Class Number, Campus, Class Name, Section Name, Instructor, Capacity, Enrolled, Available Seats, Wait List Capacity, Wait List Total
8668,Medical Campus,PAS 4946 - 0001   Physician Assistant Capstone Course,0001-CLN Main Sess,Staff,15,1,14,0,0
11367,InterAmerican Campus,MAE 4945 - 0001   Internship In Mathematics Education,0001-OTH Main Sess,Staff,8,7,1,0,0
11014,InterAmerican Campus,SCE 4945 - 0001   Internship In Science Education,0001-OTH Main Sess,Staff,4,3,1,0,0
16262,Medical Campus,HSC 4942 - 0001   Community Service Learning Practicum,0001-LEC Main Sess,Staff,15,1,14,0,0
16261,Medical Campus,HSC 4942 - 0002   Community Service Learning Practicum,0002-LEC Main Sess,Staff,15,3,12,0,0
7778,InterAmerican Campus,MAE 4942 - 0001   Seminar In Mathematics Education,0001-LEC Main Sess,Staff,8,7,1,0,0
7568,North Campus,MAN 4941 - 0001   Management Internship,0001-OTH Main Sess,Staff,40,28,12,0,0
7578,North Campus,MAN 4941 - 0002   Management Internship,0002-OTH Conversion,Staff,35,33,2,0,0
7576,North Campus,MAN 4941 - 0003   Management Internship,0003-OTH Conversion,Staff,36,0,36,0,0
7577,North Campus,MAN 4941 - 0004   Management Internship,0004-OTH Conversion,Staff,30,0,30,0,0
7569,Kendall Campus,MAN 4941 - 0005   Management Internship,0005-OTH Main Sess,Staff,36,27,9,0,0
7570,Kendall Campus,MAN 4941 - 0006   Management Internship,0006-OTH Main Sess,Staff,36,0,36,0,0
7579,Kendall Campus,MAN 4941 - 0007   Management Internship,0007-OTH Weekend,Staff,30,21,9,0,0
7571,Wolfson Campus,MAN 4941 - 0008   Management Internship,0008-OTH Main Sess,Staff,25,16,9,0,0
7572,Homestead Campus,MAN 4941 - 0010   Management Internship,0010-OTH Main Sess,Staff,30,18,12,0,0
7573,Homestead Campus,MAN 4941 - 0011   Management Internship,0011-OTH Main Sess,Staff,39,0,39,0,0
7809,North Campus,BSC 4940 - 0001   Senior Specialty Internship,0001-OTH Main Sess,Staff,24,19,5,0,0
12111,InterAmerican Campus,EEX 4940 - 0003   Internship In Special Education,0003-OTH Main Sess,Staff,8,0,8,0,0
11738,InterAmerican Campus,MAE 4940 - 0001   Advanced Topics In Mathematics Education Practicum,0001-OTH Main Sess,Staff,12,5,7,0,0
12105,InterAmerican Campus,EEC 4936 - 0002   Student Teaching Seminar I: Ece,0002-LEC Conversion,Staff,30,8,22,0,0
12372,Medical Campus,PAS 4936 - 0001   Contemporary Issues For The Pa,0001-LEC Main Sess,Staff,15,5,10,0,0
14506,InterAmerican Campus,EEX 4930 - 0002   Seminar In Special Education,0002-LEC Main Sess,Staff,10,8,2,0,0
14507,InterAmerican Campus,EEX 4930 - 0006   Seminar In Special Education,0006-LEC Main Sess,Staff,8,0,8,0,0
16290,North Campus,MAN 4900 - 0001   Capstone Project In Supervision And Management,0001-LEC Main Sess,Staff,30,12,18,0,0
16300,North Campus,MAN 4900 - 0002   Capstone Project In Supervision And Management,0002-LEC Conversion,Staff,30,14,16,0,0
16291,North Campus,MAN 4900 - 0003   Capstone Project In Supervision And Management,0003-LEC Main Sess,Staff,35,16,19,0,0
16292,North Campus,MAN 4900 - 0004   Capstone Project In Supervision And Management,0004-LEC Main Sess,Staff,30,0,30,0,0
16293,Kendall Campus,MAN 4900 - 0005   Capstone Project In Supervision And Management,0005-LEC Main Sess,Staff,36,0,36,0,0
16299,Kendall Campus,MAN 4900 - 0006   Capstone Project In Supervision And Management,0006-LEC Conversion,Staff,36,22,14,0,0
16303,Kendall Campus,MAN 4900 - 0007   Capstone Project In Supervision And Management,0007-LEC Weekend,Staff,30,0,30,0,0
16294,Kendall Campus,MAN 4900 - 0008   Capstone Project In Supervision And Management,0008-LEC Main Sess,Staff,30,28,2,0,0
16301,Wolfson Campus,MAN 4900 - 0009   Capstone Project In Supervision And Management,0009-LEC 1st Mon Sp,Staff,35,12,23,0,0
16295,Homestead Campus,MAN 4900 - 0011   Capstone Project In Supervision And Management,0011-LEC Main Sess,Staff,39,0,39,0,0
16296,Homestead Campus,MAN 4900 - 0012   Capstone Project In Supervision And Management,0012-LEC Main Sess,Staff,30,21,9,0,0
16302,Hialeah Campus,MAN 4900 - 0014   Capstone Project In Supervision And Management,0014-LEC 1st Mon Sp,Staff,30,0,30,0,0
6683,Wolfson Campus,COP 4834 - 0001   Data Driven Web Applications (Web Administration),0001-LEC Main Sess,Staff,30,26,4,0,0
6676,Kendall Campus,EEX 4833 - 0001   Practicum In Special Education,0001-OTH Main Sess,Staff,15,7,8,0,0
6678,InterAmerican Campus,EEX 4833 - 0002   Practicum In Special Education,0002-OTH Main Sess,Staff,15,14,1,0,0
9064,Wolfson Campus,NUR 4827 - 0002   Leadership And Management Theory,0002-LEC Main Sess,Staff,30,11,19,0,0
9066,Medical Campus,NUR 4827 - 0004   Leadership And Management Theory,0004-LEC Conversion,Staff,40,33,7,0,0
9068,Medical Campus,NUR 4827 - 0005   Leadership And Management Theory,0005-LEC Conversion,Staff,40,13,27,0,0
10331,North Campus,FES 4823 - 0001   Integrated Emergency Management Planning Systems,0001-LEC Twelve Wk,Staff,40,0,40,0,0
6672,Kendall Campus,EEX 4764 - 0001   Instructional And Assistive Technology In Special Education,0001-LEC Conversion,Staff,20,15,5,0,0
6673,InterAmerican Campus,EEX 4764 - 0002   Instructional And Assistive Technology In Special Education,0002-LEC 1st Mon Sp,Staff,30,0,30,0,0
8522,North Campus,COP 4723 - 0001   Database Administration,0001-LEC Main Sess,Staff,40,0,40,0,0
8525,North Campus,COP 4723 - 0002   Database Administration,0002-LEC Main Sess,Staff,40,14,26,0,0
8524,Wolfson Campus,COP 4723 - 0003   Database Administration,0003-LEC Main Sess,Staff,28,20,8,0,0
8523,Wolfson Campus,COP 4723 - 0004   Database Administration,0004-LEC Main Sess,Staff,28,14,14,0,0
11902,North Campus,MAN 4720 - 0001   Strategic Management Decision Making,0001-LEC Main Sess,Staff,43,40,3,0,0
11903,North Campus,MAN 4720 - 0002   Strategic Management Decision Making,0002-LEC Main Sess,Staff,35,0,35,0,0
11916,North Campus,MAN 4720 - 0003   Strategic Management Decision Making,0003-LEC Conversion,Staff,30,0,30,0,0
11913,North Campus,MAN 4720 - 0004   Strategic Management Decision Making,0004-LEC Conversion,Staff,35,9,26,0,0
11915,North Campus,MAN 4720 - 0005   Strategic Management Decision Making,0005-LEC Conversion,Staff,35,10,25,0,0
11909,Kendall Campus,MAN 4720 - 0006   Strategic Management Decision Making,0006-LEC Main Sess,Staff,45,0,45,0,0
11908,Kendall Campus,MAN 4720 - 0007   Strategic Management Decision Making,0007-LEC Main Sess,Staff,32,23,9,0,0
11907,Kendall Campus,MAN 4720 - 0008   Strategic Management Decision Making,0008-LEC Main Sess,Staff,35,24,11,0,0
11914,Wolfson Campus,MAN 4720 - 0009   Strategic Management Decision Making,0009-LEC Conversion,Staff,30,18,12,0,0
11906,Wolfson Campus,MAN 4720 - 0010   Strategic Management Decision Making,0010-LEC Main Sess,Staff,30,10,20,0,0
11905,Homestead Campus,MAN 4720 - 0011   Strategic Management Decision Making,0011-LEC Main Sess,Staff,25,20,5,0,0
11904,InterAmerican Campus,MAN 4720 - 0012   Strategic Management Decision Making,0012-LEC Main Sess,Staff,30,24,6,0,0
11910,Hialeah Campus,MAN 4720 - 0013   Strategic Management Decision Making,0013-LEC Eight Wk 1,Staff,30,20,10,0,0
11911,Hialeah Campus,MAN 4720 - 0014   Strategic Management Decision Making,0014-LEC Eight Wk 2,Staff,30,0,30,0,0
11912,Hialeah Campus,MAN 4720 - 0015   Strategic Management Decision Making,0015-LEC Eight Wk 2,Staff,30,0,30,0,0
7243,North Campus,CCJ 4678 - 0001   Race· Gender· Ethnicity & Crime,0001-LEC Conversion,Staff,30,0,30,0,0
7622,North Campus,CJE 4675 - 0001   Modern Fingerprint Technology,0001-LEC Main Sess,Staff,30,15,15,0,0
16451,Wolfson Campus,PCB 4674 - 0001   Evolution,0001-LEC 1st Mon Sp,Staff,30,26,4,0,0
7398,North Campus,CJE 4668 - 0001   Computer Crime,0001-LEC Main Sess,Staff,40,31,9,0,0
13965,Wolfson Campus,NUR 4667 - 0001   Globalization Of Nursing Practice,0001-LEC Main Sess,Staff,30,29,1,0,0
13966,Wolfson Campus,NUR 4667 - 0002   Globalization Of Nursing Practice,0002-LEC Main Sess,Staff,30,24,6,0,0
13974,Medical Campus,NUR 4667 - 0003   Globalization Of Nursing Practice,0003-LEC Conversion,Staff,30,0,30,0,0
13968,Medical Campus,NUR 4667 - 0004   Globalization Of Nursing Practice,0004-LEC Conversion,Staff,30,12,18,0,0
13973,Medical Campus,NUR 4667 - 0005   Globalization Of Nursing Practice,0005-LEC Conversion,Staff,40,0,40,0,0
13972,Medical Campus,NUR 4667 - 0006   Globalization Of Nursing Practice,0006-LEC Conversion,Staff,40,30,10,0,0
13970,Medical Campus,NUR 4667 - 0007   Globalization Of Nursing Practice,0007-LEC Conversion,Staff,40,34,6,0,0
13971,Medical Campus,NUR 4667 - 0008   Globalization Of Nursing Practice,0008-LEC Conversion,Staff,40,7,33,0,0
13967,Homestead Campus,NUR 4667 - 0009   Globalization Of Nursing Practice,0009-LEC Conversion,Staff,30,0,30,0,0
13969,Homestead Campus,NUR 4667 - 0010   Globalization Of Nursing Practice,0010-LEC Conversion,Staff,30,0,30,0,0
7831,North Campus,CET 4663 - 0001   Electronic Security,0001-LEC 1st Mon Sp,Staff,24,12,12,0,0
8270,Kendall Campus,CCJ 4660 - 0002   Crime· Violence· And Schools,0002-LEC Main Sess,Staff,30,17,13,0,0
9537,Wolfson Campus,COP 4656 - 0001   Mobile Applications Development,0001-LEC Main Sess,Staff,28,0,28,0,0
9014,North Campus,CCJ 4651 - 0001   Drugs And Crime,0001-LEC Main Sess,Staff,40,32,8,0,0
9015,North Campus,CCJ 4651 - 0002   Drugs And Crime,0002-LEC Twelve Wk,Staff,40,0,40,0,0
9016,North Campus,CCJ 4651 - 0003   Drugs And Crime,0003-LEC Conversion,Staff,30,26,4,0,0
6660,North Campus,CJE 4650 - 0001   Advanced Crime Scene Investigations,0001-LEC Main Sess,Staff,40,0,40,0,0
8430,North Campus,CJE 4648 - 0001   Crime Scene Safety,0001-LEC Main Sess,Staff,40,0,40,0,0
13868,North Campus,CJE 4647 - 0001   Advanced Crime Scene Technology,0001-LEC Main Sess,Staff,30,8,22,0,0
5924,North Campus,CCJ 4641 - 0001   Organized Crime,0001-LEC Twelve Wk,Staff,40,29,11,0,0
12322,Wolfson Campus,NUR 4636 - 0001   Community Health Nursing,0001-LEC Main Sess,Staff,30,29,1,0,0
12324,Wolfson Campus,NUR 4636 - 0002   Community Health Nursing,0002-LEC Main Sess,Staff,30,10,20,0,0
12323,Wolfson Campus,NUR 4636 - 0003   Community Health Nursing,0003-LEC Main Sess,Staff,30,0,30,0,0
12329,Medical Campus,NUR 4636 - 0004   Community Health Nursing,0004-LEC Conversion,Staff,40,0,40,0,0
12327,Medical Campus,NUR 4636 - 0005   Community Health Nursing,0005-LEC Conversion,Staff,40,0,40,0,0
12330,Medical Campus,NUR 4636 - 0006   Community Health Nursing,0006-LEC Conversion,Staff,40,34,6,0,0
12328,Medical Campus,NUR 4636 - 0007   Community Health Nursing,0007-LEC Conversion,Staff,40,20,20,0,0
12326,Medical Campus,NUR 4636 - 0008   Community Health Nursing,0008-LEC Conversion,Staff,40,19,21,0,0
12331,Medical Campus,NUR 4636 - 0009   Community Health Nursing,0009-LEC Conversion,Staff,40,0,40,0,0
12325,Homestead Campus,NUR 4636 - 0010   Community Health Nursing,0010-LEC Eight Wk 2,Staff,30,12,18,0,0
16430,Medical Campus,NUR 4636L - 0001   Community Health Nursing Practicum,0001-CLN Main Sess,Staff,12,0,12,0,0
16431,Medical Campus,NUR 4636L - 0002   Community Health Nursing Practicum,0002-CLN Main Sess,Staff,12,9,3,0,0
16433,Medical Campus,NUR 4636L - 0004   Community Health Nursing Practicum,0004-CLN Main Sess,Staff,12,11,1,0,0
16434,Medical Campus,NUR 4636L - 0005   Community Health Nursing Practicum,0005-CLN Main Sess,Staff,12,8,4,0,0
16436,Medical Campus,NUR 4636L - 0007   Community Health Nursing Practicum,0007-CLN Main Sess,Staff,12,11,1,0,0
16438,Medical Campus,NUR 4636L - 0008   Community Health Nursing Practicum,0008-CLN Main Sess,Staff,12,11,1,0,0
16439,Medical Campus,NUR 4636L - 0009   Community Health Nursing Practicum,0009-CLN Main Sess,Staff,12,10,2,0,0
16440,Medical Campus,NUR 4636L - 0010   Community Health Nursing Practicum,0010-CLN Main Sess,Staff,12,6,6,0,0
16437,Medical Campus,NUR 4636L - 0012   Community Health Nursing Practicum,0012-CLN Main Sess,Staff,10,6,4,0,0
16442,Homestead Campus,NUR 4636L - 0013   Community Health Nursing Practicum,0013-CLN Eight Wk 2,Staff,10,0,10,0,0
7589,Wolfson Campus,CIS 4617 - 0002   Knowledge Management,0002-LEC Main Sess,Staff,28,12,16,0,0
7590,Wolfson Campus,CIS 4617 - 0003   Knowledge Management,0003-LEC Main Sess,Staff,28,15,13,0,0
13867,Kendall Campus,CJE 4615 - 0002   Advanced Criminal Investigations,0002-LEC Twelve Wk,Staff,30,15,15,0,0
9274,InterAmerican Campus,EEX 4613 - 0001   Behavior Supports And Management For Students Withautism Spectrum Disorders,0001-LEC Conversion,Staff,21,0,21,0,0
14678,Kendall Campus,MAN 4523 - 0001   Production Information Systems,0001-LEC Main Sess,Staff,25,12,13,0,0
9690,Kendall Campus,MAN 4520 - 0001   Quality Management,0001-LEC Main Sess,Staff,35,30,5,0,0
16946,Kendall Campus,RED 4519 - 0001   Diagnosis And Instructional Intervention In Reading,0001-LEC Main Sess,Staff,28,9,19,0,0
16947,InterAmerican Campus,RED 4519 - 0002   Diagnosis And Instructional Intervention In Reading,0002-LEC Main Sess,Staff,28,0,28,0,0
16948,InterAmerican Campus,RED 4519 - 0003   Diagnosis And Instructional Intervention In Reading,0003-LEC Main Sess,Staff,21,19,2,0,0
16949,InterAmerican Campus,RED 4519 - 0004   Diagnosis And Instructional Intervention In Reading,0004-LEC Weekend,Staff,28,15,13,0,0
9532,North Campus,CJL 4514 - 0001   Criminal Sentencing,0001-LEC Twelve Wk,Staff,30,0,30,0,0
16744,Wolfson Campus,MCB 4503 - 0001   Virology,0001-LEC Main Sess,Staff,24,6,18,0,0
9633,Medical Campus,PAS 4470 - 0001   Physician Assistant Practice Management,0001-LEC Main Sess,Staff,15,4,11,0,0
7823,North Campus,CCJ 4450 - 0001   Criminal Justice Administration,0001-LEC Main Sess,Staff,40,30,10,0,0
7824,North Campus,CCJ 4450 - 0002   Criminal Justice Administration,0002-LEC Twelve Wk,Staff,40,15,25,0,0
7826,Kendall Campus,CCJ 4450 - 0003   Criminal Justice Administration,0003-LEC Conversion,Staff,40,0,40,0,0
5570,InterAmerican Campus,EDF 4430 - 0001   Measurement And Assessment In Education,0001-LEC Conversion,Staff,21,20,1,0,0
5568,InterAmerican Campus,EDF 4430 - 0003   Measurement And Assessment In Education,0003-LEC Main Sess,Staff,21,0,21,0,0
5340,North Campus,BSC 4422 - 0001   Biotechnology Methods And Applications - Iii,0001-LEC Main Sess,Staff,30,19,11,0,0
7992,North Campus,BSC 4422L - 0001   Biotechnology Methods And Applications - Iii Lab,0001-LAB Main Sess,Staff,30,19,11,0,0
16251,Kendall Campus,GEB 4363 - 0001   Import Export Management,0001-LEC Main Sess,Staff,35,32,3,0,0
11011,Kendall Campus,SCE 4362 - 0001   Methods Of Teaching Science,0001-LEC Main Sess,Staff,28,0,28,0,0
11013,InterAmerican Campus,SCE 4362 - 0002   Methods Of Teaching Science,0002-LEC 1st Mon Sp,Staff,28,16,12,0,0
11012,InterAmerican Campus,SCE 4362 - 0003   Methods Of Teaching Science,0003-LEC Main Sess,Staff,28,0,28,0,0
13486,Kendall Campus,MAE 4360 - 0001   Methods Of Teaching Mathematics,0001-LEC Main Sess,Staff,28,0,28,0,0
13489,InterAmerican Campus,MAE 4360 - 0002   Methods Of Teaching Mathematics,0002-LEC Main Sess,Staff,28,17,11,0,0
13488,InterAmerican Campus,MAE 4360 - 0003   Methods Of Teaching Mathematics,0003-LEC Main Sess,Staff,28,0,28,0,0
13487,InterAmerican Campus,MAE 4360 - 0004   Methods Of Teaching Mathematics,0004-LEC Main Sess,Staff,28,14,14,0,0
7492,North Campus,MAN 4350 - 0001   Professional Development,0001-LEC Conversion,Staff,30,15,15,0,0
7493,North Campus,MAN 4350 - 0002   Professional Development,0002-LEC Conversion,Staff,30,6,24,0,0
7491,Hialeah Campus,MAN 4350 - 0003   Professional Development,0003-LEC Eight Wk 2,Staff,30,0,30,0,0
13854,Wolfson Campus,CIS 4347 - 0002   Information Storage Management,0002-LEC Main Sess,Staff,28,10,18,0,0
13855,Wolfson Campus,CIS 4347 - 0003   Information Storage Management,0003-LEC Main Sess,Staff,22,17,5,0,0
17255,North Campus,EDG 4343 - 0001   Instructional Strategies for P-12 Teachers,0001-LEC Conversion,Staff,30,19,11,0,0
13863,North Campus,CJC 4311 - 0001   Contemporary Issues And Trends In Corrections,0001-LEC 1st Mon Sp,Staff,40,0,40,0,0
13862,North Campus,CJC 4311 - 0002   Contemporary Issues And Trends In Corrections,0002-LEC Twelve Wk,Staff,40,0,40,0,0
13861,Wolfson Campus,CJC 4311 - 0003   Contemporary Issues And Trends In Corrections,0003-LEC Main Sess,Staff,34,0,34,0,0
12654,Kendall Campus,TSL 4311 - 0001   Esol Ii: Teaching And Assessing Esol Students,0001-LEC Main Sess,Staff,28,19,9,0,0
12656,InterAmerican Campus,TSL 4311 - 0002   Esol Ii: Teaching And Assessing Esol Students,0002-LEC Main Sess,Staff,28,21,7,0,0
12655,InterAmerican Campus,TSL 4311 - 0003   Esol Ii: Teaching And Assessing Esol Students,0003-LEC Main Sess,Staff,28,0,28,0,0
17252,North Campus,TSL 4310 - 0001   Esol In Ece Ii,0001-LEC Main Sess,Staff,25,0,25,0,0
17251,Kendall Campus,TSL 4310 - 0002   Esol In Ece Ii,0002-LEC Main Sess,Staff,25,17,8,0,0
10042,InterAmerican Campus,EEX 4294 - 0001   Differentiated Instruction In Mixed-Ability Classrooms,0001-LEC Conversion,Staff,21,11,10,0,0
11083,North Campus,EEC 4268 - 0001   Designing And Implementing An Integrated Curriculum (Practicum),0001-LEC Main Sess,Staff,15,0,15,0,0
11085,North Campus,EEC 4268 - 0002   Designing And Implementing An Integrated Curriculum (Practicum),0002-LEC Main Sess,Staff,15,5,10,0,0
11084,Kendall Campus,EEC 4268 - 0003   Designing And Implementing An Integrated Curriculum (Practicum),0003-LEC Main Sess,Staff,15,13,2,0,0
12649,Homestead Campus,TRA 4234 - 0001   Warehouse Management,0001-LEC Eight Wk 2,Staff,30,0,30,0,0
12648,Homestead Campus,TRA 4234 - 0002   Warehouse Management,0002-LEC Eight Wk 2,Staff,30,1,29,0,0
10300,InterAmerican Campus,EEX 4221 - 0001   Assessment In Special Education,0001-LEC Main Sess,Staff,30,0,30,0,0
10299,InterAmerican Campus,EEX 4221 - 0002   Assessment In Special Education,0002-LEC Main Sess,Staff,21,11,10,0,0
6286,North Campus,EEC 4219 - 0001   Science· Technology· And Mathematics (Stem) Methods For Ece Ii,0001-LEC Main Sess,Staff,25,13,12,0,0
6288,North Campus,EEC 4219 - 0002   Science· Technology· And Mathematics (Stem) Methods For Ece Ii,0002-LEC Main Sess,Staff,25,0,25,0,0
6287,Kendall Campus,EEC 4219 - 0003   Science· Technology· And Mathematics (Stem) Methods For Ece Ii,0003-LEC Main Sess,Staff,30,19,11,0,0
14196,North Campus,DSC 4215 - 0001   Emergency Planning & Security Measures,0001-LEC Main Sess,Staff,40,0,40,0,0
6861,North Campus,DSC 4214 - 0001   Catastrophic Event Response Management,0001-LEC Main Sess,Staff,40,0,40,0,0
7775,North Campus,LAE 4211 - 0001   Methods And Resources For Literacy Development In Young Children,0001-LEC Main Sess,Staff,25,0,25,0,0
7774,Kendall Campus,LAE 4211 - 0002   Methods And Resources For Literacy Development In Young Children,0002-LEC Main Sess,Staff,25,18,7,0,0
8355,North Campus,FIL 4164 - 0001   Advanced Writing For Film And Television,0001-LEC 1st Mon Sp,Staff,30,28,2,0,0
8354,North Campus,FIL 4164 - 0002   Advanced Writing For Film And Television,0002-LEC Main Sess,Staff,30,19,11,0,0
7025,North Campus,CJC 4163 - 0001   Advanced Probation & Parole,0001-LEC Main Sess,Staff,60,49,11,0,0
7026,Kendall Campus,CJC 4163 - 0002   Advanced Probation & Parole,0002-LEC Main Sess,Staff,30,0,30,0,0
7027,Kendall Campus,CJC 4163 - 0003   Advanced Probation & Parole,0003-LEC Twelve Wk,Staff,36,13,23,0,0
13796,North Campus,MAN 4162 - 0001   Customer Relations For Managers,0001-LEC Main Sess,Staff,30,23,7,0,0
13804,North Campus,MAN 4162 - 0002   Customer Relations For Managers,0002-LEC Eight Wk 1,Staff,20,10,10,0,0
13813,North Campus,MAN 4162 - 0003   Customer Relations For Managers,0003-LEC Conversion,Staff,30,0,30,0,0
13812,North Campus,MAN 4162 - 0004   Customer Relations For Managers,0004-LEC Conversion,Staff,30,26,4,0,0
13797,Kendall Campus,MAN 4162 - 0005   Customer Relations For Managers,0005-LEC Main Sess,Staff,36,13,23,0,0
13798,Kendall Campus,MAN 4162 - 0006   Customer Relations For Managers,0006-LEC Main Sess,Staff,35,0,35,0,0
13799,Kendall Campus,MAN 4162 - 0007   Customer Relations For Managers,0007-LEC Main Sess,Staff,35,27,8,0,0
13809,Kendall Campus,MAN 4162 - 0008   Customer Relations For Managers,0008-LEC Eight Wk 2,Staff,35,0,35,0,0
13814,Kendall Campus,MAN 4162 - 0009   Customer Relations For Managers,0009-LEC Weekend,Staff,45,0,45,0,0
13810,Wolfson Campus,MAN 4162 - 0010   Customer Relations For Managers,0010-LEC Conversion,Staff,30,0,30,0,0
13811,Wolfson Campus,MAN 4162 - 0011   Customer Relations For Managers,0011-LEC Conversion,Staff,30,27,3,0,0
13800,Wolfson Campus,MAN 4162 - 0012   Customer Relations For Managers,0012-LEC Main Sess,Staff,30,8,22,0,0
13808,Wolfson Campus,MAN 4162 - 0013   Customer Relations For Managers,0013-LEC Eight Wk 2,Staff,30,26,4,0,0
13802,Homestead Campus,MAN 4162 - 0014   Customer Relations For Managers,0014-LEC Main Sess,Staff,25,0,25,0,0
13807,Homestead Campus,MAN 4162 - 0015   Customer Relations For Managers,0015-LEC Eight Wk 2,Staff,25,11,14,0,0
13803,Hialeah Campus,MAN 4162 - 0017   Customer Relations For Managers,0017-LEC Eight Wk 1,Staff,30,26,4,0,0
13805,Hialeah Campus,MAN 4162 - 0018   Customer Relations For Managers,0018-LEC Eight Wk 2,Staff,25,5,20,0,0
13806,Hialeah Campus,MAN 4162 - 0019   Customer Relations For Managers,0019-LEC Eight Wk 2,Staff,35,0,35,0,0
7068,North Campus,CJL 4133 - 0001   Criminal Evidence,0001-LEC Main Sess,Staff,40,20,20,0,0
16272,North Campus,MAN 4120 - 0001   Leadership Challenges And Supervision,0001-LEC Main Sess,Staff,40,16,24,0,0
16287,North Campus,MAN 4120 - 0002   Leadership Challenges And Supervision,0002-LEC Conversion,Staff,35,22,13,0,0
16273,North Campus,MAN 4120 - 0003   Leadership Challenges And Supervision,0003-LEC Main Sess,Staff,35,0,35,0,0
16280,Kendall Campus,MAN 4120 - 0004   Leadership Challenges And Supervision,0004-LEC Main Sess,Staff,35,31,4,0,0
16279,Kendall Campus,MAN 4120 - 0005   Leadership Challenges And Supervision,0005-LEC Main Sess,Staff,25,0,25,0,0
16289,Kendall Campus,MAN 4120 - 0006   Leadership Challenges And Supervision,0006-LEC Weekend,Staff,45,11,34,0,0
16278,Wolfson Campus,MAN 4120 - 0007   Leadership Challenges And Supervision,0007-LEC Main Sess,Staff,30,0,30,0,0
16277,Wolfson Campus,MAN 4120 - 0008   Leadership Challenges And Supervision,0008-LEC Main Sess,Staff,30,8,22,0,0
16286,Wolfson Campus,MAN 4120 - 0009   Leadership Challenges And Supervision,0009-LEC Conversion,Staff,30,4,26,0,0
16276,Wolfson Campus,MAN 4120 - 0010   Leadership Challenges And Supervision,0010-LEC Main Sess,Staff,30,0,30,0,0
16288,Wolfson Campus,MAN 4120 - 0011   Leadership Challenges And Supervision,0011-LEC Conversion,Staff,30,25,5,0,0
16285,Homestead Campus,MAN 4120 - 0012   Leadership Challenges And Supervision,0012-LEC Conversion,Staff,25,0,25,0,0
16275,Homestead Campus,MAN 4120 - 0013   Leadership Challenges And Supervision,0013-LEC Main Sess,Staff,25,0,25,0,0
16284,Homestead Campus,MAN 4120 - 0014   Leadership Challenges And Supervision,0014-LEC Eight Wk 2,Staff,25,6,19,0,0
16274,InterAmerican Campus,MAN 4120 - 0015   Leadership Challenges And Supervision,0015-LEC Main Sess,Staff,25,15,10,0,0
16282,Hialeah Campus,MAN 4120 - 0017   Leadership Challenges And Supervision,0017-LEC Eight Wk 2,Staff,30,0,30,0,0
16281,Hialeah Campus,MAN 4120 - 0018   Leadership Challenges And Supervision,0018-LEC Eight Wk 1,Staff,30,0,30,0,0
13076,North Campus,PCB 4097 - 0001   Human Physiology,0001-LEC Main Sess,Staff,30,16,14,0,0
10298,InterAmerican Campus,EEX 4094 - 0001   Nature And Needs Of Students With Autism Spectrum Disorders,0001-LEC Conversion,Staff,21,7,14,0,0
5923,North Campus,CCJ 4054 - 0001   Ethics In The Criminal Justice System,0001-LEC Conversion,Staff,40,28,12,0,0
5922,North Campus,CCJ 4054 - 0002   Ethics In The Criminal Justice System,0002-LEC Twelve Wk,Staff,40,33,7,0,0
10301,InterAmerican Campus,EGI 4050 - 0001   Nature And Needs Of Gifted Students,0001-LEC Conversion,Staff,28,14,14,0,0
8040,InterAmerican Campus,EEX 4024 - 0001   Legal Issues For Working With Students With Exceptionalities,0001-LEC Conversion,Staff,21,6,15,0,0
11978,North Campus,PCB 4023 - 0001   Molecular And Cell Biology,0001-LEC Main Sess,Staff,32,28,4,0,0
8543,North Campus,DSC 4012 - 0001   Terrorism,0001-LEC Twelve Wk,Staff,80,55,25,0,0
8542,Kendall Campus,DSC 4012 - 0002   Terrorism,0002-LEC Main Sess,Staff,36,19,17,0,0
11284,InterAmerican Campus,EEX 4012 - 0001   Introduction To Brain-Based Teaching Strategies,0001-LEC Conversion,Staff,21,0,21,0,0
11285,InterAmerican Campus,EEX 4012 - 0002   Introduction To Brain-Based Teaching Strategies,0002-LEC Conversion,Staff,21,19,2,0,0
11286,InterAmerican Campus,EEX 4012 - 0003   Introduction To Brain-Based Teaching Strategies,0003-LEC Conversion,Staff,28,0,28,0,0
6410,North Campus,ISM 4011 - 0001   Management Information Systems,0001-LEC Main Sess,Staff,25,19,6,0,0
6411,North Campus,ISM 4011 - 0002   Management Information Systems,0002-LEC Main Sess,Staff,25,0,25,0,0
6420,North Campus,ISM 4011 - 0003   Management Information Systems,0003-LEC Conversion,Staff,35,16,19,0,0
6423,Kendall Campus,ISM 4011 - 0005   Management Information Systems,0005-LEC Weekend,Staff,25,18,7,0,0
6413,Kendall Campus,ISM 4011 - 0006   Management Information Systems,0006-LEC Main Sess,Staff,25,13,12,0,0
6414,Kendall Campus,ISM 4011 - 0007   Management Information Systems,0007-LEC Main Sess,Staff,25,10,15,0,0
6421,Wolfson Campus,ISM 4011 - 0008   Management Information Systems,0008-LEC Conversion,Staff,30,0,30,0,0
6419,Wolfson Campus,ISM 4011 - 0009   Management Information Systems,0009-LEC Conversion,Staff,25,0,25,0,0
6422,Wolfson Campus,ISM 4011 - 0010   Management Information Systems,0010-LEC 1st Mon Sp,Staff,30,16,14,0,0
6415,Homestead Campus,ISM 4011 - 0011   Management Information Systems,0011-LEC Main Sess,Staff,25,10,15,0,0
6416,InterAmerican Campus,ISM 4011 - 0012   Management Information Systems,0012-LEC Main Sess,Staff,21,15,6,0,0
6418,Hialeah Campus,ISM 4011 - 0013   Management Information Systems,0013-LEC Eight Wk 2,Staff,30,27,3,0,0
6417,Hialeah Campus,ISM 4011 - 0014   Management Information Systems,0014-LEC Eight Wk 1,Staff,30,0,30,0,0
11331,North Campus,FES 4003 - 0001   Public Policy In Emergency Management,0001-LEC Conversion,Staff,30,7,23,0,0
17268,Medical Campus,NUR 3997 - 0001   Validated Nursing Course,0001-LEC Main Sess,Staff,40,25,15,0,0
6081,North Campus,DIG 3940 - 0001   Upper Division Internship,0001-OTH Main Sess,Staff,25,1,24,0,0
6082,North Campus,DIG 3940 - 0002   Upper Division Internship,0002-OTH Twelve Wk,Staff,25,0,25,0,0
7535,North Campus,BSC 3930 - 0001   Biological Sciences Seminar,0001-LEC Main Sess,Staff,24,14,10,0,0
9680,North Campus,MAN 3894 - 0001   Applied Case Studies In Management,0001-LEC Eight Wk 2,Staff,20,11,9,0,0
17253,North Campus,MAN 3894 - 0002   Applied Case Studies In Management,0002-LEC Twelve Wk,Staff,30,0,30,0,0
9683,North Campus,MAN 3894 - 0004   Applied Case Studies In Management,0004-LEC Conversion,Staff,30,17,13,0,0
9671,Kendall Campus,MAN 3894 - 0005   Applied Case Studies In Management,0005-LEC Main Sess,Staff,40,0,40,0,0
9672,Kendall Campus,MAN 3894 - 0006   Applied Case Studies In Management,0006-LEC Main Sess,Staff,45,0,45,0,0
17254,Kendall Campus,MAN 3894 - 0007   Applied Case Studies In Management,0007-LEC Twelve Wk,Staff,30,0,30,0,0
9684,Kendall Campus,MAN 3894 - 0008   Applied Case Studies In Management,0008-LEC Weekend,Staff,30,0,30,0,0
9682,Kendall Campus,MAN 3894 - 0009   Applied Case Studies In Management,0009-LEC Eight Wk 2,Staff,36,0,36,0,0
9673,Wolfson Campus,MAN 3894 - 0010   Applied Case Studies In Management,0010-LEC Main Sess,Staff,30,15,15,0,0
9679,Wolfson Campus,MAN 3894 - 0011   Applied Case Studies In Management,0011-LEC Eight Wk 2,Staff,30,11,19,0,0
9674,Homestead Campus,MAN 3894 - 0012   Applied Case Studies In Management,0012-LEC Main Sess,Staff,30,0,30,0,0
9675,Homestead Campus,MAN 3894 - 0013   Applied Case Studies In Management,0013-LEC Main Sess,Staff,25,20,5,0,0
9676,InterAmerican Campus,MAN 3894 - 0014   Applied Case Studies In Management,0014-LEC Main Sess,Staff,21,17,4,0,0
9677,Hialeah Campus,MAN 3894 - 0015   Applied Case Studies In Management,0015-LEC Eight Wk 1,Staff,30,21,9,0,0
9678,Hialeah Campus,MAN 3894 - 0016   Applied Case Studies In Management,0016-LEC Eight Wk 2,Staff,30,10,20,0,0
10502,Wolfson Campus,NUR 3846 - 0002   Foundations Of Professional Nursing,0002-LEC Main Sess,Staff,30,27,3,0,0
10504,Medical Campus,NUR 3846 - 0003   Foundations Of Professional Nursing,0003-LEC Conversion,Staff,40,0,40,0,0
10510,Medical Campus,NUR 3846 - 0004   Foundations Of Professional Nursing,0004-LEC Conversion,Staff,40,8,32,0,0
10509,Medical Campus,NUR 3846 - 0005   Foundations Of Professional Nursing,0005-LEC Conversion,Staff,40,27,13,0,0
10506,Medical Campus,NUR 3846 - 0006   Foundations Of Professional Nursing,0006-LEC Conversion,Staff,40,20,20,0,0
10508,Medical Campus,NUR 3846 - 0008   Foundations Of Professional Nursing,0008-LEC Conversion,Staff,40,0,40,0,0
10505,Homestead Campus,NUR 3846 - 0009   Foundations Of Professional Nursing,0009-LEC Conversion,Staff,30,0,30,0,0
10503,Homestead Campus,NUR 3846 - 0010   Foundations Of Professional Nursing,0010-LEC Conversion,Staff,30,12,18,0,0
12321,Medical Campus,NUR 3826 - 0001   Ethical Issues In Health Care And The Environment,0001-LEC Conversion,Staff,30,0,30,0,0
14896,Wolfson Campus,NUR 3805 - 0002   Transition To Professional Nursing,0002-LEC Main Sess,Staff,30,28,2,0,0
14905,Medical Campus,NUR 3805 - 0003   Transition To Professional Nursing,0003-LEC Conversion,Staff,40,6,34,0,0
14904,Medical Campus,NUR 3805 - 0004   Transition To Professional Nursing,0004-LEC Conversion,Staff,30,5,25,0,0
14900,Medical Campus,NUR 3805 - 0005   Transition To Professional Nursing,0005-LEC Conversion,Staff,30,0,30,0,0
14898,Medical Campus,NUR 3805 - 0006   Transition To Professional Nursing,0006-LEC Conversion,Staff,40,20,20,0,0
14906,Medical Campus,NUR 3805 - 0008   Transition To Professional Nursing,0008-LEC Conversion,Staff,30,21,9,0,0
14899,Medical Campus,NUR 3805 - 0009   Transition To Professional Nursing,0009-LEC Conversion,Staff,40,0,40,0,0
14901,Medical Campus,NUR 3805 - 0010   Transition To Professional Nursing,0010-LEC Conversion,Staff,20,5,15,0,0
14902,Homestead Campus,NUR 3805 - 0011   Transition To Professional Nursing,0011-LEC Conversion,Staff,30,0,30,0,0
13823,North Campus,CGS 3763 - 0001   Operating System Principles,0001-LEC Main Sess,Staff,40,17,23,0,0
13824,North Campus,CGS 3763 - 0002   Operating System Principles,0002-LEC Main Sess,Staff,40,0,40,0,0
13827,Wolfson Campus,CGS 3763 - 0003   Operating System Principles,0003-LEC Main Sess,Staff,28,0,28,0,0
13826,Wolfson Campus,CGS 3763 - 0004   Operating System Principles,0004-LEC Main Sess,Staff,28,23,5,0,0
13825,Wolfson Campus,CGS 3763 - 0005   Operating System Principles,0005-LEC Main Sess,Staff,30,0,30,0,0
15290,Medical Campus,HSC 3701 - 0001   Leadership And Management In Healthcare,0001-LEC Main Sess,Staff,15,0,15,0,0
8125,North Campus,CCJ 3700 - 0001   Methods Of Research In Criminal Justice,0001-LEC Main Sess,Staff,40,0,40,0,0
8124,North Campus,CCJ 3700 - 0002   Methods Of Research In Criminal Justice,0002-LEC Main Sess,Staff,40,20,20,0,0
8092,Medical Campus,NSP 3685 - 0001   End-Of-Life Nursing Care,0001-LEC Conversion,Staff,30,8,22,0,0
12320,Medical Campus,NUR 3674 - 0001   Faith Based Community Nursing,0001-LEC Conversion,Staff,30,15,15,0,0
6354,North Campus,ETI 3671 - 0001   Technical Economic Analysis,0001-LEC 1st Mon Sp,Staff,24,9,15,0,0
6353,North Campus,ETI 3671 - 0002   Technical Economic Analysis,0002-LEC Main Sess,Staff,24,0,24,0,0
5424,North Campus,CCJ 3666 - 0001   Victimology,0001-LEC 1st Mon Sp,Staff,40,0,40,0,0
5425,North Campus,CCJ 3666 - 0002   Victimology,0002-LEC 1st Mon Sp,Staff,40,0,40,0,0
5426,North Campus,CCJ 3666 - 0003   Victimology,0003-LEC 1st Mon Sp,Staff,40,25,15,0,0
5421,Kendall Campus,CCJ 3666 - 0004   Victimology,0004-LEC Main Sess,Staff,40,13,27,0,0
5422,Wolfson Campus,CCJ 3666 - 0005   Victimology,0005-LEC Eight Wk 2,Staff,30,0,30,0,0
7242,North Campus,CCJ 3663 - 0001   Female Crime And Delinquency,0001-LEC Twelve Wk,Staff,40,0,40,0,0
7240,North Campus,CCJ 3663 - 0002   Female Crime And Delinquency,0002-LEC Main Sess,Staff,40,32,8,0,0
7241,North Campus,CCJ 3663 - 0003   Female Crime And Delinquency,0003-LEC Main Sess,Staff,40,0,40,0,0
15257,North Campus,FIL 3651 - 0001   Business Proposals For Film & Television,0001-LEC Main Sess,Staff,30,23,7,0,0
9273,North Campus,EEX 3603 - 0001   Positive Behavior Supports In Inclusive Settings,0001-LEC Weekend,Staff,25,0,25,0,0
9270,North Campus,EEX 3603 - 0002   Positive Behavior Supports In Inclusive Settings,0002-LEC Main Sess,Staff,25,16,9,0,0
9271,North Campus,EEX 3603 - 0003   Positive Behavior Supports In Inclusive Settings,0003-LEC Main Sess,Staff,25,0,25,0,0
9272,Kendall Campus,EEX 3603 - 0004   Positive Behavior Supports In Inclusive Settings,0004-LEC Main Sess,Staff,20,16,4,0,0
11140,North Campus,FIL 3602 - 0001   Production Management,0001-LEC Main Sess,Staff,30,20,10,0,0
8501,North Campus,CJE 3574 - 0001   Interpersonal Communications For Law Enforcement,0001-LEC Twelve Wk,Staff,40,16,24,0,0
8500,Kendall Campus,CJE 3574 - 0002   Interpersonal Communications For Law Enforcement,0002-LEC Main Sess,Staff,35,23,12,0,0
9530,North Campus,CJL 3564 - 0001   Judicial Policy Making,0001-LEC Twelve Wk,Staff,43,26,17,0,0
7256,North Campus,CIS 3510 - 0001   Information Technology Project Management,0001-LEC Main Sess,Staff,40,0,40,0,0
7257,North Campus,CIS 3510 - 0002   Information Technology Project Management,0002-LEC Main Sess,Staff,30,17,13,0,0
7260,Wolfson Campus,CIS 3510 - 0003   Information Technology Project Management,0003-LEC Main Sess,Staff,28,0,28,0,0
7259,Wolfson Campus,CIS 3510 - 0004   Information Technology Project Management,0004-LEC Main Sess,Staff,28,21,7,0,0
7258,Wolfson Campus,CIS 3510 - 0005   Information Technology Project Management,0005-LEC Main Sess,Staff,30,0,30,0,0
7782,Kendall Campus,MAN 3506 - 0001   Operations Management,0001-LEC Main Sess,Staff,30,13,17,0,0
5498,North Campus,CJE 3444 - 0001   Crime Prevention,0001-LEC Main Sess,Staff,40,36,4,0,0
5497,Kendall Campus,CJE 3444 - 0002   Crime Prevention,0002-LEC Main Sess,Staff,36,22,14,0,0
8449,Kendall Campus,EDG 3443 - 0001   Classroom And Behavior Management,0001-LEC Conversion,Staff,32,0,32,0,0
8451,InterAmerican Campus,EDG 3443 - 0002   Classroom And Behavior Management,0002-LEC Weekend,Staff,30,0,30,0,0
6707,InterAmerican Campus,EME 3430 - 0001   Instructional Technology In Mathematics And Science,0001-LEC Main Sess,Staff,25,8,17,0,0
6313,InterAmerican Campus,EDG 3410 - 0001   Classroom Management and Communication for P-12 Teachers,0001-LEC Conversion,Staff,28,18,10,0,0
15707,North Campus,RTV 3408 - 0001   Ethics & Research For Non-Fiction Scripts,0001-LEC Main Sess,Staff,30,28,2,0,0
11338,Kendall Campus,FIN 3403 - 0001   Financial Management,0001-LEC Main Sess,Staff,25,0,25,0,0
11339,Kendall Campus,FIN 3403 - 0002   Financial Management,0002-LEC Weekend,Staff,25,18,7,0,0
7038,North Campus,FIN 3400 - 0001   Finance For Non-Financial Managers,0001-LEC Main Sess,Staff,30,0,30,0,0
7049,North Campus,FIN 3400 - 0003   Finance For Non-Financial Managers,0003-LEC 1st Mon Sp,Staff,30,0,30,0,0
7048,North Campus,FIN 3400 - 0004   Finance For Non-Financial Managers,0004-LEC Conversion,Staff,30,0,30,0,0
7037,North Campus,FIN 3400 - 0005   Finance For Non-Financial Managers,0005-LEC Main Sess,Staff,30,0,30,0,0
7047,North Campus,FIN 3400 - 0006   Finance For Non-Financial Managers,0006-LEC Conversion,Staff,30,21,9,0,0
7046,North Campus,FIN 3400 - 0007   Finance For Non-Financial Managers,0007-LEC Conversion,Staff,30,0,30,0,0
7030,Kendall Campus,FIN 3400 - 0008   Finance For Non-Financial Managers,0008-LEC Main Sess,Staff,36,12,24,0,0
7031,Kendall Campus,FIN 3400 - 0009   Finance For Non-Financial Managers,0009-LEC Main Sess,Staff,30,28,2,0,0
7032,Kendall Campus,FIN 3400 - 0010   Finance For Non-Financial Managers,0010-LEC Main Sess,Staff,35,20,15,0,0
7033,Kendall Campus,FIN 3400 - 0011   Finance For Non-Financial Managers,0011-LEC Main Sess,Staff,25,0,25,0,0
7040,Wolfson Campus,FIN 3400 - 0012   Finance For Non-Financial Managers,0012-LEC Twelve Wk,Staff,30,14,16,0,0
7034,Wolfson Campus,FIN 3400 - 0013   Finance For Non-Financial Managers,0013-LEC Main Sess,Staff,30,9,21,0,0
7035,Homestead Campus,FIN 3400 - 0014   Finance For Non-Financial Managers,0014-LEC Main Sess,Staff,30,0,30,0,0
7036,Homestead Campus,FIN 3400 - 0015   Finance For Non-Financial Managers,0015-LEC Main Sess,Staff,25,12,13,0,0
7039,InterAmerican Campus,FIN 3400 - 0016   Finance For Non-Financial Managers,0016-LEC Main Sess,Staff,21,9,12,0,0
7045,InterAmerican Campus,FIN 3400 - 0017   Finance For Non-Financial Managers,0017-LEC Conversion,Staff,21,12,9,0,0
7041,Hialeah Campus,FIN 3400 - 0019   Finance For Non-Financial Managers,0019-LEC Eight Wk 1,Staff,25,0,25,0,0
7042,Hialeah Campus,FIN 3400 - 0020   Finance For Non-Financial Managers,0020-LEC Eight Wk 1,Staff,31,0,31,0,0
13209,North Campus,RED 3393 - 0001   Differentiated Instruction In Content Reading,0001-LEC 1st Mon Sp,Staff,28,0,28,0,0
13208,Kendall Campus,RED 3393 - 0002   Differentiated Instruction In Content Reading,0002-LEC Conversion,Staff,28,23,5,0,0
13206,InterAmerican Campus,RED 3393 - 0003   Differentiated Instruction In Content Reading,0003-LEC Main Sess,Staff,28,16,12,0,0
8429,North Campus,CIS 3360 - 0001   Principles Of Information Security,0001-LEC 1st Mon Sp,Staff,40,0,40,0,0
8426,North Campus,CIS 3360 - 0002   Principles Of Information Security,0002-LEC Main Sess,Staff,30,18,12,0,0
8427,Wolfson Campus,CIS 3360 - 0003   Principles Of Information Security,0003-LEC Main Sess,Staff,28,13,15,0,0
8428,Wolfson Campus,CIS 3360 - 0004   Principles Of Information Security,0004-LEC Main Sess,Staff,28,17,11,0,0
9641,Kendall Campus,EDG 3321 - 0002   General Teaching Skills,0002-LEC Conversion,Staff,32,0,32,0,0
9638,InterAmerican Campus,EDG 3321 - 0003   General Teaching Skills,0003-LEC Main Sess,Staff,21,17,4,0,0
9639,InterAmerican Campus,EDG 3321 - 0004   General Teaching Skills,0004-LEC Main Sess,Staff,21,0,21,0,0
9642,InterAmerican Campus,EDG 3321 - 0005   General Teaching Skills,0005-LEC 1st Mon Sp,Staff,21,0,21,0,0
9643,InterAmerican Campus,EDG 3321 - 0006   General Teaching Skills,0006-LEC 1st Mon Sp,Staff,21,18,3,0,0
12100,North Campus,EEC 3301 - 0001   General Teaching Methods For Early Childhood Education,0001-LEC Main Sess,Staff,25,0,25,0,0
12103,North Campus,EEC 3301 - 0002   General Teaching Methods For Early Childhood Education,0002-LEC Main Sess,Staff,30,15,15,0,0
12102,North Campus,EEC 3301 - 0003   General Teaching Methods For Early Childhood Education,0003-LEC Main Sess,Staff,30,0,30,0,0
12101,Kendall Campus,EEC 3301 - 0004   General Teaching Methods For Early Childhood Education,0004-LEC Main Sess,Staff,30,15,15,0,0
15311,North Campus,MAN 3301 - 0001   Human Resource Management,0001-LEC Main Sess,Staff,30,10,20,0,0
15325,North Campus,MAN 3301 - 0002   Human Resource Management,0002-LEC Conversion,Staff,30,0,30,0,0
15324,North Campus,MAN 3301 - 0003   Human Resource Management,0003-LEC Conversion,Staff,30,0,30,0,0
15323,North Campus,MAN 3301 - 0004   Human Resource Management,0004-LEC Conversion,Staff,30,25,5,0,0
15312,Kendall Campus,MAN 3301 - 0005   Human Resource Management,0005-LEC Main Sess,Staff,35,24,11,0,0
15329,Kendall Campus,MAN 3301 - 0006   Human Resource Management,0006-LEC Weekend,Staff,35,0,35,0,0
15313,Kendall Campus,MAN 3301 - 0007   Human Resource Management,0007-LEC Main Sess,Staff,25,0,25,0,0
15327,Kendall Campus,MAN 3301 - 0008   Human Resource Management,0008-LEC Conversion,Staff,35,0,35,0,0
15314,Wolfson Campus,MAN 3301 - 0009   Human Resource Management,0009-LEC Main Sess,Staff,30,16,14,0,0
15328,Wolfson Campus,MAN 3301 - 0010   Human Resource Management,0010-LEC 1st Mon Sp,Staff,30,25,5,0,0
15326,Wolfson Campus,MAN 3301 - 0011   Human Resource Management,0011-LEC Conversion,Staff,30,17,13,0,0
15320,Wolfson Campus,MAN 3301 - 0012   Human Resource Management,0012-LEC Eight Wk 1,Staff,30,29,1,0,0
15315,Homestead Campus,MAN 3301 - 0013   Human Resource Management,0013-LEC Main Sess,Staff,25,13,12,0,0
15317,Homestead Campus,MAN 3301 - 0014   Human Resource Management,0014-LEC Main Sess,Staff,30,0,30,0,0
15316,InterAmerican Campus,MAN 3301 - 0015   Human Resource Management,0015-LEC Main Sess,Staff,30,16,14,0,0
15322,Hialeah Campus,MAN 3301 - 0016   Human Resource Management,0016-LEC Eight Wk 2,Staff,30,0,30,0,0
15321,Hialeah Campus,MAN 3301 - 0017   Human Resource Management,0017-LEC Eight Wk 2,Staff,30,0,30,0,0
15318,Hialeah Campus,MAN 3301 - 0018   Human Resource Management,0018-LEC Eight Wk 1,Staff,30,0,30,0,0
15319,Hialeah Campus,MAN 3301 - 0019   Human Resource Management,0019-LEC Eight Wk 1,Staff,30,24,6,0,0
13962,Wolfson Campus,NUR 3289 - 0001   Foundations Of Gerontology,0001-LEC Main Sess,Staff,30,14,16,0,0
13963,Medical Campus,NUR 3289 - 0002   Foundations Of Gerontology,0002-LEC Conversion,Staff,30,0,30,0,0
13964,Medical Campus,NUR 3289 - 0003   Foundations Of Gerontology,0003-LEC Conversion,Staff,30,9,21,0,0
12653,Kendall Campus,TSL 3243 - 0001   Esol I: Second Language Acquisition· Communication· And Culture,0001-LEC Conversion,Staff,28,18,10,0,0
12651,InterAmerican Campus,TSL 3243 - 0002   Esol I: Second Language Acquisition· Communication· And Culture,0002-LEC Main Sess,Staff,21,0,21,0,0
12652,InterAmerican Campus,TSL 3243 - 0003   Esol I: Second Language Acquisition· Communication· And Culture,0003-LEC Main Sess,Staff,28,26,2,0,0
11872,North Campus,MAN 3240 - 0001   Organizational Behavior,0001-LEC Main Sess,Staff,30,10,20,0,0
11887,North Campus,MAN 3240 - 0002   Organizational Behavior,0002-LEC Conversion,Staff,40,32,8,0,0
11881,North Campus,MAN 3240 - 0003   Organizational Behavior,0003-LEC Eight Wk 1,Staff,30,0,30,0,0
11885,North Campus,MAN 3240 - 0004   Organizational Behavior,0004-LEC Eight Wk 2,Staff,30,0,30,0,0
11873,Kendall Campus,MAN 3240 - 0005   Organizational Behavior,0005-LEC Main Sess,Staff,30,17,13,0,0
11874,Kendall Campus,MAN 3240 - 0006   Organizational Behavior,0006-LEC Main Sess,Staff,25,19,6,0,0
11889,Kendall Campus,MAN 3240 - 0007   Organizational Behavior,0007-LEC Weekend,Staff,36,0,36,0,0
11875,Wolfson Campus,MAN 3240 - 0008   Organizational Behavior,0008-LEC Main Sess,Staff,30,15,15,0,0
11888,Wolfson Campus,MAN 3240 - 0009   Organizational Behavior,0009-LEC 1st Mon Sp,Staff,30,29,1,0,0
11886,Wolfson Campus,MAN 3240 - 0010   Organizational Behavior,0010-LEC Conversion,Staff,30,16,14,0,0
11884,Wolfson Campus,MAN 3240 - 0011   Organizational Behavior,0011-LEC Eight Wk 2,Staff,30,28,2,0,0
11876,Homestead Campus,MAN 3240 - 0012   Organizational Behavior,0012-LEC Main Sess,Staff,30,0,30,0,0
11878,Homestead Campus,MAN 3240 - 0013   Organizational Behavior,0013-LEC Main Sess,Staff,25,6,19,0,0
11877,InterAmerican Campus,MAN 3240 - 0014   Organizational Behavior,0014-LEC Main Sess,Staff,21,16,5,0,0
11883,Hialeah Campus,MAN 3240 - 0015   Organizational Behavior,0015-LEC Eight Wk 2,Staff,30,9,21,0,0
11882,Hialeah Campus,MAN 3240 - 0016   Organizational Behavior,0016-LEC Eight Wk 2,Staff,30,0,30,0,0
11879,Hialeah Campus,MAN 3240 - 0017   Organizational Behavior,0017-LEC Eight Wk 1,Staff,30,6,24,0,0
11880,Hialeah Campus,MAN 3240 - 0018   Organizational Behavior,0018-LEC Eight Wk 1,Staff,30,0,30,0,0
10297,North Campus,EEX 3226 - 0001   Assessment Of All Young Children,0001-LEC Main Sess,Staff,25,16,9,0,0
10296,Kendall Campus,EEX 3226 - 0002   Assessment Of All Young Children,0002-LEC Main Sess,Staff,30,17,13,0,0
6631,North Campus,EEC 3212 - 0001   Integrated Social Sciences· Humanities· And Arts,0001-LEC Main Sess,Staff,25,10,15,0,0
6633,North Campus,EEC 3212 - 0002   Integrated Social Sciences· Humanities· And Arts,0002-LEC Main Sess,Staff,25,0,25,0,0
6632,Kendall Campus,EEC 3212 - 0003   Integrated Social Sciences· Humanities· And Arts,0003-LEC Main Sess,Staff,30,15,15,0,0
9227,North Campus,EEC 3211 - 0001   Science· Technology· And Mathematics (Stem) Methods For Ece I,0001-LEC Main Sess,Staff,25,15,10,0,0
9226,Kendall Campus,EEC 3211 - 0002   Science· Technology· And Mathematics (Stem) Methods For Ece I,0002-LEC Main Sess,Staff,20,16,4,0,0
13847,North Campus,MSL 3202 - 0001   Leadership And Ethics,0001-LEC Main Sess,Staff,30,2,28,0,0
14637,Medical Campus,HSC 3181 - 0001   Alternative Medicine Strategies,0001-LEC Main Sess,Staff,15,4,11,0,0
13961,Wolfson Campus,NUR 3178 - 0001   Complementary And Alternative Health Care,0001-LEC Main Sess,Staff,30,0,30,0,0
13960,Wolfson Campus,NUR 3178 - 0002   Complementary And Alternative Health Care,0002-LEC Main Sess,Staff,30,29,1,0,0
14886,Wolfson Campus,NUR 3165 - 0001   Nursing Research,0001-LEC Main Sess,Staff,30,0,30,0,0
14895,Medical Campus,NUR 3165 - 0003   Nursing Research,0003-LEC Conversion,Staff,40,0,40,0,0
14889,Medical Campus,NUR 3165 - 0004   Nursing Research,0004-LEC Conversion,Staff,40,6,34,0,0
14891,Medical Campus,NUR 3165 - 0005   Nursing Research,0005-LEC Conversion,Staff,40,14,26,0,0
14894,Medical Campus,NUR 3165 - 0006   Nursing Research,0006-LEC Conversion,Staff,40,0,40,0,0
14893,Medical Campus,NUR 3165 - 0007   Nursing Research,0007-LEC Conversion,Staff,40,30,10,0,0
14892,Medical Campus,NUR 3165 - 0008   Nursing Research,0008-LEC Conversion,Staff,40,0,40,0,0
14890,Homestead Campus,NUR 3165 - 0009   Nursing Research,0009-LEC Conversion,Staff,30,0,30,0,0
14888,Homestead Campus,NUR 3165 - 0010   Nursing Research,0010-LEC Conversion,Staff,20,12,8,0,0
13238,Homestead Campus,TRA 3132 - 0001   Purchasing And Inventory Management,0001-LEC Eight Wk 1,Staff,30,19,11,0,0
11279,Medical Campus,HSC 3131 - 0001   Client Education In Health Care,0001-LEC Main Sess,Staff,15,4,11,0,0
11281,Kendall Campus,EEX 3120 - 0001   Language Development And Communication Disorders,0001-LEC Main Sess,Staff,30,0,30,0,0
11283,InterAmerican Campus,EEX 3120 - 0002   Language Development And Communication Disorders,0002-LEC Main Sess,Staff,21,0,21,0,0
7621,North Campus,CJE 3115 - 0001   Police And Society,0001-LEC Twelve Wk,Staff,60,50,10,0,0
9330,North Campus,EDF 3115 - 0001   Child Development For Inclusive Settings,0001-LEC Main Sess,Staff,30,8,22,0,0
9332,North Campus,EDF 3115 - 0002   Child Development For Inclusive Settings,0002-LEC Main Sess,Staff,30,0,30,0,0
9331,Kendall Campus,EDF 3115 - 0003   Child Development For Inclusive Settings,0003-LEC Main Sess,Staff,20,18,2,0,0
5904,North Campus,CJE 3110 - 0001   Law Enforcement Systems,0001-LEC Main Sess,Staff,60,46,14,0,0
11365,InterAmerican Campus,MAD 3107 - 0001   Discrete Structures,0001-LEC Main Sess,Staff,15,4,11,0,0
13818,InterAmerican Campus,MAS 3105 - 0001   Linear Algebra,0001-LEC Main Sess,Staff,20,7,13,0,0
13239,North Campus,TSL 3080 - 0001   Esol In Ece I,0001-LEC Main Sess,Staff,25,0,25,0,0
13241,North Campus,TSL 3080 - 0002   Esol In Ece I,0002-LEC Main Sess,Staff,30,14,16,0,0
13240,Kendall Campus,TSL 3080 - 0003   Esol In Ece I,0003-LEC Main Sess,Staff,30,15,15,0,0
8031,North Campus,EEX 3071 - 0001   Teaching Exceptional And Diverse Populations In Inclusive Settings,0001-LEC 1st Mon Sp,Staff,25,0,25,0,0
8030,InterAmerican Campus,EEX 3071 - 0002   Teaching Exceptional And Diverse Populations In Inclusive Settings,0002-LEC 1st Mon Sp,Staff,25,22,3,0,0
8029,InterAmerican Campus,EEX 3071 - 0003   Teaching Exceptional And Diverse Populations In Inclusive Settings,0003-LEC Main Sess,Staff,25,20,5,0,0
16787,Wolfson Campus,NUR 3069 - 0001   Advanced Health Assessment,0001-LEC Main Sess,Staff,30,16,14,0,0
16785,Wolfson Campus,NUR 3069 - 0003   Advanced Health Assessment,0003-LEC Main Sess,Staff,30,29,1,0,0
16790,Medical Campus,NUR 3069 - 0004   Advanced Health Assessment,0004-LEC Conversion,Staff,20,19,1,0,0
16799,Medical Campus,NUR 3069 - 0005   Advanced Health Assessment,0005-LEC Conversion,Staff,20,0,20,0,0
16794,Medical Campus,NUR 3069 - 0006   Advanced Health Assessment,0006-LEC Conversion,Staff,20,11,9,0,0
16791,Medical Campus,NUR 3069 - 0008   Advanced Health Assessment,0008-LEC Conversion,Staff,20,0,20,0,0
16796,Medical Campus,NUR 3069 - 0009   Advanced Health Assessment,0009-LEC Conversion,Staff,20,0,20,0,0
16789,Medical Campus,NUR 3069 - 0010   Advanced Health Assessment,0010-LEC Conversion,Staff,20,0,20,0,0
16800,Medical Campus,NUR 3069 - 0011   Advanced Health Assessment,0011-LEC Conversion,Staff,20,0,20,0,0
16798,Medical Campus,NUR 3069 - 0013   Advanced Health Assessment,0013-LEC Conversion,Staff,20,0,20,0,0
16797,Medical Campus,NUR 3069 - 0014   Advanced Health Assessment,0014-LEC Conversion,Staff,30,9,21,0,0
16788,Medical Campus,NUR 3069 - 0015   Advanced Health Assessment,0015-LEC Conversion,Staff,20,0,20,0,0
16793,Homestead Campus,NUR 3069 - 0016   Advanced Health Assessment,0016-LEC Conversion,Staff,30,0,30,0,0
13505,North Campus,MAN 3065 - 0001   Business Ethics,0001-LEC Conversion,Staff,30,18,12,0,0
13490,Kendall Campus,MAN 3065 - 0004   Business Ethics,0004-LEC Main Sess,Staff,45,34,11,0,0
13507,Kendall Campus,MAN 3065 - 0005   Business Ethics,0005-LEC Weekend,Staff,30,0,30,0,0
13491,Kendall Campus,MAN 3065 - 0006   Business Ethics,0006-LEC Main Sess,Staff,25,15,10,0,0
13492,Kendall Campus,MAN 3065 - 0007   Business Ethics,0007-LEC Main Sess,Staff,25,12,13,0,0
13504,Wolfson Campus,MAN 3065 - 0008   Business Ethics,0008-LEC Conversion,Staff,30,0,30,0,0
13493,Wolfson Campus,MAN 3065 - 0009   Business Ethics,0009-LEC Main Sess,Staff,30,12,18,0,0
13496,Wolfson Campus,MAN 3065 - 0010   Business Ethics,0010-LEC Twelve Wk,Staff,30,27,3,0,0
13494,Wolfson Campus,MAN 3065 - 0011   Business Ethics,0011-LEC Main Sess,Staff,30,0,30,0,0
13499,Wolfson Campus,MAN 3065 - 0012   Business Ethics,0012-LEC Eight Wk 1,Staff,30,23,7,0,0
13495,Homestead Campus,MAN 3065 - 0013   Business Ethics,0013-LEC Main Sess,Staff,25,13,12,0,0
13506,InterAmerican Campus,MAN 3065 - 0014   Business Ethics,0014-LEC 1st Mon Sp,Staff,30,16,14,0,0
13508,Hialeah Campus,MAN 3065 - 0015   Business Ethics,0015-LEC Weekend,Staff,30,0,30,0,0
13501,Hialeah Campus,MAN 3065 - 0016   Business Ethics,0016-LEC Eight Wk 2,Staff,34,0,34,0,0
13498,Hialeah Campus,MAN 3065 - 0017   Business Ethics,0017-LEC Eight Wk 1,Staff,30,0,30,0,0
13497,Hialeah Campus,MAN 3065 - 0018   Business Ethics,0018-LEC Eight Wk 1,Staff,30,19,11,0,0
13500,Hialeah Campus,MAN 3065 - 0019   Business Ethics,0019-LEC Eight Wk 2,Staff,15,0,15,0,0
14911,North Campus,PCB 3060 - 0001   Principles Of Genetics,0001-LEC Main Sess,Staff,24,23,1,0,0
14913,Kendall Campus,PCB 3060 - 0002   Principles Of Genetics,0002-LEC Main Sess,Staff,24,0,24,0,0
14912,Wolfson Campus,PCB 3060 - 0003   Principles Of Genetics,0003-LEC Main Sess,Staff,24,0,24,0,0
13077,North Campus,PCB 3060L - 0001   Principles Of Genetics Laboratory,0001-LAB Main Sess,Staff,24,23,1,0,0
13079,Kendall Campus,PCB 3060L - 0002   Principles Of Genetics Laboratory,0002-LAB 1st Mon Sp,Staff,24,0,24,0,0
13078,Wolfson Campus,PCB 3060L - 0003   Principles Of Genetics Laboratory,0003-LAB Main Sess,Staff,24,0,24,0,0
11381,Medical Campus,HSC 3057 - 0001   Introduction To Research Methods In Health Care,0001-LEC Weekend,Staff,20,4,16,0,0
10491,Wolfson Campus,NUR 3045 - 0001   Culture In Nursing Practice,0001-LEC Main Sess,Staff,30,29,1,0,0
10492,Wolfson Campus,NUR 3045 - 0002   Culture In Nursing Practice,0002-LEC Main Sess,Staff,30,24,6,0,0
10499,Medical Campus,NUR 3045 - 0003   Culture In Nursing Practice,0003-LEC Conversion,Staff,30,0,30,0,0
10498,Medical Campus,NUR 3045 - 0004   Culture In Nursing Practice,0004-LEC Conversion,Staff,30,18,12,0,0
10495,Medical Campus,NUR 3045 - 0006   Culture In Nursing Practice,0006-LEC Conversion,Staff,40,9,31,0,0
10496,Medical Campus,NUR 3045 - 0007   Culture In Nursing Practice,0007-LEC Conversion,Staff,40,26,14,0,0
10500,Medical Campus,NUR 3045 - 0008   Culture In Nursing Practice,0008-LEC Conversion,Staff,40,19,21,0,0
10497,Medical Campus,NUR 3045 - 0009   Culture In Nursing Practice,0009-LEC Conversion,Staff,40,0,40,0,0
10493,Homestead Campus,NUR 3045 - 0010   Culture In Nursing Practice,0010-LEC Conversion,Staff,30,0,30,0,0
5946,North Campus,CJL 3044 - 0001   Civil Law,0001-LEC Twelve Wk,Staff,60,59,1,0,0
8266,North Campus,CCJ 3032 - 0001   Crime And The Media,0001-LEC Twelve Wk,Staff,40,0,40,0,0
8265,Kendall Campus,CCJ 3032 - 0003   Crime And The Media,0003-LEC Main Sess,Staff,36,16,20,0,0
8267,Wolfson Campus,CCJ 3032 - 0004   Crime And The Media,0004-LEC Eight Wk 1,Staff,30,22,8,0,0
12806,North Campus,MAN 3025 - 0002   Organization Management,0002-LEC Eight Wk 1,Staff,30,12,18,0,0
12811,North Campus,MAN 3025 - 0003   Organization Management,0003-LEC Conversion,Staff,30,28,2,0,0
12800,Kendall Campus,MAN 3025 - 0004   Organization Management,0004-LEC Main Sess,Staff,45,30,15,0,0
12801,Kendall Campus,MAN 3025 - 0005   Organization Management,0005-LEC Main Sess,Staff,25,0,25,0,0
12814,Kendall Campus,MAN 3025 - 0006   Organization Management,0006-LEC Weekend,Staff,36,18,18,0,0
12812,Wolfson Campus,MAN 3025 - 0007   Organization Management,0007-LEC Conversion,Staff,30,0,30,0,0
12809,Wolfson Campus,MAN 3025 - 0008   Organization Management,0008-LEC Eight Wk 2,Staff,30,14,16,0,0
12802,Wolfson Campus,MAN 3025 - 0009   Organization Management,0009-LEC Main Sess,Staff,30,16,14,0,0
12803,Homestead Campus,MAN 3025 - 0010   Organization Management,0010-LEC Main Sess,Staff,25,15,10,0,0
12813,InterAmerican Campus,MAN 3025 - 0011   Organization Management,0011-LEC 1st Mon Sp,Staff,21,18,3,0,0
12810,Hialeah Campus,MAN 3025 - 0012   Organization Management,0012-LEC Eight Wk 2,Staff,30,18,12,0,0
12807,Hialeah Campus,MAN 3025 - 0013   Organization Management,0013-LEC Eight Wk 2,Staff,30,0,30,0,0
12808,Hialeah Campus,MAN 3025 - 0014   Organization Management,0014-LEC Eight Wk 2,Staff,33,28,5,0,0
12805,Hialeah Campus,MAN 3025 - 0015   Organization Management,0015-LEC Eight Wk 1,Staff,30,0,30,0,0
7066,Wolfson Campus,BCH 3023 - 0003   Introductory Biochemistry,0003-LEC 1st Mon Sp,Staff,20,0,20,0,0
8269,North Campus,MCB 3023 - 0001   Principles Of Microbiology,0001-LEC Main Sess,Staff,40,25,15,0,0
8268,Kendall Campus,MCB 3023 - 0002   Principles Of Microbiology,0002-LEC Main Sess,Staff,24,13,11,0,0
7232,North Campus,BCH 3023L - 0001   Introductory Biochemistry Laboratory,0001-LAB Main Sess,Staff,20,18,2,0,0
7235,North Campus,BCH 3023L - 0002   Introductory Biochemistry Laboratory,0002-LAB Main Sess,Staff,23,18,5,0,0
7234,Kendall Campus,BCH 3023L - 0003   Introductory Biochemistry Laboratory,0003-LAB Main Sess,Staff,21,20,1,0,0
7233,Wolfson Campus,BCH 3023L - 0004   Introductory Biochemistry Laboratory,0004-LAB Main Sess,Staff,20,0,20,0,0
7791,North Campus,MCB 3023L - 0001,0001-LAB Main Sess,Staff,20,18,2,0,0
7793,North Campus,MCB 3023L - 0002,0002-LAB Main Sess,Staff,24,10,14,0,0
7792,Kendall Campus,MCB 3023L - 0003,0003-LAB Main Sess,Staff,24,15,9,0,0
15799,North Campus,ZOO 3021 - 0001   Survey Of Animal Diversity,0001-LEC Twelve Wk,Staff,1,0,1,0,0
7786,North Campus,BOT 3015 - 0001   Survey Of Plant Diversity,0001-LEC Main Sess,Staff,24,16,8,0,0
5861,North Campus,BOT 3015L - 0001   Survey Of Plant Diversity Laboratory,0001-LAB 1st Mon Sp,Staff,24,7,17,0,0
12432,Kendall Campus,RED 3013 - 0001   Foundations Of Reading Instruction,0001-LEC Main Sess,Staff,28,11,17,0,0
12436,Kendall Campus,RED 3013 - 0002   Foundations Of Reading Instruction,0002-LEC 1st Mon Sp,Staff,28,0,28,0,0
12433,InterAmerican Campus,RED 3013 - 0003   Foundations Of Reading Instruction,0003-LEC Main Sess,Staff,20,18,2,0,0
12435,InterAmerican Campus,RED 3013 - 0004   Foundations Of Reading Instruction,0004-LEC Conversion,Staff,21,8,13,0,0
12434,InterAmerican Campus,RED 3013 - 0005   Foundations Of Reading Instruction,0005-LEC Main Sess,Staff,28,11,17,0,0
16943,North Campus,RED 3009 - 0001   Early And Emergent Literacy,0001-LEC Main Sess,Staff,25,0,25,0,0
16944,Kendall Campus,RED 3009 - 0003   Early And Emergent Literacy,0003-LEC Main Sess,Staff,30,15,15,0,0
12134,North Campus,FIL 2990 - 0001   Selected Studies,0001-LEC Twelve Wk,Staff,30,12,18,0,0
7261,Kendall Campus,ART 2950 - 0001   Portfolio Preparation - Art,0001-LAB Main Sess,Staff,12,8,4,0,0
10395,Wolfson Campus,FSS 2950L - 0001   Culinary Competition,0001-LAB Twelve Wk,Staff,16,7,9,0,0
10396,Wolfson Campus,FSS 2950L - 0003   Culinary Competition,0003-LAB Twelve Wk,Staff,16,12,4,0,0
7254,Kendall Campus,ARC 2949 - 0001   Co-Op Work Experience 2: Arc,0001-LEC Main Sess,Staff,5,1,4,0,0
7967,Homestead Campus,BSC 2949 - 0001   Co-Op Wrk Exp 2: Bio,0001-LEC Conversion,Staff,10,0,10,0,0
7236,North Campus,CCJ 2949 - 0001   Co-Op Wrk Exp 2: Crj,0001-LEC 1st Mon Sp,Staff,20,5,15,0,0
5895,Homestead Campus,CHM 2949 - 0001,0001-LEC Main Sess,Staff,10,4,6,0,0
7588,North Campus,CIS 2949 - 0001   Co-Op Work Experience 2: Cis,0001-LEC Conversion,Staff,30,0,30,0,0
7586,North Campus,CIS 2949 - 0002   Co-Op Work Experience 2: Cis,0002-LEC Eight Wk 2,Staff,30,14,16,0,0
7587,Kendall Campus,CIS 2949 - 0003   Co-Op Work Experience 2: Cis,0003-LEC Conversion,Staff,5,1,4,0,0
11366,Wolfson Campus,GEB 2949 - 0001   Co-Op Experience 2: Geb,0001-LEC Conversion,Staff,30,7,23,0,0
16252,North Campus,GRA 2949 - 0001   Co-Op Wrk Exp 2: Grf,0001-LEC Main Sess,Staff,23,1,22,0,0
16253,North Campus,GRA 2949 - 0002   Co-Op Wrk Exp 2: Grf,0002-LEC Conversion,Staff,5,0,5,0,0
11211,Wolfson Campus,HFT 2949 - 0001   Co-Op Work Experience 2: Hft,0001-LEC Main Sess,Staff,25,7,18,0,0
11210,Wolfson Campus,HFT 2949 - 0002   Co-Op Work Experience 2: Hft,0002-LEC Main Sess,Staff,30,0,30,0,0
12242,Wolfson Campus,MUM 2949 - 0001   Co-Op Work Exp2: Mum,0001-LEC Main Sess,Staff,1,0,1,0,0
6854,North Campus,FIL 2945 - 0001   Film Internship,0001-OTH Twelve Wk,Staff,25,7,18,0,0
6853,North Campus,FIL 2945 - 0002   Film Internship,0002-OTH Main Sess,Staff,25,7,18,0,0
9400,North Campus,EDG 2943 - 0001   Educational Service Field Work,0001-LEC Twelve Wk,Staff,30,5,25,0,0
9402,North Campus,EDG 2943 - 0002   Educational Service Field Work,0002-LEC Weekend,Staff,30,0,30,0,0
9403,Kendall Campus,EDG 2943 - 0003   Educational Service Field Work,0003-LEC Weekend,Staff,25,0,25,0,0
9401,Homestead Campus,EDG 2943 - 0004   Educational Service Field Work,0004-LEC Weekend,Staff,25,23,2,0,0
5679,North Campus,BSC 2943L - 0001   Bioscience Internship,0001-LAB Main Sess,Staff,24,2,22,0,0
9795,North Campus,RTV 2942 - 0001   Spring Television Practicum,0001-LAB Main Sess,Staff,25,3,22,0,0
11383,Wolfson Campus,HUS 2941 - 0001   Human Services Addiction Counseling Practicum,0001-LEC Main Sess,Staff,47,11,36,0,0
13103,Wolfson Campus,PLA 2940 - 0001   Legal Assisting Internship,0001-LEC Weekend,Staff,20,19,1,0,0
9490,North Campus,RTV 2940 - 0001   Television Internship,0001-LEC Main Sess,Staff,25,3,22,0,0
12396,Wolfson Campus,PLA 2935 - 0001   Legal Specialty Seminars,0001-LEC Conversion,Staff,25,5,20,0,0
12397,Wolfson Campus,PLA 2935 - 0002   Legal Specialty Seminars,0002-LEC Conversion,Staff,25,0,25,0,0
13998,Kendall Campus,PLA 2934 - 0001   Legal Specialty Seminars,0001-LEC Conversion,Staff,25,0,25,0,0
13999,Wolfson Campus,PLA 2934 - 0002   Legal Specialty Seminars,0002-LEC Conversion,Staff,25,14,11,0,0
14000,Wolfson Campus,PLA 2934 - 0003   Legal Specialty Seminars,0003-LEC Conversion,Staff,25,0,25,0,0
14566,North Campus,FSE 2932 - 0001   Funeral Science Professional Review 2,0001-LAB Eight Wk 2,Staff,24,17,7,0,0
8654,Kendall Campus,ORH 2932 - 0001   Special Topics In Landscaping,0001-LEC Twelve Wk,Staff,30,0,30,0,0
13997,Kendall Campus,PLA 2932 - 0001   Legal Specialty Seminars,0001-LEC Conversion,Staff,25,7,18,0,0
13996,Wolfson Campus,PLA 2932 - 0002   Legal Specialty Seminars,0002-LEC Conversion,Staff,25,15,10,0,0
8360,North Campus,FSE 2931 - 0001   Funeral Service Professional Review 1,0001-LAB Eight Wk 1,Staff,24,22,2,0,0
9787,Kendall Campus,PLA 2931 - 0001   Legal Specialty Seminars,0001-LEC Conversion,Staff,25,8,17,0,0
9788,Wolfson Campus,PLA 2931 - 0002   Legal Specialty Seminars,0002-LEC Conversion,Staff,25,18,7,0,0
11280,Wolfson Campus,HUS 2902 - 0001   Directed Independent Study In Addiction Treatment,0001-LEC Main Sess,Staff,45,0,45,0,0
16909,Medical Campus,OPT 2876L - 0001   Ophthalmic Dispensing Practicum 2,0001-LAB Main Sess,Staff,15,8,7,0,0
16911,Medical Campus,OPT 2876L - 0002   Ophthalmic Dispensing Practicum 2,0002-LAB Main Sess,Staff,15,7,8,0,0
16910,Medical Campus,OPT 2876L - 0003   Ophthalmic Dispensing Practicum 2,0003-LAB Main Sess,Staff,15,9,6,0,0
16915,Medical Campus,PAS 2876L - 0001   Emergency Medicine,0001-CLN Main Sess,Staff,30,22,8,0,0
11976,Medical Campus,PAS 2870L - 0001   Obstetrics/Gynecology,0001-CLN Main Sess,Staff,25,20,5,0,0
13075,Medical Campus,PAS 2866L - 0001   Family Medicine,0001-CLN Main Sess,Staff,25,18,7,0,0
8673,Medical Campus,PAS 2860L - 0001   Pediatrics,0001-CLN Main Sess,Staff,15,9,6,0,0
8672,Medical Campus,PAS 2860L - 0002   Pediatrics,0002-CLN Main Sess,Staff,15,12,3,0,0
9636,Medical Campus,PAS 2850L - 0002   Surgery,0002-CLN Main Sess,Staff,15,12,3,0,0
12014,Medical Campus,RTE 2844 - 0001   Radiographic Clinic 5,0001-CLN Main Sess,Staff,10,7,3,0,0
12015,Medical Campus,RTE 2844 - 0002   Radiographic Clinic 5,0002-CLN Main Sess,Staff,10,7,3,0,0
12018,Medical Campus,RTE 2844 - 0003   Radiographic Clinic 5,0003-CLN Main Sess,Staff,10,6,4,0,0
12017,Medical Campus,RTE 2844 - 0004   Radiographic Clinic 5,0004-CLN Main Sess,Staff,10,6,4,0,0
12016,Medical Campus,RTE 2844 - 0005   Radiographic Clinic 5,0005-CLN Main Sess,Staff,10,6,4,0,0
15786,Medical Campus,SON 2844 - 0003   Clinic 5,0003-LEC Main Sess,Staff,7,6,1,0,0
15785,Medical Campus,SON 2844 - 0004   Clinic 5,0004-LEC Main Sess,Staff,7,2,5,0,0
12615,InterAmerican Campus,SPT 2842 - 0001   Contrastive Analysis Spanish/English,0001-LEC Main Sess,Staff,30,11,19,0,0
10401,Medical Campus,MLT 2841L - 0001   Histotechnology Practicum 2,0001-CLN Main Sess,Staff,20,0,20,0,0
16450,Medical Campus,PAS 2841L - 0001   Geriatrics,0001-CLN Main Sess,Staff,20,11,9,0,0
9635,Medical Campus,PAS 2840L - 0001   Internal Medicine,0001-LAB Main Sess,Staff,15,7,8,0,0
9634,Medical Campus,PAS 2840L - 0002   Internal Medicine,0002-LAB Main Sess,Staff,10,8,2,0,0
12006,Medical Campus,RET 2835 - 0001   Respiratory Care Clinic 4,0001-CLN Main Sess,Staff,6,5,1,0,0
12007,Medical Campus,RET 2835 - 0002   Respiratory Care Clinic 4,0002-CLN Main Sess,Staff,6,5,1,0,0
12009,Medical Campus,RET 2835 - 0004   Respiratory Care Clinic 4,0004-CLN Main Sess,Staff,6,0,6,0,0
12010,Medical Campus,RET 2835 - 0005   Respiratory Care Clinic 4,0005-CLN Main Sess,Staff,6,5,1,0,0
12008,Medical Campus,RET 2835 - 0006   Respiratory Care Clinic 4,0006-CLN Main Sess,Staff,6,0,6,0,0
13213,Medical Campus,RET 2832 - 0002   Respiratory Care Clinic 1,0002-CLN Main Sess,Staff,6,0,6,0,0
13217,Medical Campus,RET 2832 - 0003   Respiratory Care Clinic 1,0003-CLN Main Sess,Staff,6,5,1,0,0
11968,Medical Campus,OPT 2831L - 0001   Contact Lense Clinic 2,0001-CLN 1st Mon Sp,Staff,14,9,5,0,0
11967,Medical Campus,OPT 2831L - 0002   Contact Lense Clinic 2,0002-CLN 1st Mon Sp,Staff,14,8,6,0,0
11966,Medical Campus,OPT 2831L - 0003   Contact Lense Clinic 2,0003-CLN Main Sess,Staff,14,9,5,0,0
11148,InterAmerican Campus,FOT 2829 - 0001   Financial And Business Translation,0001-LEC Main Sess,Staff,21,12,9,0,0
8359,InterAmerican Campus,FOT 2828 - 0001   Medical Interpretation,0001-LEC 1st Mon Sp,Staff,25,6,19,0,0
15259,InterAmerican Campus,FOT 2827 - 0001   Medical Translation,0001-LEC Main Sess,Staff,25,18,7,0,0
12135,InterAmerican Campus,FOT 2825 - 0001   Computer Assisted Translation 1,0001-LEC Main Sess,Staff,25,15,10,0,0
10342,InterAmerican Campus,FOT 2824 - 0001   Simultaneous Interpretation Strategies,0001-LEC Main Sess,Staff,25,10,15,0,0
5854,Homestead Campus,ATT 2823 - 0001   Air Traffic Control (Atc) Non-Radar,0001-LEC Conversion,Staff,30,12,18,0,0
5853,Homestead Campus,ATT 2823 - 0002   Air Traffic Control (Atc) Non-Radar,0002-LEC Main Sess,Staff,30,0,30,0,0
11340,InterAmerican Campus,FOT 2823 - 0001   Consecutive Interpretation,0001-LEC Main Sess,Staff,25,18,7,0,0
7663,Homestead Campus,ATT 2822 - 0001   Vfr Tower Operations,0001-LEC Conversion,Staff,30,14,16,0,0
13878,Wolfson Campus,COP 2822 - 0001   Web Page Design And Programming,0001-LEC Main Sess,Staff,30,0,30,0,0
16238,InterAmerican Campus,FOT 2822 - 0001   Court Interpreting Skills,0001-LEC Main Sess,Staff,25,8,17,0,0
8766,Homestead Campus,ATT 2821 - 0001   Air Traffic Control (Atc) Radar,0001-LEC Conversion,Staff,30,11,19,0,0
15258,InterAmerican Campus,FOT 2821 - 0001   Introduction To Interpretation,0001-LEC Main Sess,Staff,21,10,11,0,0
7181,Homestead Campus,ATT 2820 - 0001   Air Traffic Control,0001-LEC Main Sess,Staff,30,0,30,0,0
7183,Homestead Campus,ATT 2820 - 0002   Air Traffic Control,0002-LEC Main Sess,Staff,30,15,15,0,0
7182,Homestead Campus,ATT 2820 - 0003   Air Traffic Control,0003-LEC Main Sess,Staff,30,18,12,0,0
6401,Medical Campus,HIM 2820 - 0001   Seminar And Professional Practice Experience 3,0001-CLN Conversion,Staff,25,4,21,0,0
11382,Wolfson Campus,HUS 2820 - 0001   Field Experience In Human Service,0001-OTH Main Sess,Staff,47,7,40,0,0
11333,North Campus,FFP 2810 - 0001   Fire Fighting Tactics And Strategy,0001-LEC Conversion,Staff,20,7,13,0,0
15284,Medical Campus,HIM 2810 - 0001   Professional Practice Experience 2,0001-LAB Main Sess,Staff,10,5,5,0,0
15285,Medical Campus,HIM 2810 - 0002   Professional Practice Experience 2,0002-LAB Conversion,Staff,25,21,4,0,0
13991,Medical Campus,PHT 2810 - 0001   Clinical Practice And Conference 2,0001-CLN Main Sess,Staff,15,14,1,0,0
13994,Medical Campus,PHT 2810 - 0002   Clinical Practice And Conference 2,0002-CLN Main Sess,Staff,15,10,5,0,0
13993,Medical Campus,PHT 2810 - 0003   Clinical Practice And Conference 2,0003-CLN Main Sess,Staff,15,12,3,0,0
13992,Medical Campus,PHT 2810 - 0004   Clinical Practice And Conference 2,0004-CLN Main Sess,Staff,15,13,2,0,0
10774,Medical Campus,DEH 2808 - 0001   Dental Hygiene 5,0001-LEC 1st Mon Sp,Staff,50,38,12,0,0
6822,Medical Campus,DEH 2808L - 0001   Dental Hygiene 5 Clinic,0001-LAB Main Sess,Staff,7,5,2,0,0
6823,Medical Campus,DEH 2808L - 0002   Dental Hygiene 5 Clinic,0002-LAB Main Sess,Staff,7,5,2,0,0
6824,Medical Campus,DEH 2808L - 0003   Dental Hygiene 5 Clinic,0003-LAB Main Sess,Staff,7,4,3,0,0
6828,Medical Campus,DEH 2808L - 0004   Dental Hygiene 5 Clinic,0004-LAB Main Sess,Staff,7,5,2,0,0
6827,Medical Campus,DEH 2808L - 0006   Dental Hygiene 5 Clinic,0006-LAB Main Sess,Staff,7,5,2,0,0
6825,Medical Campus,DEH 2808L - 0007   Dental Hygiene 5 Clinic,0007-LAB Main Sess,Staff,7,6,1,0,0
10754,North Campus,COP 2805 - 0001   Advanced Java Programming,0001-LEC Main Sess,Staff,25,12,13,0,0
10755,Kendall Campus,COP 2805 - 0002   Advanced Java Programming,0002-LEC Main Sess,Staff,21,0,21,0,0
10756,Hialeah Campus,COP 2805 - 0003   Advanced Java Programming,0003-LEC Eight Wk 2,Staff,30,6,24,0,0
11147,InterAmerican Campus,FOT 2802 - 0001   Introduction To Translation,0001-LEC Main Sess,Staff,30,12,18,0,0
9631,Medical Campus,OPT 2802L - 0001   Vision Care Clinic 3,0001-LAB Conversion,Staff,14,8,6,0,0
9632,Medical Campus,OPT 2802L - 0002   Vision Care Clinic 3,0002-LAB Conversion,Staff,14,9,5,0,0
9630,Medical Campus,OPT 2802L - 0003   Vision Care Clinic 3,0003-LAB Main Sess,Staff,14,8,6,0,0
5501,North Campus,COP 2800 - 0001   Java Programming,0001-LEC Main Sess,Staff,25,21,4,0,0
5510,North Campus,COP 2800 - 0002   Java Programming,0002-LEC 1st Mon Sp,Staff,25,20,5,0,0
5503,Kendall Campus,COP 2800 - 0004   Java Programming,0004-LEC Main Sess,Staff,40,34,6,0,0
5504,Wolfson Campus,COP 2800 - 0005   Java Programming,0005-LEC Main Sess,Staff,24,23,1,0,0
5505,Wolfson Campus,COP 2800 - 0006   Java Programming,0006-LEC Main Sess,Staff,24,22,2,0,0
5506,Wolfson Campus,COP 2800 - 0007   Java Programming,0007-LEC Main Sess,Staff,22,11,11,0,0
5508,Wolfson Campus,COP 2800 - 0008   Java Programming,0008-LEC Main Sess,Staff,30,23,7,0,0
5507,Wolfson Campus,COP 2800 - 0009   Java Programming,0009-LEC Main Sess,Staff,30,24,6,0,0
5509,Hialeah Campus,COP 2800 - 0010   Java Programming,0010-LEC Eight Wk 1,Staff,30,18,12,0,0
5511,Hialeah Campus,COP 2800 - 0011   Java Programming,0011-LEC Weekend,Staff,30,0,30,0,0
8367,Wolfson Campus,HFT 2800 - 0001   Food And Beverage Management,0001-LEC Twelve Wk,Staff,30,13,17,0,0
8366,Wolfson Campus,HFT 2800 - 0002   Food And Beverage Management,0002-LEC Main Sess,Staff,30,23,7,0,0
13202,Kendall Campus,PSY 2800 - 0001   Psychology Of Genocide,0001-LEC Main Sess,Staff,30,12,18,0,0
13205,Kendall Campus,PSY 2800 - 0002   Psychology Of Genocide,0002-LEC Main Sess,Staff,30,0,30,0,0
13204,Wolfson Campus,PSY 2800 - 0003   Psychology Of Genocide,0003-LEC Main Sess,Staff,35,27,8,0,0
13203,Homestead Campus,PSY 2800 - 0004   Psychology Of Genocide,0004-LEC Main Sess,Staff,39,19,20,0,0
9649,North Campus,SOP 2772 - 0001   Human Sexuality,0001-LEC Main Sess,Staff,40,26,14,0,0
9650,North Campus,SOP 2772 - 0002   Human Sexuality,0002-LEC Main Sess,Staff,40,39,1,0,0
9653,Kendall Campus,SOP 2772 - 0003   Human Sexuality,0003-LEC Main Sess,Staff,48,10,38,0,0
9654,Kendall Campus,SOP 2772 - 0004   Human Sexuality,0004-LEC Main Sess,Staff,48,29,19,0,0
9665,Kendall Campus,SOP 2772 - 0005   Human Sexuality,0005-LEC Twelve Wk,Staff,35,32,3,0,0
9655,Kendall Campus,SOP 2772 - 0006   Human Sexuality,0006-LEC Main Sess,Staff,48,46,2,0,0
9656,Kendall Campus,SOP 2772 - 0007   Human Sexuality,0007-LEC Main Sess,Staff,48,47,1,0,0
9657,Kendall Campus,SOP 2772 - 0008   Human Sexuality,0008-LEC Main Sess,Staff,48,46,2,0,0
9658,Kendall Campus,SOP 2772 - 0009   Human Sexuality,0009-LEC Main Sess,Staff,30,0,30,0,0
9659,Kendall Campus,SOP 2772 - 0010   Human Sexuality,0010-LEC Main Sess,Staff,45,17,28,0,0
9660,Kendall Campus,SOP 2772 - 0011   Human Sexuality,0011-LEC Main Sess,Staff,30,0,30,0,0
9666,Wolfson Campus,SOP 2772 - 0012   Human Sexuality,0012-LEC Conversion,Staff,15,0,15,0,0
9662,Wolfson Campus,SOP 2772 - 0014   Human Sexuality,0014-LEC Main Sess,Staff,47,30,17,0,0
9663,Homestead Campus,SOP 2772 - 0015   Human Sexuality,0015-LEC Main Sess,Staff,30,0,30,0,0
9664,Homestead Campus,SOP 2772 - 0016   Human Sexuality,0016-LEC Main Sess,Staff,30,21,9,0,0
9652,Hialeah Campus,SOP 2772 - 0017   Human Sexuality,0017-LEC Main Sess,Staff,31,24,7,0,0
9651,West Campus,SOP 2772 - 0018   Human Sexuality,0018-LEC Main Sess,Staff,35,17,18,0,0
9667,West Campus,SOP 2772 - 0019   Human Sexuality,0019-LEC Conversion,Staff,35,15,20,0,0
6060,Kendall Campus,BCT 2760 - 0001   Building Code Regulations,0001-LEC Main Sess,Staff,9,0,9,0,0
14634,Kendall Campus,HFT 2750 - 0001   Event And Meeting Management,0001-LEC Conversion,Staff,35,6,29,0,0
14632,Wolfson Campus,HFT 2750 - 0002   Event And Meeting Management,0002-LEC Main Sess,Staff,30,23,7,0,0
14633,Wolfson Campus,HFT 2750 - 0003   Event And Meeting Management,0003-LEC Main Sess,Staff,6,0,6,0,0
6685,Kendall Campus,ARH 2740 - 0001   Cinema Appreciation,0001-LEC Main Sess,Staff,37,32,5,0,0
6696,Kendall Campus,ARH 2740 - 0002   Cinema Appreciation,0002-LEC Weekend,Staff,40,37,3,0,0
6694,Kendall Campus,ARH 2740 - 0003   Cinema Appreciation,0003-LEC Twelve Wk,Staff,35,20,15,0,0
6686,Kendall Campus,ARH 2740 - 0004   Cinema Appreciation,0004-LEC Main Sess,Staff,40,37,3,0,0
6687,Kendall Campus,ARH 2740 - 0005   Cinema Appreciation,0005-LEC Main Sess,Staff,30,28,2,0,0
6695,Kendall Campus,ARH 2740 - 0007   Cinema Appreciation,0007-LEC Twelve Wk,Staff,35,21,14,0,0
6690,Wolfson Campus,ARH 2740 - 0009   Cinema Appreciation,0009-LEC Main Sess,Staff,50,22,28,0,0
6693,Wolfson Campus,ARH 2740 - 0010   Cinema Appreciation,0010-LEC Main Sess,Staff,47,44,3,0,0
6692,Homestead Campus,ARH 2740 - 0011   Cinema Appreciation,0011-LEC Main Sess,Staff,39,31,8,0,0
6691,InterAmerican Campus,ARH 2740 - 0012   Cinema Appreciation,0012-LEC Main Sess,Staff,33,27,6,0,0
11370,North Campus,GRA 2727 - 0001   Streaming Media Creation,0001-LEC Main Sess,Staff,20,0,20,0,0
9036,Kendall Campus,MUN 2712 - 0001   Studio Jazz,0001-LEC Main Sess,Staff,25,22,3,0,0
9038,Kendall Campus,MUN 2712 - 0002   Studio Jazz,0002-LEC Main Sess,Staff,25,0,25,0,0
9037,Wolfson Campus,MUN 2712 - 0003   Studio Jazz,0003-LEC Main Sess,Staff,15,0,15,0,0
10429,Kendall Campus,MUN 2711 - 0001   Jazz Ensemble,0001-LAB Main Sess,Staff,15,13,2,0,0
10430,Kendall Campus,MUN 2711 - 0002   Jazz Ensemble,0002-LAB Main Sess,Staff,20,0,20,0,0
10431,Wolfson Campus,MUN 2711 - 0003   Jazz Ensemble,0003-LAB Main Sess,Staff,15,13,2,0,0
10432,Wolfson Campus,MUN 2711 - 0004   Jazz Ensemble,0004-LAB Main Sess,Staff,10,9,1,0,0
10433,Wolfson Campus,MUN 2711 - 0005   Jazz Ensemble,0005-LAB Conversion,Staff,25,5,20,0,0
6054,Medical Campus,ATE 2710 - 0001   Animal Emergency Medicine,0001-LEC Main Sess,Staff,18,15,3,0,0
16367,North Campus,MUM 2704 - 0001   Music Business 4-Computer Applications,0001-LAB 1st Mon Sp,Staff,25,15,10,0,0
16366,Kendall Campus,MUM 2704 - 0002   Music Business 4-Computer Applications,0002-LAB Main Sess,Staff,25,9,16,0,0
7827,North Campus,MUM 2703 - 0001   Music Business 3-Computer,0001-LAB Main Sess,Staff,25,17,8,0,0
7830,Kendall Campus,MUM 2703 - 0002   Music Business 3-Computer,0002-LAB Main Sess,Staff,25,22,3,0,0
7829,Kendall Campus,MUM 2703 - 0003   Music Business 3-Computer,0003-LAB Main Sess,Staff,25,11,14,0,0
7828,Wolfson Campus,MUM 2703 - 0004   Music Business 3-Computer,0004-LAB Main Sess,Staff,30,0,30,0,0
5949,North Campus,ARC 2702 - 0001   History of Architecture 2,0001-LEC Main Sess,Staff,24,12,12,0,0
5948,Kendall Campus,ARC 2702 - 0002   History of Architecture 2,0002-LEC Main Sess,Staff,36,32,4,0,0
5951,Wolfson Campus,ARC 2702 - 0003   History of Architecture 2,0003-LEC Main Sess,Staff,30,14,16,0,0
5950,Wolfson Campus,ARC 2702 - 0004   History of Architecture 2,0004-LEC Main Sess,Staff,35,14,21,0,0
9032,North Campus,MUM 2702 - 0001   Music Business 2-Careers,0001-LEC Main Sess,Staff,25,12,13,0,0
9035,North Campus,MUM 2702 - 0002   Music Business 2-Careers,0002-LEC Main Sess,Staff,25,15,10,0,0
9034,Kendall Campus,MUM 2702 - 0003   Music Business 2-Careers,0003-LEC Main Sess,Staff,30,24,6,0,0
9033,Wolfson Campus,MUM 2702 - 0004   Music Business 2-Careers,0004-LEC Main Sess,Staff,30,0,30,0,0
14083,Homestead Campus,TRA 2702 - 0001   International Logistics And Transportation,0001-LEC Eight Wk 2,Staff,30,0,30,0,0
6076,Medical Campus,DEH 2702L - 0001   Community Dental Health 2 Clinic,0001-LAB Main Sess,Staff,45,38,7,0,0
5714,North Campus,ARC 2701 - 0001   History Of Architecture 1,0001-LEC Main Sess,Staff,24,13,11,0,0
5715,North Campus,ARC 2701 - 0002   History Of Architecture 1,0002-LEC Main Sess,Staff,25,15,10,0,0
5718,Kendall Campus,ARC 2701 - 0003   History Of Architecture 1,0003-LEC Main Sess,Staff,49,45,4,0,0
5717,Kendall Campus,ARC 2701 - 0004   History Of Architecture 1,0004-LEC Main Sess,Staff,35,29,6,0,0
5716,Wolfson Campus,ARC 2701 - 0005   History Of Architecture 1,0005-LEC Main Sess,Staff,35,26,9,0,0
7820,North Campus,MUM 2700 - 0001   Music Business 1,0001-LEC Main Sess,Staff,40,33,7,0,0
7822,Kendall Campus,MUM 2700 - 0002   Music Business 1,0002-LEC Main Sess,Staff,30,26,4,0,0
7821,Kendall Campus,MUM 2700 - 0003   Music Business 1,0003-LEC Main Sess,Staff,30,13,17,0,0
5827,North Campus,ARC 2681 - 0001   Environmental Technology,0001-LEC Main Sess,Staff,30,6,24,0,0
13913,Kendall Campus,DAA 2681 - 0001   Repertory 2,0001-LEC Main Sess,Staff,30,13,17,0,0
13912,Wolfson Campus,DAA 2681 - 0002   Repertory 2,0002-LEC Main Sess,Staff,10,0,10,0,0
6725,Wolfson Campus,DAA 2680 - 0001   Repertory 1,0001-LEC Main Sess,Staff,10,5,5,0,0
6726,Wolfson Campus,DAA 2680 - 0002   Repertory 1,0002-LEC Conversion,Staff,30,27,3,0,0
8596,Medical Campus,NUR 2680L - 0002   Community Health Nursing Lab,0002-CLN Conversion,Staff,10,8,2,0,0
8572,Medical Campus,NUR 2680L - 0003   Community Health Nursing Lab,0003-CLN Conversion,Staff,10,9,1,0,0
8587,Medical Campus,NUR 2680L - 0008   Community Health Nursing Lab,0008-CLN Conversion,Staff,10,0,10,0,0
8588,Medical Campus,NUR 2680L - 0009   Community Health Nursing Lab,0009-CLN Conversion,Staff,10,0,10,0,0
8576,Medical Campus,NUR 2680L - 0011   Community Health Nursing Lab,0011-CLN Conversion,Staff,10,0,10,0,0
8589,Medical Campus,NUR 2680L - 0013   Community Health Nursing Lab,0013-CLN Conversion,Staff,10,0,10,0,0
8590,Medical Campus,NUR 2680L - 0014   Community Health Nursing Lab,0014-CLN Conversion,Staff,10,0,10,0,0
8591,Medical Campus,NUR 2680L - 0015   Community Health Nursing Lab,0015-CLN Conversion,Staff,10,8,2,0,0
8578,Medical Campus,NUR 2680L - 0016   Community Health Nursing Lab,0016-CLN Conversion,Staff,10,9,1,0,0
8579,Medical Campus,NUR 2680L - 0017   Community Health Nursing Lab,0017-CLN Conversion,Staff,10,9,1,0,0
8571,Medical Campus,NUR 2680L - 0019   Community Health Nursing Lab,0019-CLN Conversion,Staff,10,0,10,0,0
8592,Medical Campus,NUR 2680L - 0021   Community Health Nursing Lab,0021-CLN Conversion,Staff,10,0,10,0,0
8593,Medical Campus,NUR 2680L - 0022   Community Health Nursing Lab,0022-CLN Conversion,Staff,10,6,4,0,0
8585,Homestead Campus,NUR 2680L - 0026   Community Health Nursing Lab,0026-CLN Conversion,Staff,10,8,2,0,0
8586,Homestead Campus,NUR 2680L - 0027   Community Health Nursing Lab,0027-CLN Conversion,Staff,10,8,2,0,0
8497,North Campus,CJE 2672 - 0001   Fingerprint Development,0001-LEC Main Sess,Staff,40,30,10,0,0
9521,North Campus,CJE 2671 - 0001   Basic Fingerprinting,0001-LEC Main Sess,Staff,40,38,2,0,0
9523,North Campus,CJE 2671 - 0002   Basic Fingerprinting,0002-LEC Main Sess,Staff,40,24,16,0,0
9522,Wolfson Campus,CJE 2671 - 0003   Basic Fingerprinting,0003-LEC Main Sess,Staff,40,20,20,0,0
5971,Homestead Campus,ASC 2670 - 0001   Aircraft Systems,0001-LEC Main Sess,Staff,30,21,9,0,0
5970,Homestead Campus,ASC 2670 - 0002   Aircraft Systems,0002-LEC Main Sess,Staff,30,0,30,0,0
10046,Medical Campus,EMS 2665 - 0001   Paramedic Clinic 2,0001-CLN Main Sess,Staff,6,5,1,0,0
10047,Medical Campus,EMS 2665 - 0002   Paramedic Clinic 2,0002-CLN Main Sess,Staff,6,5,1,0,0
10048,Medical Campus,EMS 2665 - 0003   Paramedic Clinic 2,0003-CLN Main Sess,Staff,6,4,2,0,0
10049,Medical Campus,EMS 2665 - 0004   Paramedic Clinic 2,0004-CLN Main Sess,Staff,6,5,1,0,0
10050,Medical Campus,EMS 2665 - 0005   Paramedic Clinic 2,0005-CLN Main Sess,Staff,6,5,1,0,0
10052,Medical Campus,EMS 2665 - 0007   Paramedic Clinic 2,0007-CLN Main Sess,Staff,6,4,2,0,0
10053,Medical Campus,EMS 2665 - 0008   Paramedic Clinic 2,0008-CLN Main Sess,Staff,6,0,6,0,0
12115,Medical Campus,EMS 2664 - 0003   Paramedic Clinic 1,0003-CLN Conversion,Staff,6,5,1,0,0
12120,Medical Campus,EMS 2664 - 0004   Paramedic Clinic 1,0004-CLN Conversion,Staff,6,0,6,0,0
12118,Medical Campus,EMS 2664 - 0006   Paramedic Clinic 1,0006-CLN Conversion,Staff,6,0,6,0,0
9536,Wolfson Campus,COP 2662 - 0001   Android Application Development 2,0001-LEC Conversion,Staff,28,11,17,0,0
5947,Wolfson Campus,COP 2660 - 0001   Android Application Development 1,0001-LEC Eight Wk 1,Staff,28,16,12,0,0
6304,Medical Campus,EMS 2659 - 0001   Ems-Field Internship And Conference,0001-CLN Conversion,Staff,6,0,6,0,0
6306,Medical Campus,EMS 2659 - 0003   Ems-Field Internship And Conference,0003-CLN Conversion,Staff,6,5,1,0,0
6312,Medical Campus,EMS 2659 - 0005   Ems-Field Internship And Conference,0005-CLN Conversion,Staff,6,0,6,0,0
6311,Medical Campus,EMS 2659 - 0008   Ems-Field Internship And Conference,0008-CLN Conversion,Staff,6,4,2,0,0
6308,Medical Campus,EMS 2659 - 0009   Ems-Field Internship And Conference,0009-CLN Conversion,Staff,6,0,6,0,0
7454,North Campus,CTS 2653 - 0001   Ccna 4: Connecting Networks,0001-LEC Eight Wk 2,Staff,24,0,24,0,0
7456,Kendall Campus,CTS 2653 - 0002   Ccna 4: Connecting Networks,0002-LEC Eight Wk 2,Staff,28,20,8,0,0
8675,North Campus,CTS 2652 - 0001   Ccna 3: Advanced Routing And Switching,0001-LEC Eight Wk 1,Staff,24,0,24,0,0
8677,Kendall Campus,CTS 2652 - 0002   Ccna 3: Advanced Routing And Switching,0002-LEC Eight Wk 1,Staff,28,17,11,0,0
5986,Medical Campus,ATE 2652L - 0002   Introduction To Clinical Practice 2,0002-LAB Main Sess,Staff,8,5,3,0,0
5739,North Campus,CCJ 2650 - 0001   Narcotics And Dangerous Substances,0001-LEC Main Sess,Staff,40,35,5,0,0
5740,North Campus,CCJ 2650 - 0002   Narcotics And Dangerous Substances,0002-LEC Main Sess,Staff,40,33,7,0,0
5741,North Campus,CCJ 2650 - 0003   Narcotics And Dangerous Substances,0003-LEC Main Sess,Staff,40,21,19,0,0
5742,Kendall Campus,CCJ 2650 - 0004   Narcotics And Dangerous Substances,0004-LEC Main Sess,Staff,36,35,1,0,0
5746,Wolfson Campus,CCJ 2650 - 0005   Narcotics And Dangerous Substances,0005-LEC Conversion,Staff,34,17,17,0,0
5743,Wolfson Campus,CCJ 2650 - 0006   Narcotics And Dangerous Substances,0006-LEC Main Sess,Staff,34,31,3,0,0
5744,Hialeah Campus,CCJ 2650 - 0007   Narcotics And Dangerous Substances,0007-LEC Main Sess,Staff,30,0,30,0,0
5745,West Campus,CCJ 2650 - 0008   Narcotics And Dangerous Substances,0008-LEC Main Sess,Staff,35,0,35,0,0
7029,North Campus,CJE 2644 - 0001   Crime Scene Safety,0001-LEC Main Sess,Staff,30,28,2,0,0
16761,North Campus,MUT 2642 - 0001   Jazz Improvisation 2,0001-LEC Main Sess,Staff,20,0,20,0,0
16760,Wolfson Campus,MUT 2642 - 0002   Jazz Improvisation 2,0002-LEC Main Sess,Staff,15,0,15,0,0
16388,North Campus,MUT 2641 - 0001   Introduction To Jazz Improvisation 1,0001-LEC Main Sess,Staff,12,5,7,0,0
16387,Kendall Campus,MUT 2641 - 0002   Introduction To Jazz Improvisation 1,0002-LEC Main Sess,Staff,15,0,15,0,0
7654,Medical Campus,ATE 2638 - 0001   Animal Lab Procedures 1,0001-LEC Conversion,Staff,30,25,5,0,0
6061,Medical Campus,ATE 2638L - 0001   Animal Lab Procedures 1 Laboratory,0001-LAB Main Sess,Staff,8,6,2,0,0
6064,Medical Campus,ATE 2638L - 0002   Animal Lab Procedures 1 Laboratory,0002-LAB Main Sess,Staff,8,7,1,0,0
5847,Medical Campus,ATE 2636 - 0001   Large Animal Clinic & Nursing Skills,0001-LEC Main Sess,Staff,25,24,1,0,0
8539,Wolfson Campus,DAN 2631 - 0001   Literature & Materials Of Music For Dance 2,0001-LEC Main Sess,Staff,35,0,35,0,0
8538,Wolfson Campus,DAN 2631 - 0002   Literature & Materials Of Music For Dance 2,0002-LEC Main Sess,Staff,5,0,5,0,0
9555,Wolfson Campus,DAN 2630 - 0001   Literature & Materials Of Music For Dance 1,0001-LEC Conversion,Staff,40,27,13,0,0
13985,Kendall Campus,PEO 2621 - 0001   Skills And Practices Basketball,0001-LEC Main Sess,Staff,30,17,13,0,0
10399,Medical Campus,MLT 2620L - 0001   Clinical Chemistry 2 Laboratory,0001-LAB Conversion,Staff,20,13,7,0,0
10398,Medical Campus,MLT 2620L - 0002   Clinical Chemistry 2 Laboratory,0002-LAB Conversion,Staff,20,10,10,0,0
8765,Medical Campus,ATE 2614 - 0001   Animal Medicine 2,0001-LEC Main Sess,Staff,25,15,10,0,0
7180,Medical Campus,ATE 2612 - 0001   Small Animal Nursing 2,0001-LEC Main Sess,Staff,25,16,9,0,0
11133,Wolfson Campus,ENT 2612 - 0002   Creativity· Innovation And Human Centered Design,0002-LEC Twelve Wk,Staff,25,21,4,0,0
8687,Kendall Campus,DAA 2611 - 0001   Dance Composition And Improvisation 2,0001-LEC Main Sess,Staff,25,11,14,0,0
8353,North Campus,FIL 2611 - 0001   Film Business Marketing Distribution Exhibition,0001-LEC Main Sess,Staff,30,27,3,0,0
8352,Kendall Campus,FIL 2611 - 0002   Film Business Marketing Distribution Exhibition,0002-LEC Main Sess,Staff,30,29,1,0,0
5499,North Campus,CJL 2610 - 0001   Courtroom Presentation,0001-LEC Conversion,Staff,30,0,30,0,0
12450,North Campus,SPC 2608 - 0001   Introduction To Public Speaking,0001-LEC Main Sess,Staff,28,21,7,0,0
12451,Kendall Campus,SPC 2608 - 0002   Introduction To Public Speaking,0002-LEC Main Sess,Staff,30,29,1,0,0
12452,Kendall Campus,SPC 2608 - 0003   Introduction To Public Speaking,0003-LEC Main Sess,Staff,30,28,2,0,0
12456,Kendall Campus,SPC 2608 - 0004   Introduction To Public Speaking,0004-LEC Main Sess,Staff,30,19,11,0,0
12454,Wolfson Campus,SPC 2608 - 0005   Introduction To Public Speaking,0005-LEC Main Sess,Staff,30,28,2,0,0
12455,Homestead Campus,SPC 2608 - 0006   Introduction To Public Speaking,0006-LEC Main Sess,Staff,25,10,15,0,0
12453,Hialeah Campus,SPC 2608 - 0007   Introduction To Public Speaking,0007-LEC Main Sess,Staff,30,14,16,0,0
16263,InterAmerican Campus,LIN 2606 - 0001   Introduction To Sociolinguistics,0001-LEC 1st Mon Sp,Staff,25,12,13,0,0
16757,Kendall Campus,MUM 2605 - 0001   Multi-Track Production Techniques 1,0001-LEC Main Sess,Staff,30,5,25,0,0
15310,North Campus,MAN 2604 - 0001   Managing In A Multi-Cultural Environment,0001-LEC Main Sess,Staff,25,0,25,0,0
15309,Wolfson Campus,MAN 2604 - 0002   Managing In A Multi-Cultural Environment,0002-LEC Main Sess,Staff,30,21,9,0,0
15443,North Campus,PHI 2604 - 0001   Critical Thinking/Ethics,0001-LEC Main Sess,Staff,40,37,3,0,0
15444,North Campus,PHI 2604 - 0002   Critical Thinking/Ethics,0002-LEC Main Sess,Staff,40,39,1,0,0
15446,North Campus,PHI 2604 - 0004   Critical Thinking/Ethics,0004-LEC Main Sess,Staff,40,37,3,0,0
15447,North Campus,PHI 2604 - 0005   Critical Thinking/Ethics,0005-LEC Main Sess,Staff,40,39,1,0,0
15448,North Campus,PHI 2604 - 0006   Critical Thinking/Ethics,0006-LEC Main Sess,Staff,40,38,2,0,0
15449,North Campus,PHI 2604 - 0007   Critical Thinking/Ethics,0007-LEC Main Sess,Staff,40,37,3,0,0
15450,North Campus,PHI 2604 - 0008   Critical Thinking/Ethics,0008-LEC Main Sess,Staff,40,21,19,0,0
15451,North Campus,PHI 2604 - 0009   Critical Thinking/Ethics,0009-LEC Main Sess,Staff,40,38,2,0,0
15453,North Campus,PHI 2604 - 0011   Critical Thinking/Ethics,0011-LEC Main Sess,Staff,40,38,2,0,0
15454,North Campus,PHI 2604 - 0012   Critical Thinking/Ethics,0012-LEC Main Sess,Staff,40,37,3,0,0
15542,North Campus,PHI 2604 - 0013   Critical Thinking/Ethics,0013-LEC Main Sess,Staff,45,0,45,0,0
15577,North Campus,PHI 2604 - 0014   Critical Thinking/Ethics,0014-LEC Weekend,Staff,30,10,20,0,0
15455,North Campus,PHI 2604 - 0015   Critical Thinking/Ethics,0015-LEC Main Sess,Staff,45,0,45,0,0
15558,North Campus,PHI 2604 - 0017   Critical Thinking/Ethics,0017-LEC Twelve Wk,Staff,40,39,1,0,0
15559,North Campus,PHI 2604 - 0018   Critical Thinking/Ethics,0018-LEC Twelve Wk,Staff,40,37,3,0,0
15456,North Campus,PHI 2604 - 0019   Critical Thinking/Ethics,0019-LEC Main Sess,Staff,40,14,26,0,0
15458,North Campus,PHI 2604 - 0021   Critical Thinking/Ethics,0021-LEC Main Sess,Staff,40,38,2,0,0
15459,North Campus,PHI 2604 - 0022   Critical Thinking/Ethics,0022-LEC Main Sess,Staff,40,26,14,0,0
15573,North Campus,PHI 2604 - 0024   Critical Thinking/Ethics,0024-LEC 1st Mon Sp,Staff,40,38,2,0,0
15461,North Campus,PHI 2604 - 0025   Critical Thinking/Ethics,0025-LEC Main Sess,Staff,45,0,45,0,0
15462,North Campus,PHI 2604 - 0026   Critical Thinking/Ethics,0026-LEC Main Sess,Staff,35,0,35,0,0
15555,North Campus,PHI 2604 - 0027   Critical Thinking/Ethics,0027-LEC Twelve Wk,Staff,35,18,17,0,0
15463,Kendall Campus,PHI 2604 - 0028   Critical Thinking/Ethics,0028-LEC Main Sess,Staff,38,37,1,0,0
15465,Kendall Campus,PHI 2604 - 0030   Critical Thinking/Ethics,0030-LEC Main Sess,Staff,40,39,1,0,0
15466,Kendall Campus,PHI 2604 - 0031   Critical Thinking/Ethics,0031-LEC Main Sess,Staff,40,37,3,0,0
15467,Kendall Campus,PHI 2604 - 0032   Critical Thinking/Ethics,0032-LEC Main Sess,Staff,40,36,4,0,0
15468,Kendall Campus,PHI 2604 - 0033   Critical Thinking/Ethics,0033-LEC Main Sess,Staff,36,27,9,0,0
15576,Kendall Campus,PHI 2604 - 0035   Critical Thinking/Ethics,0035-LEC Weekend,Staff,40,34,6,0,0
15470,Kendall Campus,PHI 2604 - 0036   Critical Thinking/Ethics,0036-LEC Main Sess,Staff,40,37,3,0,0
15472,Kendall Campus,PHI 2604 - 0038   Critical Thinking/Ethics,0038-LEC Main Sess,Staff,40,35,5,0,0
15473,Kendall Campus,PHI 2604 - 0039   Critical Thinking/Ethics,0039-LEC Main Sess,Staff,40,23,17,0,0
15474,Kendall Campus,PHI 2604 - 0040   Critical Thinking/Ethics,0040-LEC Main Sess,Staff,40,37,3,0,0
15475,Kendall Campus,PHI 2604 - 0041   Critical Thinking/Ethics,0041-LEC Main Sess,Staff,36,31,5,0,0
15476,Kendall Campus,PHI 2604 - 0042   Critical Thinking/Ethics,0042-LEC Main Sess,Staff,1,0,1,0,0
15477,Kendall Campus,PHI 2604 - 0043   Critical Thinking/Ethics,0043-LEC Main Sess,Staff,40,33,7,0,0
15571,Kendall Campus,PHI 2604 - 0044   Critical Thinking/Ethics,0044-LEC Conversion,Staff,40,35,5,0,0
15554,Kendall Campus,PHI 2604 - 0045   Critical Thinking/Ethics,0045-LEC Twelve Wk,Staff,40,22,18,0,0
15478,Kendall Campus,PHI 2604 - 0046   Critical Thinking/Ethics,0046-LEC Main Sess,Staff,36,32,4,0,0
15479,Kendall Campus,PHI 2604 - 0047   Critical Thinking/Ethics,0047-LEC Main Sess,Staff,30,0,30,0,0
15480,Kendall Campus,PHI 2604 - 0048   Critical Thinking/Ethics,0048-LEC Main Sess,Staff,40,29,11,0,0
15481,Kendall Campus,PHI 2604 - 0049   Critical Thinking/Ethics,0049-LEC Main Sess,Staff,40,32,8,0,0
15483,Kendall Campus,PHI 2604 - 0051   Critical Thinking/Ethics,0051-LEC Main Sess,Staff,40,36,4,0,0
15484,Kendall Campus,PHI 2604 - 0052   Critical Thinking/Ethics,0052-LEC Main Sess,Staff,40,38,2,0,0
15545,Kendall Campus,PHI 2604 - 0053   Critical Thinking/Ethics,0053-LEC Twelve Wk,Staff,40,32,8,0,0
15485,Kendall Campus,PHI 2604 - 0054   Critical Thinking/Ethics,0054-LEC Main Sess,Staff,40,35,5,0,0
15486,Kendall Campus,PHI 2604 - 0055   Critical Thinking/Ethics,0055-LEC Main Sess,Staff,5,0,5,0,0
15487,Kendall Campus,PHI 2604 - 0056   Critical Thinking/Ethics,0056-LEC Main Sess,Staff,40,28,12,0,0
15489,Kendall Campus,PHI 2604 - 0058   Critical Thinking/Ethics,0058-LEC Main Sess,Staff,40,34,6,0,0
15490,Kendall Campus,PHI 2604 - 0059   Critical Thinking/Ethics,0059-LEC Main Sess,Staff,40,34,6,0,0
15491,Kendall Campus,PHI 2604 - 0060   Critical Thinking/Ethics,0060-LEC Main Sess,Staff,38,36,2,0,0
15492,Kendall Campus,PHI 2604 - 0061   Critical Thinking/Ethics,0061-LEC Main Sess,Staff,37,35,2,0,0
15494,Kendall Campus,PHI 2604 - 0063   Critical Thinking/Ethics,0063-LEC Main Sess,Staff,40,38,2,0,0
15552,Kendall Campus,PHI 2604 - 0064   Critical Thinking/Ethics,0064-LEC Twelve Wk,Staff,40,38,2,0,0
15495,Kendall Campus,PHI 2604 - 0065   Critical Thinking/Ethics,0065-LEC Main Sess,Staff,40,20,20,0,0
15496,Wolfson Campus,PHI 2604 - 0066   Critical Thinking/Ethics,0066-LEC Main Sess,Staff,45,44,1,0,0
15498,Wolfson Campus,PHI 2604 - 0069   Critical Thinking/Ethics,0069-LEC Main Sess,Staff,50,48,2,0,0
15499,Wolfson Campus,PHI 2604 - 0070   Critical Thinking/Ethics,0070-LEC Main Sess,Staff,47,46,1,0,0
15560,Wolfson Campus,PHI 2604 - 0071   Critical Thinking/Ethics,0071-LEC Eight Wk 1,Staff,1,0,1,0,0
15501,Wolfson Campus,PHI 2604 - 0073   Critical Thinking/Ethics,0073-LEC Main Sess,Staff,1,0,1,0,0
15551,Wolfson Campus,PHI 2604 - 0074   Critical Thinking/Ethics,0074-LEC Twelve Wk,Staff,50,47,3,0,0
15561,Wolfson Campus,PHI 2604 - 0076   Critical Thinking/Ethics,0076-LEC Eight Wk 1,Staff,50,38,12,0,0
15502,Wolfson Campus,PHI 2604 - 0077   Critical Thinking/Ethics,0077-LEC Main Sess,Staff,50,46,4,0,0
15503,Wolfson Campus,PHI 2604 - 0078   Critical Thinking/Ethics,0078-LEC Main Sess,Staff,45,40,5,0,0
15549,Wolfson Campus,PHI 2604 - 0079   Critical Thinking/Ethics,0079-LEC Twelve Wk,Staff,1,0,1,0,0
15548,Wolfson Campus,PHI 2604 - 0080   Critical Thinking/Ethics,0080-LEC Twelve Wk,Staff,50,46,4,0,0
15504,Wolfson Campus,PHI 2604 - 0081   Critical Thinking/Ethics,0081-LEC Main Sess,Staff,34,28,6,0,0
15505,Wolfson Campus,PHI 2604 - 0082   Critical Thinking/Ethics,0082-LEC Main Sess,Staff,34,28,6,0,0
15569,Wolfson Campus,PHI 2604 - 0083   Critical Thinking/Ethics,0083-LEC Conversion,Staff,34,28,6,0,0
15568,Wolfson Campus,PHI 2604 - 0084   Critical Thinking/Ethics,0084-LEC Conversion,Staff,34,16,18,0,0
15506,Wolfson Campus,PHI 2604 - 0085   Critical Thinking/Ethics,0085-LEC Main Sess,Staff,34,30,4,0,0
15507,Wolfson Campus,PHI 2604 - 0086   Critical Thinking/Ethics,0086-LEC Main Sess,Staff,34,31,3,0,0
15508,Wolfson Campus,PHI 2604 - 0087   Critical Thinking/Ethics,0087-LEC Main Sess,Staff,34,31,3,0,0
15509,Wolfson Campus,PHI 2604 - 0088   Critical Thinking/Ethics,0088-LEC Main Sess,Staff,34,33,1,0,0
15567,Wolfson Campus,PHI 2604 - 0089   Critical Thinking/Ethics,0089-LEC Conversion,Staff,34,26,8,0,0
15566,Wolfson Campus,PHI 2604 - 0090   Critical Thinking/Ethics,0090-LEC Conversion,Staff,34,0,34,0,0
15510,Wolfson Campus,PHI 2604 - 0091   Critical Thinking/Ethics,0091-LEC Main Sess,Staff,30,28,2,0,0
15511,Wolfson Campus,PHI 2604 - 0092   Critical Thinking/Ethics,0092-LEC Main Sess,Staff,34,28,6,0,0
15512,Wolfson Campus,PHI 2604 - 0093   Critical Thinking/Ethics,0093-LEC Main Sess,Staff,34,27,7,0,0
15565,Wolfson Campus,PHI 2604 - 0094   Critical Thinking/Ethics,0094-LEC Conversion,Staff,34,0,34,0,0
15513,Wolfson Campus,PHI 2604 - 0095   Critical Thinking/Ethics,0095-LEC Main Sess,Staff,34,19,15,0,0
15564,Wolfson Campus,PHI 2604 - 0096   Critical Thinking/Ethics,0096-LEC Conversion,Staff,34,0,34,0,0
15514,Wolfson Campus,PHI 2604 - 0097   Critical Thinking/Ethics,0097-LEC Main Sess,Staff,30,27,3,0,0
15515,Wolfson Campus,PHI 2604 - 0098   Critical Thinking/Ethics,0098-LEC Main Sess,Staff,30,29,1,0,0
15516,Wolfson Campus,PHI 2604 - 0099   Critical Thinking/Ethics,0099-LEC Main Sess,Staff,30,28,2,0,0
15517,Wolfson Campus,PHI 2604 - 0100   Critical Thinking/Ethics,0100-LEC Main Sess,Staff,30,26,4,0,0
15518,Wolfson Campus,PHI 2604 - 0101   Critical Thinking/Ethics,0101-LEC Main Sess,Staff,34,31,3,0,0
15519,Wolfson Campus,PHI 2604 - 0102   Critical Thinking/Ethics,0102-LEC Main Sess,Staff,34,31,3,0,0
15520,Wolfson Campus,PHI 2604 - 0103   Critical Thinking/Ethics,0103-LEC Main Sess,Staff,34,27,7,0,0
15524,Homestead Campus,PHI 2604 - 0107   Critical Thinking/Ethics,0107-LEC Main Sess,Staff,39,38,1,0,0
15525,Homestead Campus,PHI 2604 - 0108   Critical Thinking/Ethics,0108-LEC Main Sess,Staff,39,34,5,0,0
15526,Homestead Campus,PHI 2604 - 0109   Critical Thinking/Ethics,0109-LEC Main Sess,Staff,39,37,2,0,0
15527,Homestead Campus,PHI 2604 - 0110   Critical Thinking/Ethics,0110-LEC Main Sess,Staff,39,0,39,0,0
15528,InterAmerican Campus,PHI 2604 - 0111   Critical Thinking/Ethics,0111-LEC Main Sess,Staff,38,36,2,0,0
15529,InterAmerican Campus,PHI 2604 - 0112   Critical Thinking/Ethics,0112-LEC Main Sess,Staff,35,32,3,0,0
15530,InterAmerican Campus,PHI 2604 - 0113   Critical Thinking/Ethics,0113-LEC Main Sess,Staff,29,27,2,0,0
15575,InterAmerican Campus,PHI 2604 - 0114   Critical Thinking/Ethics,0114-LEC Weekend,Staff,35,17,18,0,0
15562,InterAmerican Campus,PHI 2604 - 0115   Critical Thinking/Ethics,0115-LEC Eight Wk 2,Staff,35,30,5,0,0
15531,InterAmerican Campus,PHI 2604 - 0116   Critical Thinking/Ethics,0116-LEC Main Sess,Staff,38,34,4,0,0
15532,InterAmerican Campus,PHI 2604 - 0117   Critical Thinking/Ethics,0117-LEC Main Sess,Staff,30,25,5,0,0
15533,Hialeah Campus,PHI 2604 - 0118   Critical Thinking/Ethics,0118-LEC Main Sess,Staff,30,21,9,0,0
15534,Hialeah Campus,PHI 2604 - 0119   Critical Thinking/Ethics,0119-LEC Main Sess,Staff,30,27,3,0,0
15535,Hialeah Campus,PHI 2604 - 0120   Critical Thinking/Ethics,0120-LEC Main Sess,Staff,35,33,2,0,0
15547,Hialeah Campus,PHI 2604 - 0121   Critical Thinking/Ethics,0121-LEC Twelve Wk,Staff,33,32,1,0,0
15536,Hialeah Campus,PHI 2604 - 0122   Critical Thinking/Ethics,0122-LEC Main Sess,Staff,33,30,3,0,0
15537,Hialeah Campus,PHI 2604 - 0123   Critical Thinking/Ethics,0123-LEC Main Sess,Staff,35,33,2,0,0
15546,Hialeah Campus,PHI 2604 - 0124   Critical Thinking/Ethics,0124-LEC Twelve Wk,Staff,33,0,33,0,0
15563,Hialeah Campus,PHI 2604 - 0126   Critical Thinking/Ethics,0126-LEC Conversion,Staff,31,0,31,0,0
15544,Hialeah Campus,PHI 2604 - 0127   Critical Thinking/Ethics,0127-LEC Twelve Wk,Staff,30,25,5,0,0
15538,Hialeah Campus,PHI 2604 - 0128   Critical Thinking/Ethics,0128-LEC Main Sess,Staff,35,19,16,0,0
15543,Hialeah Campus,PHI 2604 - 0130   Critical Thinking/Ethics,0130-LEC Main Sess,Staff,33,17,16,0,0
15578,Hialeah Campus,PHI 2604 - 0131   Critical Thinking/Ethics,0131-LEC Weekend,Staff,31,0,31,0,0
15557,Hialeah Campus,PHI 2604 - 0132   Critical Thinking/Ethics,0132-LEC Twelve Wk,Staff,33,31,2,0,0
15572,West Campus,PHI 2604 - 0133   Critical Thinking/Ethics,0133-LEC Conversion,Staff,35,32,3,0,0
15540,West Campus,PHI 2604 - 0134   Critical Thinking/Ethics,0134-LEC Main Sess,Staff,35,29,6,0,0
15541,West Campus,PHI 2604 - 0135   Critical Thinking/Ethics,0135-LEC Main Sess,Staff,49,37,12,0,0
6289,Medical Campus,EMS 2602 - 0001   Paramedic Lecture 2,0001-LEC Main Sess,Staff,45,36,9,0,0
6290,Medical Campus,EMS 2602 - 0002   Paramedic Lecture 2,0002-LEC Conversion,Staff,18,16,2,0,0
10304,Medical Campus,EMS 2602L - 0001   Paramedic Laboratory 2,0001-LAB Main Sess,Staff,6,5,1,0,0
10307,Medical Campus,EMS 2602L - 0004   Paramedic Laboratory 2,0004-LAB Main Sess,Staff,6,5,1,0,0
10311,Medical Campus,EMS 2602L - 0007   Paramedic Laboratory 2,0007-LAB Weekend,Staff,6,5,1,0,0
10310,Medical Campus,EMS 2602L - 0008   Paramedic Laboratory 2,0008-LAB Main Sess,Staff,6,4,2,0,0
10313,Medical Campus,EMS 2602L - 0009   Paramedic Laboratory 2,0009-LAB Weekend,Staff,6,3,3,0,0
11259,North Campus,EEC 2601 - 0001   Observation And Assessment In Early Childhood,0001-LEC Main Sess,Staff,30,27,3,0,0
11261,Kendall Campus,EEC 2601 - 0002   Observation And Assessment In Early Childhood,0002-LEC Main Sess,Staff,30,28,2,0,0
11260,Homestead Campus,EEC 2601 - 0003   Observation And Assessment In Early Childhood,0003-LEC Main Sess,Staff,30,13,17,0,0
10044,Medical Campus,EMS 2601 - 0002   Paramedic Lecture 1,0002-LEC Main Sess,Staff,18,0,18,0,0
10406,North Campus,MUC 2601 - 0001   Introduction To Songwriting,0001-LEC 1st Mon Sp,Staff,25,13,12,0,0
10405,Kendall Campus,MUC 2601 - 0002   Introduction To Songwriting,0002-LEC Main Sess,Staff,23,9,14,0,0
13865,North Campus,MUM 2601 - 0001   Sound Recording 2,0001-LEC 1st Mon Sp,Staff,20,12,8,0,0
13864,Kendall Campus,MUM 2601 - 0002   Sound Recording 2,0002-LEC Main Sess,Staff,20,17,3,0,0
16461,Medical Campus,RET 2601 - 0001   Respiratory Care Seminar,0001-LEC Main Sess,Staff,45,21,24,0,0
6735,Medical Campus,EMS 2601L - 0002   Paramedic Laboratory 1,0002-LAB Weekend,Staff,6,0,6,0,0
6728,Medical Campus,EMS 2601L - 0004   Paramedic Laboratory 1,0004-LAB Conversion,Staff,6,5,1,0,0
6734,Medical Campus,EMS 2601L - 0005   Paramedic Laboratory 1,0005-LAB Weekend,Staff,6,0,6,0,0
6736,Medical Campus,EMS 2601L - 0010   Paramedic Laboratory 1,0010-LAB Weekend,Staff,6,0,6,0,0
12244,North Campus,MUM 2601L - 0001   Sound Recording 2 Lab,0001-LAB 1st Mon Sp,Staff,20,12,8,0,0
12243,Kendall Campus,MUM 2601L - 0002   Sound Recording 2 Lab,0002-LAB Main Sess,Staff,20,17,3,0,0
7360,Kendall Campus,CJE 2600 - 0003   Criminal Investigation,0003-LEC Twelve Wk,Staff,35,25,10,0,0
7355,Kendall Campus,CJE 2600 - 0004   Criminal Investigation,0004-LEC Main Sess,Staff,40,0,40,0,0
7356,Kendall Campus,CJE 2600 - 0005   Criminal Investigation,0005-LEC Main Sess,Staff,40,29,11,0,0
7358,Wolfson Campus,CJE 2600 - 0007   Criminal Investigation,0007-LEC Main Sess,Staff,34,27,7,0,0
7361,Wolfson Campus,CJE 2600 - 0008   Criminal Investigation,0008-LEC Conversion,Staff,34,27,7,0,0
16362,North Campus,MUM 2600 - 0001   Sound Recording 1,0001-LEC Main Sess,Staff,25,18,7,0,0
16365,Kendall Campus,MUM 2600 - 0002   Sound Recording 1,0002-LEC Main Sess,Staff,20,14,6,0,0
16364,Kendall Campus,MUM 2600 - 0003   Sound Recording 1,0003-LEC Main Sess,Staff,20,10,10,0,0
16363,Kendall Campus,MUM 2600 - 0004   Sound Recording 1,0004-LEC Main Sess,Staff,20,19,1,0,0
14848,North Campus,MUM 2600L - 0001   Sound Recording 1 Lab,0001-LAB Main Sess,Staff,25,18,7,0,0
14851,Kendall Campus,MUM 2600L - 0002   Sound Recording 1 Lab,0002-LAB Main Sess,Staff,20,14,6,0,0
14850,Kendall Campus,MUM 2600L - 0003   Sound Recording 1 Lab,0003-LAB Main Sess,Staff,20,10,10,0,0
14849,Kendall Campus,MUM 2600L - 0004   Sound Recording 1 Lab,0004-LAB Main Sess,Staff,20,19,1,0,0
10776,North Campus,DSC 2590 - 0001   Intelligence Analysis And Security Management,0001-LEC Twelve Wk,Staff,40,25,15,0,0
10778,Kendall Campus,DSC 2590 - 0002   Intelligence Analysis And Security Management,0002-LEC Twelve Wk,Staff,36,0,36,0,0
10777,Wolfson Campus,DSC 2590 - 0003   Intelligence Analysis And Security Management,0003-LEC Twelve Wk,Staff,34,11,23,0,0
10332,North Campus,FFP 2590 - 0001   Fire Inspector Preparation,0001-LEC Conversion,Staff,24,17,7,0,0
5285,Kendall Campus,ARC 2580 - 0001   Architectural Structures 1,0001-LEC Main Sess,Staff,32,20,12,0,0
5284,Wolfson Campus,ARC 2580 - 0002   Architectural Structures 1,0002-LEC Main Sess,Staff,33,22,11,0,0
8537,Wolfson Campus,DAA 2571 - 0001   Modern Dance/Jazz For The Theater 2,0001-LAB Main Sess,Staff,25,5,20,0,0
9553,Wolfson Campus,DAA 2570 - 0001   Modern Dance For Theater 1,0001-LAB Conversion,Staff,40,13,27,0,0
14553,North Campus,FFP 2540 - 0001   Fire Detection And Suppression Systems,0001-LEC Conversion,Staff,24,21,3,0,0
11532,Medical Campus,NMT 2534 - 0001   Nuclear Medicine Instruction,0001-LEC Main Sess,Staff,20,11,9,0,0
14500,North Campus,EEC 2527 - 0001   Legal & Financial Issue In Child Care,0001-LEC Conversion,Staff,30,11,19,0,0
14501,InterAmerican Campus,EEC 2527 - 0002   Legal & Financial Issue In Child Care,0002-LEC Conversion,Staff,25,18,7,0,0
10288,North Campus,EEC 2523 - 0001   Programming & Management For Early Childhood Administrators,0001-LEC Conversion,Staff,30,11,19,0,0
10289,InterAmerican Campus,EEC 2523 - 0002   Programming & Management For Early Childhood Administrators,0002-LEC Conversion,Staff,25,19,6,0,0
6845,North Campus,FFP 2521 - 0001   Blueprint Readings And Plans Review,0001-LEC Conversion,Staff,24,18,6,0,0
14499,Hialeah Campus,EEC 2520 - 0001   Early Childhood Organization Leadership And Management,0001-LEC Twelve Wk,Staff,25,0,25,0,0
15330,North Campus,MAR 2520 - 0001   Hispanic Marketing Communications,0001-LEC Main Sess,Staff,30,0,30,0,0
11635,Wolfson Campus,NUR 2520 - 0001   Psychiatric Nursing,0001-LEC Conversion,Staff,30,21,9,0,0
11639,Medical Campus,NUR 2520 - 0002   Psychiatric Nursing,0002-LEC Conversion,Staff,35,25,10,0,0
11636,Medical Campus,NUR 2520 - 0003   Psychiatric Nursing,0003-LEC Conversion,Staff,40,30,10,0,0
11640,Medical Campus,NUR 2520 - 0004   Psychiatric Nursing,0004-LEC Conversion,Staff,35,31,4,0,0
11641,Medical Campus,NUR 2520 - 0005   Psychiatric Nursing,0005-LEC Conversion,Staff,50,14,36,0,0
16803,Medical Campus,NUR 2520L - 0001   Psychiatric Nursing Clinical Lab,0001-CLN Conversion,Staff,8,0,8,0,0
16820,Medical Campus,NUR 2520L - 0002   Psychiatric Nursing Clinical Lab,0002-CLN Conversion,Staff,8,7,1,0,0
16830,Medical Campus,NUR 2520L - 0004   Psychiatric Nursing Clinical Lab,0004-CLN Conversion,Staff,8,7,1,0,0
16831,Medical Campus,NUR 2520L - 0005   Psychiatric Nursing Clinical Lab,0005-CLN Conversion,Staff,8,6,2,0,0
16804,Medical Campus,NUR 2520L - 0006   Psychiatric Nursing Clinical Lab,0006-CLN Conversion,Staff,8,6,2,0,0
16805,Medical Campus,NUR 2520L - 0007   Psychiatric Nursing Clinical Lab,0007-CLN Conversion,Staff,8,0,8,0,0
16818,Medical Campus,NUR 2520L - 0010   Psychiatric Nursing Clinical Lab,0010-CLN Conversion,Staff,8,0,8,0,0
16806,Medical Campus,NUR 2520L - 0014   Psychiatric Nursing Clinical Lab,0014-CLN Conversion,Staff,6,0,6,0,0
16823,Medical Campus,NUR 2520L - 0015   Psychiatric Nursing Clinical Lab,0015-CLN Conversion,Staff,8,0,8,0,0
16807,Medical Campus,NUR 2520L - 0017   Psychiatric Nursing Clinical Lab,0017-CLN Conversion,Staff,8,0,8,0,0
16826,Medical Campus,NUR 2520L - 0022   Psychiatric Nursing Clinical Lab,0022-CLN Conversion,Staff,8,7,1,0,0
16824,Medical Campus,NUR 2520L - 0023   Psychiatric Nursing Clinical Lab,0023-CLN Conversion,Staff,8,0,8,0,0
16812,Medical Campus,NUR 2520L - 0024   Psychiatric Nursing Clinical Lab,0024-CLN Conversion,Staff,8,0,8,0,0
16836,Medical Campus,NUR 2520L - 0025   Psychiatric Nursing Clinical Lab,0025-CLN Conversion,Staff,6,0,6,0,0
16808,Medical Campus,NUR 2520L - 0030   Psychiatric Nursing Clinical Lab,0030-CLN Conversion,Staff,6,0,6,0,0
16825,Medical Campus,NUR 2520L - 0031   Psychiatric Nursing Clinical Lab,0031-CLN Conversion,Staff,8,0,8,0,0
16829,Homestead Campus,NUR 2520L - 0038   Psychiatric Nursing Clinical Lab,0038-CLN Conversion,Staff,8,0,8,0,0
5392,Wolfson Campus,AVM 2515 - 0001   Airline Marketing,0001-LEC Main Sess,Staff,30,26,4,0,0
6635,North Campus,ANT 2511 - 0001   Introduction To Physical Anthropology,0001-LEC Main Sess,Staff,40,15,25,0,0
6634,Wolfson Campus,ANT 2511 - 0002   Introduction To Physical Anthropology,0002-LEC Main Sess,Staff,30,17,13,0,0
9668,Kendall Campus,SPC 2511 - 0001   Argumentation And Debate,0001-LEC Main Sess,Staff,8,0,8,0,0
9670,Wolfson Campus,SPC 2511 - 0002   Argumentation And Debate,0002-LEC Main Sess,Staff,30,0,30,0,0
9669,InterAmerican Campus,SPC 2511 - 0003   Argumentation And Debate,0003-LEC Main Sess,Staff,29,0,29,0,0
5982,North Campus,ASL 2510 - 0001   Deaf Culture And Community,0001-LEC 1st Mon Sp,Staff,20,14,6,0,0
5856,Homestead Campus,AVM 2510 - 0001   Airline Management,0001-LEC Main Sess,Staff,30,17,13,0,0
5855,Homestead Campus,AVM 2510 - 0002   Airline Management,0002-LEC Main Sess,Staff,30,0,30,0,0
11332,North Campus,FFP 2510 - 0001   Fire And Building Codes,0001-LEC Conversion,Staff,24,19,5,0,0
9611,Medical Campus,OPT 2505 - 0001   Contact Lenses 1,0001-LEC Main Sess,Staff,36,30,6,0,0
12447,Medical Campus,RET 2503 - 0001   Respiratory Care Pathophysiology 2,0001-LEC Main Sess,Staff,45,31,14,0,0
12121,Kendall Campus,ENT 2502 - 0001   Starting And Growing A Social Venture,0001-LEC Main Sess,Staff,25,0,25,0,0
5852,Homestead Campus,ATF 2501 - 0001   Flight Instructor-Flight Training,0001-LEC Conversion,Staff,30,1,29,0,0
5851,Homestead Campus,ATF 2501 - 0002   Flight Instructor-Flight Training,0002-LEC Conversion,Staff,30,0,30,0,0
6383,Wolfson Campus,HFT 2500 - 0001   Marketing Of Hospitality Services,0001-LEC Main Sess,Staff,40,19,21,0,0
6385,Wolfson Campus,HFT 2500 - 0002   Marketing Of Hospitality Services,0002-LEC Twelve Wk,Staff,30,0,30,0,0
6384,Wolfson Campus,HFT 2500 - 0003   Marketing Of Hospitality Services,0003-LEC Main Sess,Staff,34,10,24,0,0
12228,Medical Campus,HIM 2500 - 0001   Data Management & Quality Assessment,0001-LEC Conversion,Staff,5,0,5,0,0
6403,Wolfson Campus,HUS 2500 - 0001   Issues & Ethics In Human Services,0001-LEC Main Sess,Staff,40,0,40,0,0
10425,Medical Campus,HIM 2500L - 0001   Data Management & Quality Assessment Laboratory,0001-LAB Conversion,Staff,5,0,5,0,0
11725,North Campus,LIT 2480 - 0001   Issues In Literature & Culture,0001-LEC Main Sess,Staff,3,0,3,0,0
11726,North Campus,LIT 2480 - 0002   Issues In Literature & Culture,0002-LEC Main Sess,Staff,9,0,9,0,0
11727,North Campus,LIT 2480 - 0003   Issues In Literature & Culture,0003-LEC Main Sess,Staff,28,11,17,0,0
11728,North Campus,LIT 2480 - 0004   Issues In Literature & Culture,0004-LEC Main Sess,Staff,28,15,13,0,0
11729,North Campus,LIT 2480 - 0005   Issues In Literature & Culture,0005-LEC Main Sess,Staff,28,14,14,0,0
11730,Kendall Campus,LIT 2480 - 0006   Issues In Literature & Culture,0006-LEC Main Sess,Staff,25,20,5,0,0
11737,Kendall Campus,LIT 2480 - 0007   Issues In Literature & Culture,0007-LEC Main Sess,Staff,6,0,6,0,0
11732,Kendall Campus,LIT 2480 - 0008   Issues In Literature & Culture,0008-LEC Main Sess,Staff,25,23,2,0,0
11734,Wolfson Campus,LIT 2480 - 0010   Issues In Literature & Culture,0010-LEC Main Sess,Staff,28,26,2,0,0
11735,Wolfson Campus,LIT 2480 - 0011   Issues In Literature & Culture,0011-LEC Main Sess,Staff,30,26,4,0,0
11736,InterAmerican Campus,LIT 2480 - 0012   Issues In Literature & Culture,0012-LEC Main Sess,Staff,25,0,25,0,0
11731,Hialeah Campus,LIT 2480 - 0013   Issues In Literature & Culture,0013-LEC Main Sess,Staff,25,0,25,0,0
9644,Kendall Campus,PGY 2475 - 0001   Advanced Photography,0001-LEC Main Sess,Staff,5,4,1,0,0
9645,Wolfson Campus,PGY 2475 - 0003   Advanced Photography,0003-LEC Main Sess,Staff,10,5,5,0,0
16758,Wolfson Campus,MUN 2473 - 0001   Early Music Consortium,0001-LEC Main Sess,Staff,30,0,30,0,0
6400,Kendall Campus,HIM 2472 - 0001   Medical Terminology,0001-LEC 1st Mon Sp,Staff,30,28,2,0,0
6391,Wolfson Campus,HIM 2472 - 0003   Medical Terminology,0003-LEC Main Sess,Staff,30,26,4,0,0
6394,Medical Campus,HIM 2472 - 0004   Medical Terminology,0004-LEC Conversion,Staff,30,16,14,0,0
6396,Medical Campus,HIM 2472 - 0006   Medical Terminology,0006-LEC Conversion,Staff,30,25,5,0,0
6397,Medical Campus,HIM 2472 - 0007   Medical Terminology,0007-LEC Conversion,Staff,10,0,10,0,0
6398,Medical Campus,HIM 2472 - 0008   Medical Terminology,0008-LEC Conversion,Staff,30,26,4,0,0
6395,Medical Campus,HIM 2472 - 0009   Medical Terminology,0009-LEC Conversion,Staff,10,0,10,0,0
6399,Medical Campus,HIM 2472 - 0010   Medical Terminology,0010-LEC Conversion,Staff,30,27,3,0,0
5969,Homestead Campus,ASC 2470 - 0001   Physiology/Psychology Of Flight,0001-LEC Main Sess,Staff,30,17,13,0,0
10761,North Campus,CTS 2463 - 0001   C# Web Application Development,0001-LEC Main Sess,Staff,30,0,30,0,0
10763,Kendall Campus,CTS 2463 - 0002   C# Web Application Development,0002-LEC Main Sess,Staff,22,21,1,0,0
10762,Wolfson Campus,CTS 2463 - 0003   C# Web Application Development,0003-LEC Main Sess,Staff,30,0,30,0,0
6638,North Campus,ARC 2461 - 0001   Architectural Materials And Construction 1,0001-LEC Main Sess,Staff,20,17,3,0,0
6641,Kendall Campus,ARC 2461 - 0002   Architectural Materials And Construction 1,0002-LEC Main Sess,Staff,20,18,2,0,0
6640,Wolfson Campus,ARC 2461 - 0003   Architectural Materials And Construction 1,0003-LEC Main Sess,Staff,20,13,7,0,0
5934,North Campus,ACG 2450 - 0001   Microcomputers In Accounting,0001-LEC Twelve Wk,Staff,24,14,10,0,0
5930,Kendall Campus,ACG 2450 - 0002   Microcomputers In Accounting,0002-LEC Main Sess,Staff,25,15,10,0,0
5935,Wolfson Campus,ACG 2450 - 0003   Microcomputers In Accounting,0003-LEC Twelve Wk,Staff,25,9,16,0,0
5931,Wolfson Campus,ACG 2450 - 0004   Microcomputers In Accounting,0004-LEC Main Sess,Staff,30,26,4,0,0
5932,Homestead Campus,ACG 2450 - 0005   Microcomputers In Accounting,0005-LEC Main Sess,Staff,30,9,21,0,0
5933,InterAmerican Campus,ACG 2450 - 0006   Microcomputers In Accounting,0006-LEC Main Sess,Staff,30,0,30,0,0
5937,InterAmerican Campus,ACG 2450 - 0007   Microcomputers In Accounting,0007-LEC 1st Mon Sp,Staff,21,0,21,0,0
5936,Hialeah Campus,ACG 2450 - 0008   Microcomputers In Accounting,0008-LEC Eight Wk 2,Staff,30,0,30,0,0
5326,Homestead Campus,AVM 2450 - 0001   Airport Facilities/Financial Planning,0001-LEC Eight Wk 2,Staff,30,0,30,0,0
5327,Homestead Campus,AVM 2450 - 0002   Airport Facilities/Financial Planning,0002-LEC Conversion,Staff,30,1,29,0,0
5322,Homestead Campus,AVM 2450 - 0003   Airport Facilities/Financial Planning,0003-LEC Main Sess,Staff,30,0,30,0,0
5323,Homestead Campus,AVM 2450 - 0004   Airport Facilities/Financial Planning,0004-LEC Main Sess,Staff,30,0,30,0,0
5324,Homestead Campus,AVM 2450 - 0005   Airport Facilities/Financial Planning,0005-LEC Eight Wk 1,Staff,30,0,30,0,0
5325,Homestead Campus,AVM 2450 - 0006   Airport Facilities/Financial Planning,0006-LEC Eight Wk 2,Staff,30,0,30,0,0
8670,Kendall Campus,CTS 2450 - 0001   Business Intelligence: Analysis Services And Data Mining,0001-LEC Eight Wk 2,Staff,22,21,1,0,0
16257,Wolfson Campus,HFT 2449 - 0001   E-Business For The Hospitality Industry,0001-LEC Twelve Wk,Staff,30,12,18,0,0
16256,Wolfson Campus,HFT 2449 - 0002   E-Business For The Hospitality Industry,0002-LEC Main Sess,Staff,30,17,13,0,0
11993,North Campus,PSB 2442 - 0001   The Psychology Of Addiction,0001-LEC Conversion,Staff,45,0,45,0,0
11994,North Campus,PSB 2442 - 0002   The Psychology Of Addiction,0002-LEC Conversion,Staff,45,0,45,0,0
11990,Wolfson Campus,PSB 2442 - 0003   The Psychology Of Addiction,0003-LEC Main Sess,Staff,45,24,21,0,0
6083,Homestead Campus,AVM 2441 - 0001   Aviation Safety & Human Factors,0001-LEC Main Sess,Staff,30,14,16,0,0
12754,Hialeah Campus,INR 2440 - 0001   International Law And Organization,0001-LEC Main Sess,Staff,30,8,22,0,0
12753,Hialeah Campus,INR 2440 - 0002   International Law And Organization,0002-LEC Main Sess,Staff,35,22,13,0,0
16745,Medical Campus,MLT 2440 - 0001   Clinical Microbiology 1,0001-LEC Conversion,Staff,30,25,5,0,0
10394,Medical Campus,MLT 2440L - 0002   Clinical Microbiology Lab 1,0002-LAB Conversion,Staff,16,15,1,0,0
11379,Wolfson Campus,HIM 2433 - 0001   Pathophysiology And Pharmacology,0001-LEC Main Sess,Staff,30,11,19,0,0
7187,Homestead Campus,AVM 2431 - 0001   Customer Service Agent,0001-LEC Main Sess,Staff,30,17,13,0,0
10773,Wolfson Campus,DAN 2431 - 0001   Laban Movement Analysis 2,0001-LEC Main Sess,Staff,30,13,17,0,0
10772,Wolfson Campus,DAN 2431 - 0002   Laban Movement Analysis 2,0002-LEC Main Sess,Staff,1,0,1,0,0
5972,North Campus,ASL 2430 - 0001   Manual Alphabet Skills Development,0001-LEC Main Sess,Staff,20,14,6,0,0
6408,Wolfson Campus,IND 2430 - 0001   Lighting Design,0001-LEC Conversion,Staff,30,0,30,0,0
11871,Wolfson Campus,SYG 2430 - 0001   Marriage And The Family,0001-LEC Main Sess,Staff,47,23,24,0,0
5419,North Campus,BSC 2427 - 0001   Biotechnology Methods And Applications 2,0001-LEC Main Sess,Staff,24,19,5,0,0
5418,Kendall Campus,BSC 2427 - 0002   Biotechnology Methods And Applications 2,0002-LEC Main Sess,Staff,24,0,24,0,0
7988,North Campus,BSC 2427L - 0001   Biotechnology Methods & Applications 2 Laboratory,0001-LAB Main Sess,Staff,24,20,4,0,0
7987,Kendall Campus,BSC 2427L - 0002   Biotechnology Methods & Applications 2 Laboratory,0002-LAB Main Sess,Staff,24,0,24,0,0
5339,North Campus,BSC 2426 - 0001   Biotechnology Methods And Applications 1,0001-LEC 1st Mon Sp,Staff,45,21,24,0,0
5338,Wolfson Campus,BSC 2426 - 0002   Biotechnology Methods And Applications 1,0002-LEC Main Sess,Staff,24,0,24,0,0
6848,North Campus,BSC 2426L - 0001   Biotechnology Methods & Applications 1 Laboratory,0001-LAB Main Sess,Staff,24,21,3,0,0
6847,Wolfson Campus,BSC 2426L - 0002   Biotechnology Methods & Applications 1 Laboratory,0002-LAB Main Sess,Staff,24,0,24,0,0
6382,Wolfson Campus,HFT 2421 - 0001   Managerial Accounting For Hospitality,0001-LEC Twelve Wk,Staff,30,29,1,0,0
6381,Wolfson Campus,HFT 2421 - 0002   Managerial Accounting For Hospitality,0002-LEC Main Sess,Staff,30,0,30,0,0
14655,Kendall Campus,IND 2421 - 0001   Introduction To Furniture Design,0001-LEC Main Sess,Staff,15,0,15,0,0
10484,Wolfson Campus,NUR 2420 - 0001   Obstetrical Nursing,0001-LEC Conversion,Staff,30,20,10,0,0
10488,Medical Campus,NUR 2420 - 0002   Obstetrical Nursing,0002-LEC Conversion,Staff,30,22,8,0,0
10485,Medical Campus,NUR 2420 - 0003   Obstetrical Nursing,0003-LEC Conversion,Staff,30,26,4,0,0
10486,Medical Campus,NUR 2420 - 0004   Obstetrical Nursing,0004-LEC Conversion,Staff,50,14,36,0,0
10489,Medical Campus,NUR 2420 - 0006   Obstetrical Nursing,0006-LEC Conversion,Staff,35,34,1,0,0
11927,Medical Campus,NUR 2420L - 0001   Obstetrical Nursing Clinical Lab,0001-CLN Conversion,Staff,6,0,6,0,0
11963,Medical Campus,NUR 2420L - 0003   Obstetrical Nursing Clinical Lab,0003-CLN Conversion,Staff,6,0,6,0,0
11930,Medical Campus,NUR 2420L - 0005   Obstetrical Nursing Clinical Lab,0005-CLN Conversion,Staff,8,7,1,0,0
11958,Medical Campus,NUR 2420L - 0006   Obstetrical Nursing Clinical Lab,0006-CLN Conversion,Staff,8,6,2,0,0
11965,Medical Campus,NUR 2420L - 0007   Obstetrical Nursing Clinical Lab,0007-CLN Conversion,Staff,8,6,2,0,0
11942,Medical Campus,NUR 2420L - 0008   Obstetrical Nursing Clinical Lab,0008-CLN Conversion,Staff,6,0,6,0,0
11936,Medical Campus,NUR 2420L - 0011   Obstetrical Nursing Clinical Lab,0011-CLN Conversion,Staff,10,0,10,0,0
11928,Medical Campus,NUR 2420L - 0016   Obstetrical Nursing Clinical Lab,0016-CLN Conversion,Staff,8,7,1,0,0
11938,Medical Campus,NUR 2420L - 0019   Obstetrical Nursing Clinical Lab,0019-CLN Conversion,Staff,8,0,8,0,0
11939,Medical Campus,NUR 2420L - 0020   Obstetrical Nursing Clinical Lab,0020-CLN Conversion,Staff,6,5,1,0,0
11937,Medical Campus,NUR 2420L - 0022   Obstetrical Nursing Clinical Lab,0022-CLN Conversion,Staff,8,0,8,0,0
11932,Medical Campus,NUR 2420L - 0023   Obstetrical Nursing Clinical Lab,0023-CLN Conversion,Staff,8,0,8,0,0
11933,Medical Campus,NUR 2420L - 0024   Obstetrical Nursing Clinical Lab,0024-CLN Conversion,Staff,8,6,2,0,0
11953,Medical Campus,NUR 2420L - 0025   Obstetrical Nursing Clinical Lab,0025-CLN Conversion,Staff,10,0,10,0,0
11955,Medical Campus,NUR 2420L - 0026   Obstetrical Nursing Clinical Lab,0026-CLN Conversion,Staff,8,0,8,0,0
11934,Medical Campus,NUR 2420L - 0028   Obstetrical Nursing Clinical Lab,0028-CLN Conversion,Staff,10,0,10,0,0
11943,Medical Campus,NUR 2420L - 0029   Obstetrical Nursing Clinical Lab,0029-CLN Conversion,Staff,8,6,2,0,0
11949,Medical Campus,NUR 2420L - 0033   Obstetrical Nursing Clinical Lab,0033-CLN Conversion,Staff,6,5,1,0,0
11954,Medical Campus,NUR 2420L - 0035   Obstetrical Nursing Clinical Lab,0035-CLN Conversion,Staff,10,0,10,0,0
11957,Homestead Campus,NUR 2420L - 0038   Obstetrical Nursing Clinical Lab,0038-CLN Conversion,Staff,8,7,1,0,0
11956,Homestead Campus,NUR 2420L - 0039   Obstetrical Nursing Clinical Lab,0039-CLN Conversion,Staff,8,0,8,0,0
12448,Medical Campus,RET 2414L - 0002   Pulmonary Studies Laboratory,0002-LAB 1st Mon Sp,Staff,18,13,5,0,0
8351,North Campus,FIL 2413 - 0001   Screenwriting 3,0001-LEC Main Sess,Staff,25,23,2,0,0
5275,North Campus,ANT 2410 - 0001   Introduction To Cultural Anthropology,0001-LEC Main Sess,Staff,40,0,40,0,0
5281,North Campus,ANT 2410 - 0002   Introduction To Cultural Anthropology,0002-LEC Conversion,Staff,40,20,20,0,0
5276,North Campus,ANT 2410 - 0003   Introduction To Cultural Anthropology,0003-LEC Main Sess,Staff,40,24,16,0,0
5277,Kendall Campus,ANT 2410 - 0004   Introduction To Cultural Anthropology,0004-LEC Main Sess,Staff,30,0,30,0,0
5278,Kendall Campus,ANT 2410 - 0005   Introduction To Cultural Anthropology,0005-LEC Main Sess,Staff,35,16,19,0,0
5279,Wolfson Campus,ANT 2410 - 0006   Introduction To Cultural Anthropology,0006-LEC Main Sess,Staff,45,0,45,0,0
5280,Wolfson Campus,ANT 2410 - 0007   Introduction To Cultural Anthropology,0007-LEC Main Sess,Staff,45,26,19,0,0
7186,Homestead Campus,AVM 2410 - 0001   Principles Of Airport Management,0001-LEC Conversion,Staff,30,0,30,0,0
7184,Homestead Campus,AVM 2410 - 0002   Principles Of Airport Management,0002-LEC Main Sess,Staff,30,0,30,0,0
7185,Homestead Campus,AVM 2410 - 0003   Principles Of Airport Management,0003-LEC Eight Wk 2,Staff,30,16,14,0,0
11373,Wolfson Campus,HFT 2410 - 0001   Front Office Procedures And Lodging Operations,0001-LEC Main Sess,Staff,30,0,30,0,0
14857,North Campus,MUN 2410 - 0001   String Ensemble,0001-LAB Main Sess,Staff,8,4,4,0,0
14858,Kendall Campus,MUN 2410 - 0002   String Ensemble,0002-LAB Conversion,Staff,30,19,11,0,0
6283,North Campus,EEC 2407 - 0001   Facilitating Social Development,0001-LEC Twelve Wk,Staff,30,26,4,0,0
6285,North Campus,EEC 2407 - 0002   Facilitating Social Development,0002-LEC Conversion,Staff,30,28,2,0,0
6284,Kendall Campus,EEC 2407 - 0003   Facilitating Social Development,0003-LEC Conversion,Staff,30,20,10,0,0
6281,Kendall Campus,EEC 2407 - 0004   Facilitating Social Development,0004-LEC Twelve Wk,Staff,30,26,4,0,0
6280,Wolfson Campus,EEC 2407 - 0005   Facilitating Social Development,0005-LEC Main Sess,Staff,30,0,30,0,0
6282,InterAmerican Campus,EEC 2407 - 0006   Facilitating Social Development,0006-LEC Twelve Wk,Staff,30,0,30,0,0
6352,North Campus,ETI 2404 - 0001   Advanced Manufacturing Technology,0001-LEC Twelve Wk,Staff,30,0,30,0,0
6351,North Campus,ETI 2404 - 0002   Advanced Manufacturing Technology,0002-LEC Main Sess,Staff,24,0,24,0,0
12229,Medical Campus,MLT 2403 - 0001   Clinical Microbiology 2,0001-LEC 1st Mon Sp,Staff,30,28,2,0,0
16351,Medical Campus,MLT 2403L - 0001   Clinical Microbiology Lab 2,0001-LAB Conversion,Staff,20,14,6,0,0
16350,Medical Campus,MLT 2403L - 0002   Clinical Microbiology Lab 2,0002-LAB Conversion,Staff,20,11,9,0,0
5286,North Campus,ARH 2402 - 0001   Art History 3,0001-LEC Main Sess,Staff,10,1,9,0,0
11901,Homestead Campus,TRA 2402 - 0001   Intermodal Transportation Operations And Project Management,0001-LEC Eight Wk 2,Staff,30,0,30,0,0
10038,North Campus,EEC 2401 - 0001   Family Interaction And Cultural Continuity,0001-LEC Twelve Wk,Staff,30,11,19,0,0
10036,Kendall Campus,EEC 2401 - 0002   Family Interaction And Cultural Continuity,0002-LEC Twelve Wk,Staff,30,16,14,0,0
10035,Homestead Campus,EEC 2401 - 0003   Family Interaction And Cultural Continuity,0003-LEC Main Sess,Staff,30,24,6,0,0
10037,InterAmerican Campus,EEC 2401 - 0004   Family Interaction And Cultural Continuity,0004-LEC Twelve Wk,Staff,29,19,10,0,0
12238,Kendall Campus,HSC 2401 - 0001   Instructor's Training First Aid & Cpr,0001-LEC Main Sess,Staff,30,4,26,0,0
5317,North Campus,ASL 2400 - 0001   Linguistics Of American Sign Language,0001-LEC 1st Mon Sp,Staff,4,0,4,0,0
7415,Homestead Campus,ATF 2400 - 0001   Multi-Engine Pilot Flight,0001-LEC Conversion,Staff,24,0,24,0,0
7414,Homestead Campus,ATF 2400 - 0002   Multi-Engine Pilot Flight,0002-LEC Conversion,Staff,24,0,24,0,0
10445,North Campus,HSC 2400 - 0001   Basic Emergency Care,0001-LEC Main Sess,Staff,30,21,9,0,0
10446,North Campus,HSC 2400 - 0002   Basic Emergency Care,0002-LEC Main Sess,Staff,30,14,16,0,0
10447,North Campus,HSC 2400 - 0003   Basic Emergency Care,0003-LEC Main Sess,Staff,30,0,30,0,0
10457,North Campus,HSC 2400 - 0004   Basic Emergency Care,0004-LEC 1st Mon Sp,Staff,30,29,1,0,0
10448,Kendall Campus,HSC 2400 - 0005   Basic Emergency Care,0005-LEC Main Sess,Staff,30,14,16,0,0
10449,Kendall Campus,HSC 2400 - 0006   Basic Emergency Care,0006-LEC Main Sess,Staff,30,18,12,0,0
10450,Kendall Campus,HSC 2400 - 0007   Basic Emergency Care,0007-LEC Main Sess,Staff,30,12,18,0,0
10451,Kendall Campus,HSC 2400 - 0008   Basic Emergency Care,0008-LEC Main Sess,Staff,30,14,16,0,0
10454,Kendall Campus,HSC 2400 - 0009   Basic Emergency Care,0009-LEC Main Sess,Staff,30,13,17,0,0
10455,Kendall Campus,HSC 2400 - 0010   Basic Emergency Care,0010-LEC Twelve Wk,Staff,35,14,21,0,0
10453,Wolfson Campus,HSC 2400 - 0011   Basic Emergency Care,0011-LEC Main Sess,Staff,25,13,12,0,0
10452,Wolfson Campus,HSC 2400 - 0012   Basic Emergency Care,0012-LEC Main Sess,Staff,34,31,3,0,0
10456,Wolfson Campus,HSC 2400 - 0013   Basic Emergency Care,0013-LEC Conversion,Staff,34,28,6,0,0
12013,Medical Campus,RTE 2385 - 0001   Radiation Biology,0001-LEC Main Sess,Staff,48,32,16,0,0
14842,North Campus,MUL 2380 - 0001   Jazz And Popular Music In America,0001-LEC Twelve Wk,Staff,30,0,30,0,0
14789,North Campus,MUL 2380 - 0002   Jazz And Popular Music In America,0002-LEC Main Sess,Staff,30,10,20,0,0
14790,North Campus,MUL 2380 - 0003   Jazz And Popular Music In America,0003-LEC Main Sess,Staff,30,28,2,0,0
14800,North Campus,MUL 2380 - 0004   Jazz And Popular Music In America,0004-LEC Main Sess,Staff,30,23,7,0,0
14801,North Campus,MUL 2380 - 0005   Jazz And Popular Music In America,0005-LEC Main Sess,Staff,30,12,18,0,0
14802,North Campus,MUL 2380 - 0006   Jazz And Popular Music In America,0006-LEC Main Sess,Staff,30,13,17,0,0
14803,North Campus,MUL 2380 - 0007   Jazz And Popular Music In America,0007-LEC Main Sess,Staff,30,0,30,0,0
14804,North Campus,MUL 2380 - 0008   Jazz And Popular Music In America,0008-LEC Main Sess,Staff,30,0,30,0,0
14805,North Campus,MUL 2380 - 0009   Jazz And Popular Music In America,0009-LEC Main Sess,Staff,30,21,9,0,0
14806,North Campus,MUL 2380 - 0010   Jazz And Popular Music In America,0010-LEC Main Sess,Staff,30,0,30,0,0
14841,North Campus,MUL 2380 - 0011   Jazz And Popular Music In America,0011-LEC Twelve Wk,Staff,30,12,18,0,0
14807,Kendall Campus,MUL 2380 - 0012   Jazz And Popular Music In America,0012-LEC Main Sess,Staff,40,37,3,0,0
14808,Kendall Campus,MUL 2380 - 0013   Jazz And Popular Music In America,0013-LEC Main Sess,Staff,40,17,23,0,0
14809,Kendall Campus,MUL 2380 - 0014   Jazz And Popular Music In America,0014-LEC Main Sess,Staff,35,0,35,0,0
14844,Kendall Campus,MUL 2380 - 0015   Jazz And Popular Music In America,0015-LEC Eight Wk 2,Staff,30,29,1,0,0
14810,Kendall Campus,MUL 2380 - 0016   Jazz And Popular Music In America,0016-LEC Main Sess,Staff,40,12,28,0,0
14811,Kendall Campus,MUL 2380 - 0017   Jazz And Popular Music In America,0017-LEC Main Sess,Staff,105,32,73,0,0
14812,Kendall Campus,MUL 2380 - 0018   Jazz And Popular Music In America,0018-LEC Main Sess,Staff,40,17,23,0,0
14813,Kendall Campus,MUL 2380 - 0019   Jazz And Popular Music In America,0019-LEC Main Sess,Staff,40,13,27,0,0
14814,Kendall Campus,MUL 2380 - 0020   Jazz And Popular Music In America,0020-LEC Main Sess,Staff,40,19,21,0,0
14815,Kendall Campus,MUL 2380 - 0021   Jazz And Popular Music In America,0021-LEC Main Sess,Staff,40,12,28,0,0
14816,Kendall Campus,MUL 2380 - 0022   Jazz And Popular Music In America,0022-LEC Main Sess,Staff,30,27,3,0,0
14845,Kendall Campus,MUL 2380 - 0023   Jazz And Popular Music In America,0023-LEC Conversion,Staff,40,0,40,0,0
14843,Kendall Campus,MUL 2380 - 0024   Jazz And Popular Music In America,0024-LEC Eight Wk 2,Staff,30,26,4,0,0
14817,Kendall Campus,MUL 2380 - 0025   Jazz And Popular Music In America,0025-LEC Main Sess,Staff,40,37,3,0,0
14818,Kendall Campus,MUL 2380 - 0026   Jazz And Popular Music In America,0026-LEC Main Sess,Staff,40,7,33,0,0
14819,Kendall Campus,MUL 2380 - 0027   Jazz And Popular Music In America,0027-LEC Main Sess,Staff,40,18,22,0,0
14820,Kendall Campus,MUL 2380 - 0028   Jazz And Popular Music In America,0028-LEC Main Sess,Staff,40,26,14,0,0
14821,Kendall Campus,MUL 2380 - 0029   Jazz And Popular Music In America,0029-LEC Main Sess,Staff,40,14,26,0,0
14822,Kendall Campus,MUL 2380 - 0030   Jazz And Popular Music In America,0030-LEC Main Sess,Staff,40,8,32,0,0
14823,Kendall Campus,MUL 2380 - 0031   Jazz And Popular Music In America,0031-LEC Main Sess,Staff,30,0,30,0,0
14824,Kendall Campus,MUL 2380 - 0032   Jazz And Popular Music In America,0032-LEC Main Sess,Staff,30,22,8,0,0
14825,Wolfson Campus,MUL 2380 - 0033   Jazz And Popular Music In America,0033-LEC Main Sess,Staff,40,0,40,0,0
14840,Wolfson Campus,MUL 2380 - 0034   Jazz And Popular Music In America,0034-LEC Twelve Wk,Staff,35,0,35,0,0
14839,Wolfson Campus,MUL 2380 - 0035   Jazz And Popular Music In America,0035-LEC Twelve Wk,Staff,2,0,2,0,0
14826,Wolfson Campus,MUL 2380 - 0036   Jazz And Popular Music In America,0036-LEC Main Sess,Staff,40,28,12,0,0
14847,Wolfson Campus,MUL 2380 - 0038   Jazz And Popular Music In America,0038-LEC 1st Mon Sp,Staff,40,38,2,0,0
14828,Wolfson Campus,MUL 2380 - 0039   Jazz And Popular Music In America,0039-LEC Main Sess,Staff,50,20,30,0,0
14829,Wolfson Campus,MUL 2380 - 0040   Jazz And Popular Music In America,0040-LEC Main Sess,Staff,40,0,40,0,0
14830,Wolfson Campus,MUL 2380 - 0041   Jazz And Popular Music In America,0041-LEC Main Sess,Staff,34,30,4,0,0
14831,Wolfson Campus,MUL 2380 - 0042   Jazz And Popular Music In America,0042-LEC Main Sess,Staff,30,29,1,0,0
14832,Wolfson Campus,MUL 2380 - 0043   Jazz And Popular Music In America,0043-LEC Main Sess,Staff,30,28,2,0,0
14833,Wolfson Campus,MUL 2380 - 0044   Jazz And Popular Music In America,0044-LEC Main Sess,Staff,30,26,4,0,0
14834,Homestead Campus,MUL 2380 - 0045   Jazz And Popular Music In America,0045-LEC Main Sess,Staff,39,19,20,0,0
14835,InterAmerican Campus,MUL 2380 - 0046   Jazz And Popular Music In America,0046-LEC Main Sess,Staff,40,38,2,0,0
14837,InterAmerican Campus,MUL 2380 - 0048   Jazz And Popular Music In America,0048-LEC Main Sess,Staff,35,11,24,0,0
14838,Hialeah Campus,MUL 2380 - 0049   Jazz And Popular Music In America,0049-LEC Twelve Wk,Staff,33,13,20,0,0
14799,Hialeah Campus,MUL 2380 - 0050   Jazz And Popular Music In America,0050-LEC Main Sess,Staff,33,30,3,0,0
14797,Hialeah Campus,MUL 2380 - 0052   Jazz And Popular Music In America,0052-LEC Main Sess,Staff,33,29,4,0,0
14796,Hialeah Campus,MUL 2380 - 0053   Jazz And Popular Music In America,0053-LEC Main Sess,Staff,33,30,3,0,0
14795,West Campus,MUL 2380 - 0054   Jazz And Popular Music In America,0054-LEC Main Sess,Staff,35,26,9,0,0
14794,West Campus,MUL 2380 - 0055   Jazz And Popular Music In America,0055-LEC Main Sess,Staff,35,21,14,0,0
14793,West Campus,MUL 2380 - 0056   Jazz And Popular Music In America,0056-LEC Main Sess,Staff,35,20,15,0,0
14792,West Campus,MUL 2380 - 0057   Jazz And Popular Music In America,0057-LEC Main Sess,Staff,35,10,25,0,0
14791,West Campus,MUL 2380 - 0058   Jazz And Popular Music In America,0058-LEC Main Sess,Staff,35,19,16,0,0
14846,West Campus,MUL 2380 - 0059   Jazz And Popular Music In America,0059-LEC Conversion,Staff,35,19,16,0,0
16445,Medical Campus,OPT 2377L - 0001   Refractometry 3 Laboratory,0001-LAB Main Sess,Staff,15,12,3,0,0
16446,Medical Campus,OPT 2377L - 0002   Refractometry 3 Laboratory,0002-LAB Conversion,Staff,15,12,3,0,0
16444,Medical Campus,OPT 2377L - 0003   Refractometry 3 Laboratory,0003-LAB Main Sess,Staff,12,0,12,0,0
6850,North Campus,CCJ 2358 - 0001   Criminal Justice Reporting,0001-LEC Twelve Wk,Staff,30,17,13,0,0
10444,Wolfson Campus,MUT 2352 - 0001   Popular Music Arranging 2,0001-LEC Main Sess,Staff,15,10,5,0,0
16759,Kendall Campus,MUT 2351 - 0001   Introduction To Popular Music Arranging,0001-LEC Main Sess,Staff,20,8,12,0,0
11164,North Campus,GEB 2350 - 0001   Introduction To International Business,0001-LEC Main Sess,Staff,30,0,30,0,0
11166,Kendall Campus,GEB 2350 - 0002   Introduction To International Business,0002-LEC Twelve Wk,Staff,25,19,6,0,0
11167,Wolfson Campus,GEB 2350 - 0003   Introduction To International Business,0003-LEC Twelve Wk,Staff,35,12,23,0,0
11165,Wolfson Campus,GEB 2350 - 0004   Introduction To International Business,0004-LEC Main Sess,Staff,30,20,10,0,0
14001,Medical Campus,RET 2350 - 0001   Respiratory Care Pharmacology,0001-LEC Main Sess,Staff,45,31,14,0,0
12960,Kendall Campus,MUN 2341 - 0001   Vocal Ensemble,0001-LAB Main Sess,Staff,25,12,13,0,0
12961,Kendall Campus,MUN 2341 - 0002   Vocal Ensemble,0002-LAB Main Sess,Staff,20,0,20,0,0
12962,Kendall Campus,MUN 2341 - 0003   Vocal Ensemble,0003-LAB Main Sess,Staff,20,14,6,0,0
12963,Wolfson Campus,MUN 2341 - 0004   Vocal Ensemble,0004-LAB Main Sess,Staff,25,16,9,0,0
12964,Wolfson Campus,MUN 2341 - 0005   Vocal Ensemble,0005-LAB Main Sess,Staff,5,1,4,0,0
12965,Wolfson Campus,MUN 2341 - 0006   Vocal Ensemble,0006-LAB Conversion,Staff,50,13,37,0,0
12575,InterAmerican Campus,SPN 2341 - 0001   Spanish For Native Speakers 2,0001-LEC Main Sess,Staff,30,8,22,0,0
14018,InterAmerican Campus,SPN 2340 - 0001   Spanish For Native Speakers 1,0001-LEC Main Sess,Staff,30,15,15,0,0
9535,Kendall Campus,COP 2335 - 0001   Object Oriented Programming Using C++,0001-LEC Main Sess,Staff,20,17,3,0,0
9534,Wolfson Campus,COP 2335 - 0002   Object Oriented Programming Using C++,0002-LEC Main Sess,Staff,30,16,14,0,0
11969,North Campus,OST 2335 - 0001   Business Writing,0001-LEC Main Sess,Staff,25,18,7,0,0
11970,Kendall Campus,OST 2335 - 0002   Business Writing,0002-LEC Main Sess,Staff,35,11,24,0,0
11974,Wolfson Campus,OST 2335 - 0003   Business Writing,0003-LEC Twelve Wk,Staff,30,9,21,0,0
11975,Wolfson Campus,OST 2335 - 0004   Business Writing,0004-LEC Conversion,Staff,30,0,30,0,0
11972,Homestead Campus,OST 2335 - 0006   Business Writing,0006-LEC Main Sess,Staff,28,0,28,0,0
11973,InterAmerican Campus,OST 2335 - 0007   Business Writing,0007-LEC Main Sess,Staff,21,14,7,0,0
9552,Kendall Campus,CTS 2334 - 0001   Configuring Advanced Windows Servers,0001-LEC Main Sess,Staff,22,0,22,0,0
9533,Wolfson Campus,COP 2333 - 0001   Advanced Programming Concepts Using Visual Basic,0001-LEC Main Sess,Staff,30,0,30,0,0
6407,Kendall Campus,IND 2330 - 0001   Interior Design Presentations 2,0001-LEC Main Sess,Staff,20,5,15,0,0
6406,Wolfson Campus,IND 2330 - 0002   Interior Design Presentations 2,0002-LEC Main Sess,Staff,15,11,4,0,0
14676,Kendall Campus,LIT 2330 - 0001   Survey Of Children's Literature,0001-LEC Main Sess,Staff,1,0,1,0,0
14877,Kendall Campus,MVJ 2329 - 0001   Jazz Percussion Drum Set Principal Instrument 2 Yr,0001-LEC Main Sess,Staff,15,0,15,0,0
10464,Wolfson Campus,MVJ 2328 - 0001   Jazz Trombone Principal Instrument Second Year,0001-LEC Main Sess,Staff,2,1,1,0,0
11512,North Campus,MVJ 2326 - 0001   Jazz Saxophone Principal Instrument Second Year,0001-LEC Main Sess,Staff,1,0,1,0,0
11514,Kendall Campus,MVJ 2326 - 0002   Jazz Saxophone Principal Instrument Second Year,0002-LEC Main Sess,Staff,50,2,48,0,0
9060,Kendall Campus,MVS 2326 - 0002   Guitar Principal Instrument Second Year,0002-LEC Main Sess,Staff,30,0,30,0,0
9058,Wolfson Campus,MVS 2326 - 0004   Guitar Principal Instrument Second Year,0004-LEC Main Sess,Staff,5,0,5,0,0
14870,Kendall Campus,MVB 2325 - 0001   Tuba Principal Instrument Second Year,0001-LEC Main Sess,Staff,15,0,15,0,0
8090,Wolfson Campus,MVW 2325 - 0002   Saxophone Principal Instrument Second Year,0002-LEC Main Sess,Staff,5,0,5,0,0
11522,Wolfson Campus,MVS 2324 - 0003   Bass Principal Instrument Second Year,0003-LEC Main Sess,Staff,5,0,5,0,0
10462,North Campus,MVB 2323 - 0002   Trombone Principal Instrument Second Year,0002-LEC Twelve Wk,Staff,1,0,1,0,0
10459,Kendall Campus,MVB 2323 - 0003   Trombone Principal Instrument Second Year,0003-LEC Main Sess,Staff,15,2,13,0,0
10460,Wolfson Campus,MVB 2323 - 0004   Trombone Principal Instrument Second Year,0004-LEC Main Sess,Staff,1,0,1,0,0
10461,Wolfson Campus,MVB 2323 - 0005   Trombone Principal Instrument Second Year,0005-LEC Main Sess,Staff,5,1,4,0,0
9047,Kendall Campus,MVJ 2323 - 0001   Jazz Guitar Principal Instrument Second Year,0001-LEC Main Sess,Staff,10,4,6,0,0
9046,Wolfson Campus,MVJ 2323 - 0002   Jazz Guitar Principal Instrument Second Year,0002-LEC Main Sess,Staff,1,0,1,0,0
11520,Kendall Campus,MVS 2323 - 0001   Cello Principal Instrument Second Year,0001-LEC Main Sess,Staff,30,0,30,0,0
11519,Wolfson Campus,MVS 2323 - 0002   Cello Principal Instrument Second Year,0002-LEC Main Sess,Staff,5,1,4,0,0
10481,Kendall Campus,MVW 2323 - 0001   Clarinet Principal Instrument Second Year,0001-LEC Main Sess,Staff,50,1,49,0,0
10483,Wolfson Campus,MVW 2323 - 0002   Clarinet Principal Instrument Second Year,0002-LEC Main Sess,Staff,5,0,5,0,0
10482,Wolfson Campus,MVW 2323 - 0003   Clarinet Principal Instrument Second Year,0003-LEC Main Sess,Staff,1,0,1,0,0
13850,Wolfson Campus,CIS 2322 - 0001   Systems Analysis And Design Implementation,0001-LEC Main Sess,Staff,30,15,15,0,0
12982,Kendall Campus,MVS 2322 - 0001   Viola Principal Instrument Second Year,0001-LEC Main Sess,Staff,10,2,8,0,0
12981,Wolfson Campus,MVS 2322 - 0002   Viola Principal Instrument Second Year,0002-LEC Main Sess,Staff,5,0,5,0,0
16778,Kendall Campus,MVW 2322 - 0001   Oboe Principal Instrument Second Year,0001-LEC Main Sess,Staff,30,1,29,0,0
11503,North Campus,MVB 2321 - 0001   Trumpet Principal Instrument Second Year,0001-LEC Main Sess,Staff,1,0,1,0,0
11506,Kendall Campus,MVB 2321 - 0002   Trumpet Principal Instrument Second Year,0002-LEC Main Sess,Staff,15,0,15,0,0
11505,Wolfson Campus,MVB 2321 - 0003   Trumpet Principal Instrument Second Year,0003-LEC Main Sess,Staff,5,1,4,0,0
11504,Wolfson Campus,MVB 2321 - 0004   Trumpet Principal Instrument Second Year,0004-LEC Main Sess,Staff,1,0,1,0,0
12281,Kendall Campus,MVJ 2321 - 0001   Jazz Voice Principal Instrument Second Year,0001-LEC Main Sess,Staff,10,1,9,0,0
12280,Kendall Campus,MVJ 2321 - 0002   Jazz Voice Principal Instrument Second Year,0002-LEC Main Sess,Staff,50,2,48,0,0
16410,North Campus,MVK 2321 - 0001   Piano Principal Instrument Second Year,0001-LEC Main Sess,Staff,1,0,1,0,0
16411,Kendall Campus,MVK 2321 - 0002   Piano Principal Instrument Second Year,0002-LEC Main Sess,Staff,40,2,38,0,0
16412,Kendall Campus,MVK 2321 - 0003   Piano Principal Instrument Second Year,0003-LEC Main Sess,Staff,30,0,30,0,0
16413,Kendall Campus,MVK 2321 - 0004   Piano Principal Instrument Second Year,0004-LEC Main Sess,Staff,30,0,30,0,0
16419,Kendall Campus,MVK 2321 - 0005   Piano Principal Instrument Second Year,0005-LEC Main Sess,Staff,20,0,20,0,0
16415,Kendall Campus,MVK 2321 - 0006   Piano Principal Instrument Second Year,0006-LEC Main Sess,Staff,30,0,30,0,0
16416,Kendall Campus,MVK 2321 - 0007   Piano Principal Instrument Second Year,0007-LEC Main Sess,Staff,30,0,30,0,0
16418,Wolfson Campus,MVK 2321 - 0009   Piano Principal Instrument Second Year,0009-LEC Main Sess,Staff,5,0,5,0,0
16414,Wolfson Campus,MVK 2321 - 0010   Piano Principal Instrument Second Year,0010-LEC Main Sess,Staff,1,0,1,0,0
16769,Kendall Campus,MVP 2321 - 0001   Percussion Principal Instrument Second Year,0001-LEC Main Sess,Staff,15,1,14,0,0
8057,Wolfson Campus,MVS 2321 - 0001   Violin Principal Instrument Second Year,0001-LEC Main Sess,Staff,5,0,5,0,0
13939,Kendall Campus,MVV 2321 - 0003   Voice Principal Instrument Second Year,0003-LEC Main Sess,Staff,30,2,28,0,0
13940,Kendall Campus,MVV 2321 - 0004   Voice Principal Instrument Second Year,0004-LEC Main Sess,Staff,16,3,13,0,0
13945,Kendall Campus,MVV 2321 - 0005   Voice Principal Instrument Second Year,0005-LEC Main Sess,Staff,30,1,29,0,0
13942,Wolfson Campus,MVV 2321 - 0006   Voice Principal Instrument Second Year,0006-LEC Main Sess,Staff,5,3,2,0,0
13944,Wolfson Campus,MVV 2321 - 0008   Voice Principal Instrument Second Year,0008-LEC Main Sess,Staff,1,0,1,0,0
13941,Wolfson Campus,MVV 2321 - 0009   Voice Principal Instrument Second Year,0009-LEC Main Sess,Staff,50,4,46,0,0
13949,Kendall Campus,MVW 2321 - 0001   Flute Principal Instrument Second Year,0001-LEC Main Sess,Staff,10,1,9,0,0
13951,Wolfson Campus,MVW 2321 - 0002   Flute Principal Instrument Second Year,0002-LEC Main Sess,Staff,5,0,5,0,0
8763,Homestead Campus,ASC 2320 - 0001   Aviation Laws And Regulations,0001-LEC Main Sess,Staff,30,0,30,0,0
8764,Homestead Campus,ASC 2320 - 0002   Aviation Laws And Regulations,0002-LEC Eight Wk 1,Staff,30,27,3,0,0
13933,Kendall Campus,MVJ 2320 - 0001   Jazz Piano Principal Instrument Second Year,0001-LEC Main Sess,Staff,50,2,48,0,0
12793,North Campus,MAC 2313 - 0001   Calculus and Analytical Geometry 3,0001-LEC Main Sess,Staff,35,23,12,0,0
12794,Kendall Campus,MAC 2313 - 0002   Calculus and Analytical Geometry 3,0002-LEC Main Sess,Staff,25,18,7,0,0
12795,Kendall Campus,MAC 2313 - 0003   Calculus and Analytical Geometry 3,0003-LEC Main Sess,Staff,35,29,6,0,0
12799,Wolfson Campus,MAC 2313 - 0004   Calculus and Analytical Geometry 3,0004-LEC Main Sess,Staff,38,37,1,0,0
12797,Wolfson Campus,MAC 2313 - 0005   Calculus and Analytical Geometry 3,0005-LEC Main Sess,Staff,35,0,35,0,0
12798,InterAmerican Campus,MAC 2313 - 0006   Calculus and Analytical Geometry 3,0006-LEC Main Sess,Staff,30,28,2,0,0
12796,InterAmerican Campus,MAC 2313 - 0007   Calculus and Analytical Geometry 3,0007-LEC Main Sess,Staff,37,0,37,0,0
10303,North Campus,EGN 2312 - 0001   Engineering Mechanics - Statics (With Vectors),0001-LEC Main Sess,Staff,30,9,21,0,0
10302,Kendall Campus,EGN 2312 - 0002   Engineering Mechanics - Statics (With Vectors),0002-LEC Main Sess,Staff,24,11,13,0,0
7469,North Campus,MAC 2312 - 0001   Calculus and Analytical Geometry 2,0001-LEC Main Sess,Staff,30,0,30,0,0
7490,North Campus,MAC 2312 - 0002   Calculus and Analytical Geometry 2,0002-LEC Main Sess,Staff,30,21,9,0,0
7471,North Campus,MAC 2312 - 0003   Calculus and Analytical Geometry 2,0003-LEC Main Sess,Staff,20,17,3,0,0
7472,North Campus,MAC 2312 - 0004   Calculus and Analytical Geometry 2,0004-LEC Main Sess,Staff,30,8,22,0,0
7473,North Campus,MAC 2312 - 0005   Calculus and Analytical Geometry 2,0005-LEC Main Sess,Staff,30,24,6,0,0
7474,Kendall Campus,MAC 2312 - 0006   Calculus and Analytical Geometry 2,0006-LEC Main Sess,Staff,36,31,5,0,0
7476,Kendall Campus,MAC 2312 - 0008   Calculus and Analytical Geometry 2,0008-LEC Main Sess,Staff,40,39,1,0,0
7477,Kendall Campus,MAC 2312 - 0009   Calculus and Analytical Geometry 2,0009-LEC Main Sess,Staff,25,0,25,0,0
7479,Wolfson Campus,MAC 2312 - 0011   Calculus and Analytical Geometry 2,0011-LEC Main Sess,Staff,38,35,3,0,0
7480,Wolfson Campus,MAC 2312 - 0012   Calculus and Analytical Geometry 2,0012-LEC Main Sess,Staff,38,37,1,0,0
7482,Homestead Campus,MAC 2312 - 0014   Calculus and Analytical Geometry 2,0014-LEC Main Sess,Staff,30,0,30,0,0
7484,InterAmerican Campus,MAC 2312 - 0016   Calculus and Analytical Geometry 2,0016-LEC Main Sess,Staff,35,34,1,0,0
7485,InterAmerican Campus,MAC 2312 - 0017   Calculus and Analytical Geometry 2,0017-LEC Main Sess,Staff,30,20,10,0,0
7470,InterAmerican Campus,MAC 2312 - 0018   Calculus and Analytical Geometry 2,0018-LEC Main Sess,Staff,30,0,30,0,0
7487,Hialeah Campus,MAC 2312 - 0020   Calculus and Analytical Geometry 2,0020-LEC Main Sess,Staff,25,15,10,0,0
7488,Hialeah Campus,MAC 2312 - 0021   Calculus and Analytical Geometry 2,0021-LEC Main Sess,Staff,30,0,30,0,0
7489,Hialeah Campus,MAC 2312 - 0022   Calculus and Analytical Geometry 2,0022-LEC Main Sess,Staff,33,0,33,0,0
7633,North Campus,EDG 2311 - 0001   Substitute Training,0001-LEC Conversion,Staff,30,21,9,0,0
7634,North Campus,EDG 2311 - 0002   Substitute Training,0002-LEC Conversion,Staff,19,18,1,0,0
7636,Homestead Campus,EDG 2311 - 0003   Substitute Training,0003-LEC Conversion,Staff,35,32,3,0,0
7635,Homestead Campus,EDG 2311 - 0004   Substitute Training,0004-LEC Conversion,Staff,30,26,4,0,0
7639,Homestead Campus,EDG 2311 - 0005   Substitute Training,0005-LEC Conversion,Staff,30,25,5,0,0
7644,InterAmerican Campus,EDG 2311 - 0006   Substitute Training,0006-LEC Conversion,Staff,30,24,6,0,0
7638,InterAmerican Campus,EDG 2311 - 0007   Substitute Training,0007-LEC Conversion,Staff,30,20,10,0,0
7641,InterAmerican Campus,EDG 2311 - 0008   Substitute Training,0008-LEC Conversion,Staff,30,26,4,0,0
7642,InterAmerican Campus,EDG 2311 - 0009   Substitute Training,0009-LEC Conversion,Staff,30,27,3,0,0
7628,InterAmerican Campus,EDG 2311 - 0011   Substitute Training,0011-LEC Conversion,Staff,28,24,4,0,0
7630,InterAmerican Campus,EDG 2311 - 0012   Substitute Training,0012-LEC Conversion,Staff,30,23,7,0,0
7629,Hialeah Campus,EDG 2311 - 0013   Substitute Training,0013-LEC Conversion,Staff,30,23,7,0,0
7640,Hialeah Campus,EDG 2311 - 0014   Substitute Training,0014-LEC Conversion,Staff,33,31,2,0,0
7631,Hialeah Campus,EDG 2311 - 0015   Substitute Training,0015-LEC Conversion,Staff,32,30,2,0,0
7632,Hialeah Campus,EDG 2311 - 0016   Substitute Training,0016-LEC Conversion,Staff,32,31,1,0,0
7637,Hialeah Campus,EDG 2311 - 0017   Substitute Training,0017-LEC Conversion,Staff,32,26,6,0,0
9580,North Campus,MAC 2311 - 0001   Calculus and Analytical Geometry 1,0001-LEC Main Sess,Staff,34,20,14,0,0
9581,North Campus,MAC 2311 - 0002   Calculus and Analytical Geometry 1,0002-LEC Main Sess,Staff,34,10,24,0,0
9582,North Campus,MAC 2311 - 0003   Calculus and Analytical Geometry 1,0003-LEC Main Sess,Staff,34,19,15,0,0
9583,North Campus,MAC 2311 - 0004   Calculus and Analytical Geometry 1,0004-LEC Main Sess,Staff,34,32,2,0,0
9584,Kendall Campus,MAC 2311 - 0005   Calculus and Analytical Geometry 1,0005-LEC Main Sess,Staff,36,19,17,0,0
9586,Kendall Campus,MAC 2311 - 0007   Calculus and Analytical Geometry 1,0007-LEC Main Sess,Staff,25,19,6,0,0
9587,Kendall Campus,MAC 2311 - 0008   Calculus and Analytical Geometry 1,0008-LEC Main Sess,Staff,30,0,30,0,0
9588,Kendall Campus,MAC 2311 - 0009   Calculus and Analytical Geometry 1,0009-LEC Main Sess,Staff,35,17,18,0,0
9589,Kendall Campus,MAC 2311 - 0010   Calculus and Analytical Geometry 1,0010-LEC Main Sess,Staff,35,33,2,0,0
9590,Kendall Campus,MAC 2311 - 0011   Calculus and Analytical Geometry 1,0011-LEC Main Sess,Staff,35,33,2,0,0
9591,Kendall Campus,MAC 2311 - 0012   Calculus and Analytical Geometry 1,0012-LEC Main Sess,Staff,35,13,22,0,0
9593,Wolfson Campus,MAC 2311 - 0014   Calculus and Analytical Geometry 1,0014-LEC Main Sess,Staff,38,22,16,0,0
9594,Wolfson Campus,MAC 2311 - 0015   Calculus and Analytical Geometry 1,0015-LEC Main Sess,Staff,41,0,41,0,0
9595,Wolfson Campus,MAC 2311 - 0016   Calculus and Analytical Geometry 1,0016-LEC Main Sess,Staff,38,33,5,0,0
9596,Wolfson Campus,MAC 2311 - 0017   Calculus and Analytical Geometry 1,0017-LEC Main Sess,Staff,38,37,1,0,0
9599,Wolfson Campus,MAC 2311 - 0020   Calculus and Analytical Geometry 1,0020-LEC Main Sess,Staff,38,23,15,0,0
9601,InterAmerican Campus,MAC 2311 - 0022   Calculus and Analytical Geometry 1,0022-LEC Main Sess,Staff,37,35,2,0,0
9602,InterAmerican Campus,MAC 2311 - 0023   Calculus and Analytical Geometry 1,0023-LEC Main Sess,Staff,30,0,30,0,0
9603,InterAmerican Campus,MAC 2311 - 0024   Calculus and Analytical Geometry 1,0024-LEC Main Sess,Staff,35,34,1,0,0
9607,InterAmerican Campus,MAC 2311 - 0025   Calculus and Analytical Geometry 1,0025-LEC Twelve Wk,Staff,35,31,4,0,0
9604,Hialeah Campus,MAC 2311 - 0026   Calculus and Analytical Geometry 1,0026-LEC Main Sess,Staff,32,27,5,0,0
9605,Hialeah Campus,MAC 2311 - 0027   Calculus and Analytical Geometry 1,0027-LEC Main Sess,Staff,35,26,9,0,0
9606,Hialeah Campus,MAC 2311 - 0028   Calculus and Analytical Geometry 1,0028-LEC Main Sess,Staff,31,0,31,0,0
12313,Wolfson Campus,NUR 2310 - 0001   Pediatric Nursing,0001-LEC Conversion,Staff,30,19,11,0,0
12314,Medical Campus,NUR 2310 - 0002   Pediatric Nursing,0002-LEC Conversion,Staff,30,24,6,0,0
12316,Medical Campus,NUR 2310 - 0004   Pediatric Nursing,0004-LEC Conversion,Staff,50,14,36,0,0
13043,Medical Campus,NUR 2310L - 0002   Pediatric Nursing Clinical Lab,0002-CLN Conversion,Staff,8,0,8,0,0
13064,Medical Campus,NUR 2310L - 0004   Pediatric Nursing Clinical Lab,0004-CLN Conversion,Staff,8,7,1,0,0
13066,Medical Campus,NUR 2310L - 0005   Pediatric Nursing Clinical Lab,0005-CLN Conversion,Staff,8,7,1,0,0
13071,Medical Campus,NUR 2310L - 0007   Pediatric Nursing Clinical Lab,0007-CLN Conversion,Staff,8,5,3,0,0
13045,Medical Campus,NUR 2310L - 0009   Pediatric Nursing Clinical Lab,0009-CLN Conversion,Staff,8,0,8,0,0
13051,Medical Campus,NUR 2310L - 0010   Pediatric Nursing Clinical Lab,0010-CLN Conversion,Staff,8,7,1,0,0
13070,Medical Campus,NUR 2310L - 0013   Pediatric Nursing Clinical Lab,0013-CLN Conversion,Staff,8,6,2,0,0
13067,Medical Campus,NUR 2310L - 0014   Pediatric Nursing Clinical Lab,0014-CLN Conversion,Staff,8,7,1,0,0
13047,Medical Campus,NUR 2310L - 0016   Pediatric Nursing Clinical Lab,0016-CLN Conversion,Staff,8,6,2,0,0
13046,Medical Campus,NUR 2310L - 0018   Pediatric Nursing Clinical Lab,0018-CLN Conversion,Staff,8,0,8,0,0
13057,Medical Campus,NUR 2310L - 0019   Pediatric Nursing Clinical Lab,0019-CLN Conversion,Staff,8,0,8,0,0
13058,Medical Campus,NUR 2310L - 0020   Pediatric Nursing Clinical Lab,0020-CLN Conversion,Staff,8,0,8,0,0
13062,Medical Campus,NUR 2310L - 0021   Pediatric Nursing Clinical Lab,0021-CLN Conversion,Staff,8,0,8,0,0
13063,Medical Campus,NUR 2310L - 0022   Pediatric Nursing Clinical Lab,0022-CLN Conversion,Staff,8,0,8,0,0
13042,Medical Campus,NUR 2310L - 0023   Pediatric Nursing Clinical Lab,0023-CLN Conversion,Staff,8,6,2,0,0
13049,Medical Campus,NUR 2310L - 0027   Pediatric Nursing Clinical Lab,0027-CLN Conversion,Staff,8,6,2,0,0
13040,Medical Campus,NUR 2310L - 0029   Pediatric Nursing Clinical Lab,0029-CLN Conversion,Staff,8,6,2,0,0
13059,Medical Campus,NUR 2310L - 0031   Pediatric Nursing Clinical Lab,0031-CLN Conversion,Staff,8,0,8,0,0
13044,Homestead Campus,NUR 2310L - 0032   Pediatric Nursing Clinical Lab,0032-CLN Conversion,Staff,8,7,1,0,0
7762,Kendall Campus,CTS 2306 - 0001   Administering Windows Servers,0001-LEC Main Sess,Staff,22,15,7,0,0
7763,Wolfson Campus,CTS 2306 - 0002   Administering Windows Servers,0002-LEC Eight Wk 2,Staff,16,11,5,0,0
5321,Homestead Campus,ATF 2305 - 0001   Instruments Pilot Flight,0001-LEC Conversion,Staff,30,1,29,0,0
5320,Homestead Campus,ATF 2305 - 0002   Instruments Pilot Flight,0002-LEC Conversion,Staff,30,7,23,0,0
5371,Kendall Campus,ARC 2304 - 0003   Architectural Design 4,0003-LEC Main Sess,Staff,15,13,2,0,0
5373,Kendall Campus,ARC 2304 - 0005   Architectural Design 4,0005-LEC Main Sess,Staff,15,12,3,0,0
5372,Wolfson Campus,ARC 2304 - 0007   Architectural Design 4,0007-LEC Main Sess,Staff,15,11,4,0,0
7452,Kendall Campus,CTS 2303 - 0001   Configuring Windows Servers,0001-LEC Main Sess,Staff,22,20,2,0,0
14641,Wolfson Campus,HUS 2303 - 0001   Counseling Techniques,0001-LEC Main Sess,Staff,45,24,21,0,0
11917,North Campus,MAP 2302 - 0001   Introduction To Differential Equations,0001-LEC Main Sess,Staff,30,18,12,0,0
11918,Kendall Campus,MAP 2302 - 0002   Introduction To Differential Equations,0002-LEC Main Sess,Staff,30,15,15,0,0
11919,Kendall Campus,MAP 2302 - 0003   Introduction To Differential Equations,0003-LEC Main Sess,Staff,40,16,24,0,0
11920,Kendall Campus,MAP 2302 - 0004   Introduction To Differential Equations,0004-LEC Main Sess,Staff,30,0,30,0,0
11926,Wolfson Campus,MAP 2302 - 0005   Introduction To Differential Equations,0005-LEC Main Sess,Staff,35,25,10,0,0
11922,Wolfson Campus,MAP 2302 - 0006   Introduction To Differential Equations,0006-LEC Main Sess,Staff,25,18,7,0,0
11924,Homestead Campus,MAP 2302 - 0008   Introduction To Differential Equations,0008-LEC Main Sess,Staff,3,2,1,0,0
11925,InterAmerican Campus,MAP 2302 - 0009   Introduction To Differential Equations,0009-LEC Main Sess,Staff,37,13,24,0,0
11921,InterAmerican Campus,MAP 2302 - 0010   Introduction To Differential Equations,0010-LEC Main Sess,Staff,37,0,37,0,0
10950,Wolfson Campus,ECO 2301 - 0001   History Of Economics Ideas And Their Consequences,0001-LEC Main Sess,Staff,30,24,6,0,0
11322,Wolfson Campus,ENC 2300 - 0001   Advanced Composition And Communication,0001-LEC Main Sess,Staff,30,0,30,0,0
11324,Wolfson Campus,ENC 2300 - 0002   Advanced Composition And Communication,0002-LEC Main Sess,Staff,30,29,1,0,0
11323,Wolfson Campus,ENC 2300 - 0003   Advanced Composition And Communication,0003-LEC Main Sess,Staff,30,0,30,0,0
11741,North Campus,MAN 2300 - 0001   Human Resources Management,0001-LEC Conversion,Staff,30,12,18,0,0
11739,Kendall Campus,MAN 2300 - 0002   Human Resources Management,0002-LEC Main Sess,Staff,35,17,18,0,0
11740,Wolfson Campus,MAN 2300 - 0003   Human Resources Management,0003-LEC Twelve Wk,Staff,30,23,7,0,0
12376,Kendall Campus,PHM 2300 - 0001   Political Philosophy,0001-LEC Main Sess,Staff,37,14,23,0,0
12378,Wolfson Campus,PHM 2300 - 0002   Political Philosophy,0002-LEC Main Sess,Staff,30,0,30,0,0
12377,Homestead Campus,PHM 2300 - 0003   Political Philosophy,0003-LEC Main Sess,Staff,30,7,23,0,0
12437,North Campus,REL 2300 - 0001   Survey Of World Religions,0001-LEC Main Sess,Staff,20,0,20,0,0
12445,North Campus,REL 2300 - 0002   Survey Of World Religions,0002-LEC Twelve Wk,Staff,30,20,10,0,0
12446,North Campus,REL 2300 - 0003   Survey Of World Religions,0003-LEC Twelve Wk,Staff,30,8,22,0,0
12438,Kendall Campus,REL 2300 - 0004   Survey Of World Religions,0004-LEC Main Sess,Staff,37,17,20,0,0
12439,Kendall Campus,REL 2300 - 0005   Survey Of World Religions,0005-LEC Main Sess,Staff,38,0,38,0,0
12440,Kendall Campus,REL 2300 - 0006   Survey Of World Religions,0006-LEC Main Sess,Staff,37,31,6,0,0
12441,Kendall Campus,REL 2300 - 0007   Survey Of World Religions,0007-LEC Main Sess,Staff,30,12,18,0,0
12443,Wolfson Campus,REL 2300 - 0008   Survey Of World Religions,0008-LEC Main Sess,Staff,30,27,3,0,0
12444,Hialeah Campus,REL 2300 - 0009   Survey Of World Religions,0009-LEC Main Sess,Staff,25,0,25,0,0
12442,Hialeah Campus,REL 2300 - 0010   Survey Of World Religions,0010-LEC Main Sess,Staff,33,22,11,0,0
11010,North Campus,RTV 2300 - 0001   Broadcast Writing,0001-LEC Main Sess,Staff,23,12,11,0,0
11009,North Campus,RTV 2300 - 0002   Broadcast Writing,0002-LEC Main Sess,Staff,23,10,13,0,0
11893,North Campus,TPA 2292 - 0001   Production Lab,0001-LAB Main Sess,Staff,15,8,7,0,0
11894,Kendall Campus,TPA 2292 - 0002   Production Lab,0002-LAB Main Sess,Staff,10,2,8,0,0
11896,Wolfson Campus,TPA 2292 - 0003   Production Lab,0003-LAB Conversion,Staff,25,8,17,0,0
11897,Wolfson Campus,TPA 2292 - 0004   Production Lab,0004-LAB Conversion,Staff,40,8,32,0,0
11895,Wolfson Campus,TPA 2292 - 0005   Production Lab,0005-LAB Main Sess,Staff,25,1,24,0,0
9475,Medical Campus,RET 2275 - 0001   Respiratory Care Theory 2,0001-LEC Main Sess,Staff,45,32,13,0,0
9793,Medical Campus,RET 2275L - 0002   Respiratory Care Theory Laboratory 2,0002-LAB Main Sess,Staff,18,14,4,0,0
14495,North Campus,EEC 2271 - 0001   Working With Young Children With Special Needs And Their Families,0001-LEC Main Sess,Staff,30,26,4,0,0
14496,Kendall Campus,EEC 2271 - 0002   Working With Young Children With Special Needs And Their Families,0002-LEC Main Sess,Staff,30,27,3,0,0
14498,Homestead Campus,EEC 2271 - 0003   Working With Young Children With Special Needs And Their Families,0003-LEC Main Sess,Staff,30,15,15,0,0
14497,InterAmerican Campus,EEC 2271 - 0004   Working With Young Children With Special Needs And Their Families,0004-LEC Main Sess,Staff,30,19,11,0,0
7434,North Campus,COP 2270 - 0001   "C" For Engineers,0001-LEC Main Sess,Staff,24,16,8,0,0
7435,North Campus,COP 2270 - 0002   "C" For Engineers,0002-LEC Main Sess,Staff,24,0,24,0,0
7436,North Campus,COP 2270 - 0003   "C" For Engineers,0003-LEC Main Sess,Staff,24,10,14,0,0
7443,North Campus,COP 2270 - 0005   "C" For Engineers,0005-LEC Twelve Wk,Staff,24,23,1,0,0
7440,Kendall Campus,COP 2270 - 0008   "C" For Engineers,0008-LEC Main Sess,Staff,24,20,4,0,0
7442,Wolfson Campus,COP 2270 - 0010   "C" For Engineers,0010-LEC Main Sess,Staff,24,21,3,0,0
11298,Kendall Campus,ISS 2270 - 0001   Multicultural Communications And Relations,0001-LEC Main Sess,Staff,45,15,30,0,0
16940,North Campus,TPP 2260 - 0001   Acting For The Camera 1,0001-LEC 1st Mon Sp,Staff,12,10,2,0,0
11113,Wolfson Campus,TPP 2256 - 0001   Musical Theatre 2,0001-LEC Main Sess,Staff,25,5,20,0,0
13914,North Campus,MUT 2247 - 0001   Sightsinging And Ear Training 2,0001-LAB Main Sess,Staff,15,14,1,0,0
13915,Kendall Campus,MUT 2247 - 0002   Sightsinging And Ear Training 2,0002-LAB Main Sess,Staff,15,12,3,0,0
13917,Wolfson Campus,MUT 2247 - 0004   Sightsinging And Ear Training 2,0004-LAB Main Sess,Staff,17,15,2,0,0
13918,Wolfson Campus,MUT 2247 - 0005   Sightsinging And Ear Training 2,0005-LAB Main Sess,Staff,30,10,20,0,0
13916,Wolfson Campus,MUT 2247 - 0006   Sightsinging And Ear Training 2,0006-LAB Main Sess,Staff,15,0,15,0,0
14867,North Campus,MUT 2246 - 0001   Sightsinging And Ear Training 1,0001-LAB Main Sess,Staff,20,8,12,0,0
7815,North Campus,BUL 2242 - 0001   Business Law 2,0001-LEC Main Sess,Staff,25,6,19,0,0
7816,Kendall Campus,BUL 2242 - 0002   Business Law 2,0002-LEC Main Sess,Staff,25,12,13,0,0
7819,Wolfson Campus,BUL 2242 - 0003   Business Law 2,0003-LEC Main Sess,Staff,25,24,1,0,0
7818,Wolfson Campus,BUL 2242 - 0004   Business Law 2,0004-LEC Main Sess,Staff,25,13,12,0,0
7817,InterAmerican Campus,BUL 2242 - 0005   Business Law 2,0005-LEC Main Sess,Staff,30,14,16,0,0
5528,North Campus,DSC 2242 - 0001   Transportation And Border Security,0001-LEC Twelve Wk,Staff,40,31,9,0,0
5527,InterAmerican Campus,DSC 2242 - 0002   Transportation And Border Security,0002-LEC Main Sess,Staff,30,0,30,0,0
5526,InterAmerican Campus,DSC 2242 - 0003   Transportation And Border Security,0003-LEC Main Sess,Staff,30,0,30,0,0
5529,InterAmerican Campus,DSC 2242 - 0004   Transportation And Border Security,0004-LEC Twelve Wk,Staff,30,0,30,0,0
5719,North Campus,BUL 2241 - 0001   Business Law 1,0001-LEC Main Sess,Staff,30,19,11,0,0
5720,North Campus,BUL 2241 - 0002   Business Law 1,0002-LEC Main Sess,Staff,25,16,9,0,0
5724,North Campus,BUL 2241 - 0003   Business Law 1,0003-LEC Main Sess,Staff,25,18,7,0,0
5725,North Campus,BUL 2241 - 0004   Business Law 1,0004-LEC Main Sess,Staff,30,9,21,0,0
5726,Kendall Campus,BUL 2241 - 0005   Business Law 1,0005-LEC Main Sess,Staff,35,0,35,0,0
5727,Kendall Campus,BUL 2241 - 0006   Business Law 1,0006-LEC Main Sess,Staff,25,18,7,0,0
5728,Kendall Campus,BUL 2241 - 0007   Business Law 1,0007-LEC Main Sess,Staff,25,10,15,0,0
5729,Kendall Campus,BUL 2241 - 0008   Business Law 1,0008-LEC Main Sess,Staff,35,29,6,0,0
5730,Wolfson Campus,BUL 2241 - 0010   Business Law 1,0010-LEC Main Sess,Staff,30,24,6,0,0
5735,Wolfson Campus,BUL 2241 - 0011   Business Law 1,0011-LEC Twelve Wk,Staff,30,29,1,0,0
5732,Wolfson Campus,BUL 2241 - 0013   Business Law 1,0013-LEC Main Sess,Staff,25,20,5,0,0
5733,Wolfson Campus,BUL 2241 - 0014   Business Law 1,0014-LEC Main Sess,Staff,25,0,25,0,0
5734,Wolfson Campus,BUL 2241 - 0015   Business Law 1,0015-LEC Main Sess,Staff,30,24,6,0,0
5723,Wolfson Campus,BUL 2241 - 0016   Business Law 1,0016-LEC Main Sess,Staff,30,15,15,0,0
5737,Homestead Campus,BUL 2241 - 0017   Business Law 1,0017-LEC Eight Wk 2,Staff,18,0,18,0,0
5722,Homestead Campus,BUL 2241 - 0018   Business Law 1,0018-LEC Main Sess,Staff,18,4,14,0,0
5721,InterAmerican Campus,BUL 2241 - 0019   Business Law 1,0019-LEC Main Sess,Staff,27,18,9,0,0
5736,Hialeah Campus,BUL 2241 - 0020   Business Law 1,0020-LEC Eight Wk 1,Staff,25,4,21,0,0
8363,Kendall Campus,HFT 2241 - 0001   Leadership And Quality Assurance Management,0001-LEC Main Sess,Staff,30,1,29,0,0
8365,Wolfson Campus,HFT 2241 - 0002   Leadership And Quality Assurance Management,0002-LEC Twelve Wk,Staff,25,15,10,0,0
8364,Wolfson Campus,HFT 2241 - 0003   Leadership And Quality Assurance Management,0003-LEC Main Sess,Staff,30,0,30,0,0
14677,North Campus,MAC 2241 - 0001   Life Science Calculus,0001-LEC Main Sess,Staff,30,0,30,0,0
10443,Kendall Campus,MUT 2239 - 0001   Jazz Keyboard Harmony 2,0001-LEC Main Sess,Staff,15,3,12,0,0
10442,Wolfson Campus,MUT 2239 - 0002   Jazz Keyboard Harmony 2,0002-LEC Main Sess,Staff,15,3,12,0,0
14917,North Campus,PGY 2239 - 0001   Illustrative Photography 2,0001-LEC Main Sess,Staff,20,6,14,0,0
7076,Medical Campus,HIM 2234 - 0001   Advanced Coding & Reimbursement Systems,0001-LEC Main Sess,Staff,30,12,18,0,0
7075,Medical Campus,HIM 2234 - 0002   Advanced Coding & Reimbursement Systems,0002-LEC Main Sess,Staff,30,10,20,0,0
12231,Medical Campus,HIM 2234L - 0001   Advanced Coding & Reimbursement Systems Laboratory,0001-LAB Main Sess,Staff,30,12,18,0,0
12230,Medical Campus,HIM 2234L - 0002   Advanced Coding & Reimbursement Systems Laboratory,0002-LAB Main Sess,Staff,30,10,20,0,0
9232,North Campus,MAC 2233 - 0001   Business Calculus,0001-LEC Main Sess,Staff,40,38,2,0,0
9233,North Campus,MAC 2233 - 0002   Business Calculus,0002-LEC Main Sess,Staff,40,16,24,0,0
9239,North Campus,MAC 2233 - 0003   Business Calculus,0003-LEC Main Sess,Staff,40,36,4,0,0
9240,Kendall Campus,MAC 2233 - 0004   Business Calculus,0004-LEC Main Sess,Staff,39,31,8,0,0
9241,Kendall Campus,MAC 2233 - 0005   Business Calculus,0005-LEC Main Sess,Staff,40,37,3,0,0
9242,Kendall Campus,MAC 2233 - 0006   Business Calculus,0006-LEC Main Sess,Staff,39,36,3,0,0
9267,Kendall Campus,MAC 2233 - 0007   Business Calculus,0007-LEC Weekend,Staff,45,26,19,0,0
9243,Kendall Campus,MAC 2233 - 0008   Business Calculus,0008-LEC Main Sess,Staff,40,29,11,0,0
9244,Kendall Campus,MAC 2233 - 0009   Business Calculus,0009-LEC Main Sess,Staff,40,38,2,0,0
9245,Kendall Campus,MAC 2233 - 0010   Business Calculus,0010-LEC Main Sess,Staff,38,20,18,0,0
9246,Kendall Campus,MAC 2233 - 0011   Business Calculus,0011-LEC Main Sess,Staff,40,21,19,0,0
9247,Kendall Campus,MAC 2233 - 0012   Business Calculus,0012-LEC Main Sess,Staff,39,37,2,0,0
9263,Kendall Campus,MAC 2233 - 0014   Business Calculus,0014-LEC Eight Wk 2,Staff,40,14,26,0,0
9250,Wolfson Campus,MAC 2233 - 0016   Business Calculus,0016-LEC Main Sess,Staff,38,35,3,0,0
9262,Wolfson Campus,MAC 2233 - 0017   Business Calculus,0017-LEC Eight Wk 2,Staff,25,18,7,0,0
9251,Wolfson Campus,MAC 2233 - 0018   Business Calculus,0018-LEC Main Sess,Staff,38,36,2,0,0
9252,Wolfson Campus,MAC 2233 - 0019   Business Calculus,0019-LEC Main Sess,Staff,38,15,23,0,0
9265,Wolfson Campus,MAC 2233 - 0021   Business Calculus,0021-LEC Conversion,Staff,20,0,20,0,0
9254,Wolfson Campus,MAC 2233 - 0022   Business Calculus,0022-LEC Main Sess,Staff,38,35,3,0,0
9255,Wolfson Campus,MAC 2233 - 0023   Business Calculus,0023-LEC Main Sess,Staff,25,15,10,0,0
9256,Wolfson Campus,MAC 2233 - 0024   Business Calculus,0024-LEC Main Sess,Staff,30,20,10,0,0
9264,Wolfson Campus,MAC 2233 - 0025   Business Calculus,0025-LEC Conversion,Staff,30,27,3,0,0
9257,Wolfson Campus,MAC 2233 - 0026   Business Calculus,0026-LEC Main Sess,Staff,30,25,5,0,0
9258,Wolfson Campus,MAC 2233 - 0027   Business Calculus,0027-LEC Main Sess,Staff,30,26,4,0,0
9259,Homestead Campus,MAC 2233 - 0028   Business Calculus,0028-LEC Main Sess,Staff,35,30,5,0,0
9266,InterAmerican Campus,MAC 2233 - 0029   Business Calculus,0029-LEC 1st Mon Sp,Staff,37,35,2,0,0
9260,InterAmerican Campus,MAC 2233 - 0030   Business Calculus,0030-LEC Main Sess,Staff,35,33,2,0,0
9261,InterAmerican Campus,MAC 2233 - 0031   Business Calculus,0031-LEC Main Sess,Staff,35,0,35,0,0
9237,Hialeah Campus,MAC 2233 - 0033   Business Calculus,0033-LEC Main Sess,Staff,33,18,15,0,0
9236,Hialeah Campus,MAC 2233 - 0034   Business Calculus,0034-LEC Main Sess,Staff,30,26,4,0,0
9234,Hialeah Campus,MAC 2233 - 0036   Business Calculus,0036-LEC Main Sess,Staff,30,28,2,0,0
15790,Wolfson Campus,SYG 2230 - 0001   Multi-Ethnic America,0001-LEC Main Sess,Staff,34,11,23,0,0
11518,Wolfson Campus,MVS 2226 - 0001   Guitar Secondary Instrument Second Year,0001-LEC Main Sess,Staff,1,0,1,0,0
7997,North Campus,EEC 2224 - 0001   Emergent Literacy Through The Use Of Children's Literature,0001-LEC Main Sess,Staff,30,18,12,0,0
7998,Kendall Campus,EEC 2224 - 0002   Emergent Literacy Through The Use Of Children's Literature,0002-LEC Main Sess,Staff,30,28,2,0,0
8001,Homestead Campus,EEC 2224 - 0003   Emergent Literacy Through The Use Of Children's Literature,0003-LEC Main Sess,Staff,30,0,30,0,0
8000,Homestead Campus,EEC 2224 - 0004   Emergent Literacy Through The Use Of Children's Literature,0004-LEC Main Sess,Staff,25,0,25,0,0
7999,InterAmerican Campus,EEC 2224 - 0005   Emergent Literacy Through The Use Of Children's Literature,0005-LEC Main Sess,Staff,30,17,13,0,0
8002,Wolfson Campus,MVJ 2224 - 0001   Electric Bass Secondary Instrument Second Year,0001-LEC Main Sess,Staff,1,0,1,0,0
8055,Wolfson Campus,MVS 2224 - 0001   Bass Secondary Instrument Second Year,0001-LEC Main Sess,Staff,1,0,1,0,0
10480,Kendall Campus,MVW 2224 - 0001   Bassoon Secondary Instrument Second Year,0001-LEC Main Sess,Staff,30,0,30,0,0
11372,Wolfson Campus,HFT 2223 - 0001   Training Skills And Development,0001-LEC Main Sess,Staff,30,0,30,0,0
16429,Wolfson Campus,MVW 2223 - 0001   Clarinet Secondary Instrument Second Year,0001-LEC Main Sess,Staff,1,0,1,0,0
10907,Kendall Campus,PLA 2223 - 0001   Trial Practice & Appeals,0001-LEC Main Sess,Staff,25,8,17,0,0
10909,Wolfson Campus,PLA 2223 - 0002   Trial Practice & Appeals,0002-LEC Main Sess,Staff,30,13,17,0,0
10421,Medical Campus,HIM 2222 - 0001   Icd Coding Systems,0001-LEC Conversion,Staff,5,0,5,0,0
14916,North Campus,PGY 2222 - 0001   Fashion Photography,0001-LEC Twelve Wk,Staff,15,4,11,0,0
16260,Medical Campus,HIM 2222L - 0001   Icd Coding Systems Laboratory,0001-LAB Conversion,Staff,3,0,3,0,0
5432,Kendall Campus,CHI 2221 - 0001   Intermediate Mandarin Chinese 2,0001-LEC Main Sess,Staff,1,0,1,0,0
5431,Wolfson Campus,CHI 2221 - 0002   Intermediate Mandarin Chinese 2,0002-LEC Main Sess,Staff,20,6,14,0,0
6628,InterAmerican Campus,EEC 2221 - 0001   Curriculum High/Scope Approach,0001-LEC Main Sess,Staff,30,25,5,0,0
15260,Kendall Campus,FRE 2221 - 0001   Intermediate French 2,0001-LEC Main Sess,Staff,20,10,10,0,0
12978,Wolfson Campus,MVK 2221 - 0003   Piano Secondary Instrument Second Year,0003-LEC Main Sess,Staff,5,0,5,0,0
12977,Wolfson Campus,MVK 2221 - 0004   Piano Secondary Instrument Second Year,0004-LEC Main Sess,Staff,1,0,1,0,0
9056,Wolfson Campus,MVP 2221 - 0001   Percussion Secondary Instrument Second Year,0001-LEC Main Sess,Staff,5,1,4,0,0
12305,Wolfson Campus,MVV 2221 - 0002   Voice Secondary Instruments Second Year,0002-LEC Main Sess,Staff,25,5,20,0,0
12304,Wolfson Campus,MVV 2221 - 0003   Voice Secondary Instruments Second Year,0003-LEC Main Sess,Staff,1,0,1,0,0
13948,Wolfson Campus,MVW 2221 - 0001   Flute Secondary Instrument Second Year,0001-LEC Main Sess,Staff,1,0,1,0,0
11989,Wolfson Campus,POR 2221 - 0001   Intermediate Portuguese 2,0001-LEC Conversion,Staff,25,5,20,0,0
11106,Kendall Campus,SPN 2221 - 0001   Intermediate Spanish 2,0001-LEC 1st Mon Sp,Staff,25,0,25,0,0
11104,Kendall Campus,SPN 2221 - 0002   Intermediate Spanish 2,0002-LEC Main Sess,Staff,20,9,11,0,0
11105,Wolfson Campus,SPN 2221 - 0003   Intermediate Spanish 2,0003-LEC Main Sess,Staff,30,0,30,0,0
5754,Kendall Campus,CHI 2220 - 0001   Intermediate Mandarin Chinese 1,0001-LEC Main Sess,Staff,10,2,8,0,0
5753,Wolfson Campus,CHI 2220 - 0002   Intermediate Mandarin Chinese 1,0002-LEC Main Sess,Staff,20,7,13,0,0
12752,Kendall Campus,IND 2220 - 0001   Interior Design 4,0001-LEC Main Sess,Staff,15,5,10,0,0
12751,Wolfson Campus,IND 2220 - 0002   Interior Design 4,0002-LEC Main Sess,Staff,15,12,3,0,0
14657,Kendall Campus,ITA 2220 - 0001   Intermediate Italian 1,0001-LEC Main Sess,Staff,20,7,13,0,0
13931,Wolfson Campus,MVJ 2220 - 0001   Jazz Piano Secondary Instrument Second Year,0001-LEC Main Sess,Staff,1,0,1,0,0
12401,Wolfson Campus,POR 2220 - 0001   Intermediate Portuguese 1,0001-LEC Conversion,Staff,3,0,3,0,0
12400,Wolfson Campus,POR 2220 - 0002   Intermediate Portuguese 1,0002-LEC Conversion,Staff,30,0,30,0,0
16924,Kendall Campus,SPN 2220 - 0001   Intermediate Spanish 1,0001-LEC Main Sess,Staff,20,14,6,0,0
16927,Kendall Campus,SPN 2220 - 0002   Intermediate Spanish 1,0002-LEC Main Sess,Staff,20,11,9,0,0
16926,Kendall Campus,SPN 2220 - 0003   Intermediate Spanish 1,0003-LEC Main Sess,Staff,2,0,2,0,0
16925,Wolfson Campus,SPN 2220 - 0004   Intermediate Spanish 1,0004-LEC Main Sess,Staff,20,0,20,0,0
16779,Medical Campus,NUR 2212 - 0002   Advanced Medical-Surgical Nursing,0002-LEC Conversion,Staff,30,21,9,0,0
16780,Medical Campus,NUR 2212 - 0003   Advanced Medical-Surgical Nursing,0003-LEC Conversion,Staff,47,41,6,0,0
16782,Medical Campus,NUR 2212 - 0004   Advanced Medical-Surgical Nursing,0004-LEC Conversion,Staff,11,0,11,0,0
16783,Homestead Campus,NUR 2212 - 0006   Advanced Medical-Surgical Nursing,0006-LEC Conversion,Staff,40,35,5,0,0
13030,Medical Campus,NUR 2212L - 0003   Advanced Medical-Surgical Nursing Clinical,0003-CLN Conversion,Staff,8,6,2,0,0
13036,Medical Campus,NUR 2212L - 0005   Advanced Medical-Surgical Nursing Clinical,0005-CLN Conversion,Staff,8,0,8,0,0
13024,Medical Campus,NUR 2212L - 0006   Advanced Medical-Surgical Nursing Clinical,0006-CLN Conversion,Staff,10,6,4,0,0
13025,Medical Campus,NUR 2212L - 0007   Advanced Medical-Surgical Nursing Clinical,0007-CLN Conversion,Staff,8,7,1,0,0
13016,Medical Campus,NUR 2212L - 0016   Advanced Medical-Surgical Nursing Clinical,0016-CLN Conversion,Staff,8,0,8,0,0
13017,Homestead Campus,NUR 2212L - 0019   Advanced Medical-Surgical Nursing Clinical,0019-CLN Conversion,Staff,8,0,8,0,0
13018,Homestead Campus,NUR 2212L - 0020   Advanced Medical-Surgical Nursing Clinical,0020-CLN Conversion,Staff,8,0,8,0,0
13021,Homestead Campus,NUR 2212L - 0023   Advanced Medical-Surgical Nursing Clinical,0023-CLN Conversion,Staff,6,4,2,0,0
7192,Wolfson Campus,BAN 2211 - 0001   Applied Financial Statement Analysis,0001-LEC Conversion,Staff,20,6,14,0,0
13837,North Campus,CHM 2211 - 0001   Organic Chemistry 2,0001-LEC Main Sess,Staff,40,30,10,0,0
13838,North Campus,CHM 2211 - 0002   Organic Chemistry 2,0002-LEC Main Sess,Staff,40,0,40,0,0
13839,Kendall Campus,CHM 2211 - 0003   Organic Chemistry 2,0003-LEC Main Sess,Staff,110,43,67,0,0
13844,Wolfson Campus,CHM 2211 - 0004   Organic Chemistry 2,0004-LEC Main Sess,Staff,45,0,45,0,0
13841,Wolfson Campus,CHM 2211 - 0005   Organic Chemistry 2,0005-LEC Main Sess,Staff,30,23,7,0,0
13842,Homestead Campus,CHM 2211 - 0006   Organic Chemistry 2,0006-LEC Main Sess,Staff,24,14,10,0,0
13843,InterAmerican Campus,CHM 2211 - 0007   Organic Chemistry 2,0007-LEC Main Sess,Staff,32,30,2,0,0
13840,InterAmerican Campus,CHM 2211 - 0008   Organic Chemistry 2,0008-LEC Main Sess,Staff,37,12,25,0,0
12374,North Campus,PGY 2211 - 0001   Portrait And Still Photography,0001-LEC Main Sess,Staff,20,6,14,0,0
8368,North Campus,CHM 2211L - 0001   Organic Chemistry 2 Laboratory,0001-LAB Main Sess,Staff,16,8,8,0,0
8369,North Campus,CHM 2211L - 0002   Organic Chemistry 2 Laboratory,0002-LAB Main Sess,Staff,16,12,4,0,0
8370,North Campus,CHM 2211L - 0003   Organic Chemistry 2 Laboratory,0003-LAB Main Sess,Staff,16,12,4,0,0
8377,North Campus,CHM 2211L - 0004   Organic Chemistry 2 Laboratory,0004-LAB Main Sess,Staff,16,14,2,0,0
8371,North Campus,CHM 2211L - 0005   Organic Chemistry 2 Laboratory,0005-LAB Main Sess,Staff,16,0,16,0,0
8372,Kendall Campus,CHM 2211L - 0006   Organic Chemistry 2 Laboratory,0006-LAB Main Sess,Staff,14,10,4,0,0
8373,Kendall Campus,CHM 2211L - 0007   Organic Chemistry 2 Laboratory,0007-LAB Main Sess,Staff,14,12,2,0,0
8375,Wolfson Campus,CHM 2211L - 0009   Organic Chemistry 2 Laboratory,0009-LAB Main Sess,Staff,20,19,1,0,0
8378,Homestead Campus,CHM 2211L - 0010   Organic Chemistry 2 Laboratory,0010-LAB Main Sess,Staff,24,14,10,0,0
8376,InterAmerican Campus,CHM 2211L - 0011   Organic Chemistry 2 Laboratory,0011-LAB Main Sess,Staff,12,8,4,0,0
7655,Homestead Campus,ATF 2210 - 0001   Commercial Pilot Flight,0001-LEC Main Sess,Staff,30,6,24,0,0
7656,Homestead Campus,ATF 2210 - 0002   Commercial Pilot Flight,0002-LEC Conversion,Staff,30,0,30,0,0
6999,Wolfson Campus,BAN 2210 - 0001   Analyzing Financial Statements,0001-LEC Conversion,Staff,30,11,19,0,0
8033,North Campus,CHM 2210 - 0002   Organic Chemistry 1,0002-LEC Main Sess,Staff,40,27,13,0,0
8034,North Campus,CHM 2210 - 0003   Organic Chemistry 1,0003-LEC Main Sess,Staff,40,0,40,0,0
8039,Kendall Campus,CHM 2210 - 0004   Organic Chemistry 1,0004-LEC Main Sess,Staff,110,58,52,0,0
8036,Wolfson Campus,CHM 2210 - 0005   Organic Chemistry 1,0005-LEC Main Sess,Staff,45,41,4,0,0
8038,InterAmerican Campus,CHM 2210 - 0007   Organic Chemistry 1,0007-LEC Main Sess,Staff,37,34,3,0,0
8035,InterAmerican Campus,CHM 2210 - 0008   Organic Chemistry 1,0008-LEC Main Sess,Staff,40,0,40,0,0
6656,North Campus,CHM 2210L - 0001   Organic Chemistry 1 Laboratory,0001-LAB 1st Mon Sp,Staff,16,9,7,0,0
6643,North Campus,CHM 2210L - 0004   Organic Chemistry 1 Laboratory,0004-LAB Main Sess,Staff,16,12,4,0,0
6655,North Campus,CHM 2210L - 0005   Organic Chemistry 1 Laboratory,0005-LAB 1st Mon Sp,Staff,16,0,16,0,0
6657,North Campus,CHM 2210L - 0007   Organic Chemistry 1 Laboratory,0007-LAB 1st Mon Sp,Staff,16,15,1,0,0
6648,Kendall Campus,CHM 2210L - 0009   Organic Chemistry 1 Laboratory,0009-LAB Main Sess,Staff,14,13,1,0,0
6650,Wolfson Campus,CHM 2210L - 0011   Organic Chemistry 1 Laboratory,0011-LAB Main Sess,Staff,20,18,2,0,0
6651,Wolfson Campus,CHM 2210L - 0012   Organic Chemistry 1 Laboratory,0012-LAB Main Sess,Staff,20,19,1,0,0
6652,Wolfson Campus,CHM 2210L - 0013   Organic Chemistry 1 Laboratory,0013-LAB Main Sess,Staff,20,11,9,0,0
6653,InterAmerican Campus,CHM 2210L - 0014   Organic Chemistry 1 Laboratory,0014-LAB Main Sess,Staff,12,11,1,0,0
6654,InterAmerican Campus,CHM 2210L - 0015   Organic Chemistry 1 Laboratory,0015-LAB Main Sess,Staff,12,11,1,0,0
6646,InterAmerican Campus,CHM 2210L - 0016   Organic Chemistry 1 Laboratory,0016-LAB Main Sess,Staff,12,7,5,0,0
6658,InterAmerican Campus,CHM 2210L - 0017   Organic Chemistry 1 Laboratory,0017-LAB Weekend,Staff,12,11,1,0,0
6723,Wolfson Campus,DAA 2207 - 0001   Advanced Ballet,0001-LEC Main Sess,Staff,35,13,22,0,0
6724,Wolfson Campus,DAA 2207 - 0002   Advanced Ballet,0002-LEC Conversion,Staff,30,27,3,0,0
8679,Wolfson Campus,DAA 2206 - 0001   Ballet 2,0001-LEC Main Sess,Staff,10,7,3,0,0
8362,Wolfson Campus,FSS 2205L - 0001   Food Production 3,0001-LAB Twelve Wk,Staff,16,13,3,0,0
13906,Wolfson Campus,DAA 2203 - 0001   Advanced Ballet Dance,0001-LEC Main Sess,Staff,10,3,7,0,0
11364,North Campus,FSE 2203 - 0001   Funeral Home Application,0001-LEC Main Sess,Staff,24,17,7,0,0
9782,Kendall Campus,PLA 2203 - 0001   Trial Preparation,0001-LEC Main Sess,Staff,30,11,19,0,0
9784,Kendall Campus,PLA 2203 - 0002   Trial Preparation,0002-LEC Eight Wk 2,Staff,28,16,12,0,0
9785,Wolfson Campus,PLA 2203 - 0003   Trial Preparation,0003-LEC Eight Wk 2,Staff,20,0,20,0,0
9783,Wolfson Campus,PLA 2203 - 0004   Trial Preparation,0004-LEC Main Sess,Staff,25,0,25,0,0
9786,Wolfson Campus,PLA 2203 - 0005   Trial Preparation,0005-LEC 1st Mon Sp,Staff,25,16,9,0,0
7464,Medical Campus,DEH 2202 - 0001   Nutrition and Dental Health,0001-LEC Conversion,Staff,48,0,48,0,0
7463,Medical Campus,DEH 2202 - 0002   Nutrition and Dental Health,0002-LEC Conversion,Staff,50,43,7,0,0
7983,North Campus,EEC 2202 - 0001   Program Development In Early Childhood Education,0001-LEC Twelve Wk,Staff,30,8,22,0,0
7984,North Campus,EEC 2202 - 0002   Program Development In Early Childhood Education,0002-LEC Weekend,Staff,30,0,30,0,0
7981,North Campus,EEC 2202 - 0003   Program Development In Early Childhood Education,0003-LEC Main Sess,Staff,30,0,30,0,0
7982,Kendall Campus,EEC 2202 - 0004   Program Development In Early Childhood Education,0004-LEC Main Sess,Staff,30,25,5,0,0
7584,North Campus,ARC 2201 - 0001   Theory Of Architecture,0001-LEC Main Sess,Staff,24,14,10,0,0
7583,Kendall Campus,ARC 2201 - 0002   Theory Of Architecture,0002-LEC Main Sess,Staff,35,16,19,0,0
7585,Wolfson Campus,ARC 2201 - 0003   Theory Of Architecture,0003-LEC Main Sess,Staff,35,0,35,0,0
7925,North Campus,EEC 2201 - 0001   Developing Curriculum For Infants And Toddlers,0001-LEC Twelve Wk,Staff,30,8,22,0,0
7924,Kendall Campus,EEC 2201 - 0002   Developing Curriculum For Infants And Toddlers,0002-LEC Twelve Wk,Staff,30,6,24,0,0
8297,Wolfson Campus,ENT 2201 - 0001   Introduction To Lean Start-Up,0001-LEC Twelve Wk,Staff,30,0,30,0,0
8346,North Campus,CHM 2200 - 0001   Survey Of Organic Chemistry,0001-LEC Main Sess,Staff,32,19,13,0,0
14565,North Campus,FSE 2200 - 0001   Funeral Service Accounting,0001-LEC Main Sess,Staff,30,0,30,0,0
14564,North Campus,FSE 2200 - 0002   Funeral Service Accounting,0002-LEC Main Sess,Staff,30,12,18,0,0
7766,North Campus,JOU 2200 - 0001   Editing And Makeup,0001-LEC Main Sess,Staff,25,0,25,0,0
7768,North Campus,JOU 2200 - 0002   Editing And Makeup,0002-LEC Conversion,Staff,25,11,14,0,0
7767,Kendall Campus,JOU 2200 - 0003   Editing And Makeup,0003-LEC Main Sess,Staff,25,10,15,0,0
11392,Kendall Campus,LIN 2200 - 0001   Phonetics,0001-LEC Main Sess,Staff,2,0,2,0,0
7245,North Campus,CHM 2200L - 0002   Survey Of Organic Chemistry Laboratory,0002-LAB Main Sess,Staff,16,0,16,0,0
9692,Kendall Campus,TPP 2191 - 0001   Mainstage Production - Cast,0001-LAB Main Sess,Staff,10,1,9,0,0
5710,North Campus,ARC 2172 - 0001   Computer Aided Drafting 2,0001-LEC Main Sess,Staff,22,21,1,0,0
5713,Kendall Campus,ARC 2172 - 0002   Computer Aided Drafting 2,0002-LEC Main Sess,Staff,23,19,4,0,0
5712,Wolfson Campus,ARC 2172 - 0003   Computer Aided Drafting 2,0003-LEC Main Sess,Staff,22,15,7,0,0
5711,Wolfson Campus,ARC 2172 - 0004   Computer Aided Drafting 2,0004-LEC Main Sess,Staff,24,20,4,0,0
7160,North Campus,ARC 2171 - 0001   Computer Aided Drafting 1,0001-LEC Main Sess,Staff,22,15,7,0,0
7161,Kendall Campus,ARC 2171 - 0002   Computer Aided Drafting 1,0002-LEC Main Sess,Staff,23,19,4,0,0
7162,Kendall Campus,ARC 2171 - 0003   Computer Aided Drafting 1,0003-LEC Main Sess,Staff,23,22,1,0,0
7166,Kendall Campus,ARC 2171 - 0004   Computer Aided Drafting 1,0004-LEC Weekend,Staff,23,8,15,0,0
7164,Wolfson Campus,ARC 2171 - 0006   Computer Aided Drafting 1,0006-LEC Main Sess,Staff,22,11,11,0,0
7165,Wolfson Campus,ARC 2171 - 0007   Computer Aided Drafting 1,0007-LEC Conversion,Staff,6,0,6,0,0
12585,Wolfson Campus,TPP 2163 - 0001   Voice & Movement 2 Continuation,0001-LEC Main Sess,Staff,25,9,16,0,0
15262,North Campus,FSE 2160 - 0001   Pathology,0001-LEC Main Sess,Staff,30,17,13,0,0
16941,Homestead Campus,TRA 2156 - 0001   Operations Management For Transportation,0001-LEC Eight Wk 1,Staff,30,5,25,0,0
13890,Kendall Campus,CTS 2153 - 0001   Supporting Windows Users & Applications,0001-LEC Main Sess,Staff,22,16,6,0,0
13891,Wolfson Campus,CTS 2153 - 0002   Supporting Windows Users & Applications,0002-LEC Conversion,Staff,16,15,1,0,0
12647,Wolfson Campus,TPP 2152 - 0001   Scene Study 3,0001-LEC Main Sess,Staff,25,9,16,0,0
7783,Wolfson Campus,MAR 2150 - 0001   International Marketing,0001-LEC Main Sess,Staff,30,12,18,0,0
7674,Kendall Campus,CLP 2140 - 0001   Abnormal Psychology,0001-LEC Twelve Wk,Staff,28,27,1,0,0
7664,Kendall Campus,CLP 2140 - 0002   Abnormal Psychology,0002-LEC Main Sess,Staff,30,17,13,0,0
7665,Kendall Campus,CLP 2140 - 0003   Abnormal Psychology,0003-LEC Main Sess,Staff,45,42,3,0,0
7666,Kendall Campus,CLP 2140 - 0004   Abnormal Psychology,0004-LEC Main Sess,Staff,42,38,4,0,0
7675,Wolfson Campus,CLP 2140 - 0005   Abnormal Psychology,0005-LEC Conversion,Staff,15,13,2,0,0
7667,Wolfson Campus,CLP 2140 - 0006   Abnormal Psychology,0006-LEC Main Sess,Staff,45,40,5,0,0
7668,Wolfson Campus,CLP 2140 - 0007   Abnormal Psychology,0007-LEC Main Sess,Staff,47,0,47,0,0
7669,Wolfson Campus,CLP 2140 - 0008   Abnormal Psychology,0008-LEC Main Sess,Staff,30,26,4,0,0
7671,Wolfson Campus,CLP 2140 - 0009   Abnormal Psychology,0009-LEC Main Sess,Staff,30,24,6,0,0
7672,Wolfson Campus,CLP 2140 - 0010   Abnormal Psychology,0010-LEC Main Sess,Staff,30,26,4,0,0
7673,InterAmerican Campus,CLP 2140 - 0011   Abnormal Psychology,0011-LEC Main Sess,Staff,40,18,22,0,0
7670,West Campus,CLP 2140 - 0012   Abnormal Psychology,0012-LEC Main Sess,Staff,35,17,18,0,0
11149,North Campus,FSE 2140 - 0001   Embalming 2,0001-LEC Main Sess,Staff,30,22,8,0,0
15264,North Campus,FSE 2140L - 0001   Embalming 2 Laboratory,0001-LAB Main Sess,Staff,10,0,10,0,0
6889,Homestead Campus,ATT 2133 - 0001   Multi-Engine Pilot Theory,0001-LEC Main Sess,Staff,30,14,16,0,0
5566,Kendall Campus,AFR 2131 - 0001   Introduction To The United States Air Force - Part 2,0001-LEC Main Sess,Staff,30,2,28,0,0
6075,Homestead Campus,ATT 2131 - 0001   Flight Instructor Theory,0001-LEC Main Sess,Staff,30,14,16,0,0
7993,North Campus,BUL 2131 - 0001   Legal Environment,0001-LEC Main Sess,Staff,30,13,17,0,0
6041,Wolfson Campus,DAN 2131 - 0001   Dance History 2,0001-LEC Main Sess,Staff,35,13,22,0,0
6355,North Campus,FIL 2131 - 0001   Screenwriting 2: Character Development & Advanced Story Structure,0001-LEC Main Sess,Staff,25,24,1,0,0
6357,North Campus,FIL 2131 - 0002   Screenwriting 2: Character Development & Advanced Story Structure,0002-LEC 1st Mon Sp,Staff,25,24,1,0,0
6356,Kendall Campus,FIL 2131 - 0003   Screenwriting 2: Character Development & Advanced Story Structure,0003-LEC Main Sess,Staff,20,11,9,0,0
7787,North Campus,DAN 2130 - 0001   Dance History 1,0001-LEC Main Sess,Staff,30,0,30,0,0
7790,North Campus,DAN 2130 - 0002   Dance History 1,0002-LEC Twelve Wk,Staff,30,10,20,0,0
7788,Kendall Campus,DAN 2130 - 0003   Dance History 1,0003-LEC Main Sess,Staff,40,28,12,0,0
7789,Wolfson Campus,DAN 2130 - 0004   Dance History 1,0004-LEC Main Sess,Staff,45,0,45,0,0
12999,Medical Campus,NMT 2130 - 0001   Nuclear Medicine Pharmacology,0001-LEC Conversion,Staff,20,0,20,0,0
12998,Medical Campus,NMT 2130 - 0002   Nuclear Medicine Pharmacology,0002-LEC Main Sess,Staff,20,10,10,0,0
9053,North Campus,MVK 2122 - 0001   Class Piano 4,0001-LAB Eight Wk 2,Staff,20,1,19,0,0
9052,Wolfson Campus,MVK 2122 - 0002   Class Piano 4,0002-LAB Main Sess,Staff,25,9,16,0,0
16409,North Campus,MVK 2121 - 0001   Class Piano 3,0001-LAB Eight Wk 1,Staff,20,2,18,0,0
16408,North Campus,MVK 2121 - 0002   Class Piano 3,0002-LAB Eight Wk 1,Staff,20,0,20,0,0
16407,Kendall Campus,MVK 2121 - 0003   Class Piano 3,0003-LAB Main Sess,Staff,15,0,15,0,0
6065,Homestead Campus,ATT 2120 - 0001   Instruments Pilot Theory,0001-LEC Main Sess,Staff,30,16,14,0,0
6079,Homestead Campus,AVM 2120 - 0001   Air Cargo,0001-LEC Eight Wk 2,Staff,30,0,30,0,0
6080,Homestead Campus,AVM 2120 - 0002   Air Cargo,0002-LEC Conversion,Staff,30,1,29,0,0
6078,Homestead Campus,AVM 2120 - 0003   Air Cargo,0003-LEC Main Sess,Staff,30,0,30,0,0
16222,North Campus,FFP 2120 - 0001   Building Construction For Fire Science,0001-LEC Conversion,Staff,24,18,6,0,0
14563,North Campus,FSE 2120 - 0001   Restorative Art,0001-LEC Main Sess,Staff,30,14,16,0,0
16264,North Campus,LIT 2120 - 0001   A Survey Of World Literature 2,0001-LEC Main Sess,Staff,28,20,8,0,0
16265,Kendall Campus,LIT 2120 - 0002   A Survey Of World Literature 2,0002-LEC Main Sess,Staff,25,0,25,0,0
16266,Kendall Campus,LIT 2120 - 0003   A Survey Of World Literature 2,0003-LEC Main Sess,Staff,28,14,14,0,0
16271,Kendall Campus,LIT 2120 - 0004   A Survey Of World Literature 2,0004-LEC Main Sess,Staff,28,18,10,0,0
16268,Kendall Campus,LIT 2120 - 0005   A Survey Of World Literature 2,0005-LEC Main Sess,Staff,28,10,18,0,0
16270,Wolfson Campus,LIT 2120 - 0007   A Survey Of World Literature 2,0007-LEC Main Sess,Staff,30,17,13,0,0
16267,Wolfson Campus,LIT 2120 - 0008   A Survey Of World Literature 2,0008-LEC Main Sess,Staff,30,21,9,0,0
16352,North Campus,MNA 2120 - 0001   Human Relations In Business,0001-LEC Main Sess,Staff,30,14,16,0,0
16355,North Campus,MNA 2120 - 0002   Human Relations In Business,0002-LEC Eight Wk 2,Staff,45,31,14,0,0
16354,North Campus,MNA 2120 - 0003   Human Relations In Business,0003-LEC Eight Wk 1,Staff,30,22,8,0,0
16353,Wolfson Campus,MNA 2120 - 0004   Human Relations In Business,0004-LEC Twelve Wk,Staff,30,28,2,0,0
12138,North Campus,FSE 2120L - 0001   Restorative Arts Lab,0001-LAB 1st Mon Sp,Staff,24,15,9,0,0
13908,Kendall Campus,MUT 2117 - 0002   Theory 4,0002-LEC Main Sess,Staff,16,14,2,0,0
13909,Wolfson Campus,MUT 2117 - 0005   Theory 4,0005-LEC Main Sess,Staff,25,13,12,0,0
14866,North Campus,MUT 2116 - 0001   Theory 3,0001-LEC Main Sess,Staff,12,7,5,0,0
15579,Kendall Campus,PLA 2114 - 0001   Legal Writing,0001-LEC Main Sess,Staff,25,0,25,0,0
15582,Kendall Campus,PLA 2114 - 0002   Legal Writing,0002-LEC Conversion,Staff,30,16,14,0,0
15581,Wolfson Campus,PLA 2114 - 0003   Legal Writing,0003-LEC Eight Wk 1,Staff,20,0,20,0,0
15583,Wolfson Campus,PLA 2114 - 0004   Legal Writing,0004-LEC 1st Mon Sp,Staff,25,5,20,0,0
15580,Wolfson Campus,PLA 2114 - 0005   Legal Writing,0005-LEC Main Sess,Staff,25,0,25,0,0
8541,Wolfson Campus,DIG 2113 - 0001   Post Production & Editing,0001-LEC Main Sess,Staff,24,18,6,0,0
8540,Wolfson Campus,DIG 2113 - 0002   Post Production & Editing,0002-LEC Main Sess,Staff,15,0,15,0,0
6375,North Campus,GEB 2112 - 0001   Introduction To Entrepreneurship,0001-LEC Conversion,Staff,30,0,30,0,0
6373,North Campus,GEB 2112 - 0002   Introduction To Entrepreneurship,0002-LEC Eight Wk 1,Staff,30,0,30,0,0
6364,North Campus,GEB 2112 - 0003   Introduction To Entrepreneurship,0003-LEC Main Sess,Staff,30,18,12,0,0
6368,North Campus,GEB 2112 - 0004   Introduction To Entrepreneurship,0004-LEC Twelve Wk,Staff,30,0,30,0,0
6374,North Campus,GEB 2112 - 0005   Introduction To Entrepreneurship,0005-LEC Conversion,Staff,30,0,30,0,0
6370,North Campus,GEB 2112 - 0006   Introduction To Entrepreneurship,0006-LEC Twelve Wk,Staff,30,0,30,0,0
6365,Kendall Campus,GEB 2112 - 0007   Introduction To Entrepreneurship,0007-LEC Main Sess,Staff,25,11,14,0,0
6369,Wolfson Campus,GEB 2112 - 0008   Introduction To Entrepreneurship,0008-LEC Twelve Wk,Staff,35,19,16,0,0
6366,Wolfson Campus,GEB 2112 - 0009   Introduction To Entrepreneurship,0009-LEC Main Sess,Staff,30,25,5,0,0
6367,InterAmerican Campus,GEB 2112 - 0010   Introduction To Entrepreneurship,0010-LEC Main Sess,Staff,30,8,22,0,0
6371,Hialeah Campus,GEB 2112 - 0011   Introduction To Entrepreneurship,0011-LEC Eight Wk 1,Staff,15,0,15,0,0
6372,Hialeah Campus,GEB 2112 - 0012   Introduction To Entrepreneurship,0012-LEC Eight Wk 1,Staff,30,0,30,0,0
6376,West Campus,GEB 2112 - 0013   Introduction To Entrepreneurship,0013-LEC 1st Mon Sp,Staff,30,0,30,0,0
14656,Kendall Campus,IPM 2112 - 0001   Principles Of Entomology,0001-LEC Main Sess,Staff,24,0,24,0,0
13860,Kendall Campus,MUH 2112 - 0002   Survey Of Music History 2,0002-LEC Main Sess,Staff,30,18,12,0,0
13859,Kendall Campus,MUH 2112 - 0003   Survey Of Music History 2,0003-LEC Main Sess,Staff,40,13,27,0,0
13858,Wolfson Campus,MUH 2112 - 0004   Survey Of Music History 2,0004-LEC Main Sess,Staff,30,21,9,0,0
8994,Wolfson Campus,POS 2112 - 0001   State And Local Government In America,0001-LEC Main Sess,Staff,47,14,33,0,0
8993,Wolfson Campus,POS 2112 - 0002   State And Local Government In America,0002-LEC Main Sess,Staff,34,16,18,0,0
9691,Wolfson Campus,TPP 2112 - 0001   Acting 2,0001-LEC Main Sess,Staff,25,14,11,0,0
16935,North Campus,TPP 2111 - 0001   Acting 2,0001-LEC Main Sess,Staff,12,5,7,0,0
16938,Kendall Campus,TPP 2111 - 0002   Acting 2,0002-LEC Main Sess,Staff,15,10,5,0,0
5389,Homestead Campus,ATT 2110 - 0001   Commercial Pilot Theory 3,0001-LEC Main Sess,Staff,30,9,21,0,0
5952,North Campus,CGS 2108 - 0001   Advanced Desktop Applications,0001-LEC Main Sess,Staff,16,12,4,0,0
5955,Homestead Campus,CGS 2108 - 0003   Advanced Desktop Applications,0003-LEC Eight Wk 1,Staff,30,0,30,0,0
5956,Homestead Campus,CGS 2108 - 0004   Advanced Desktop Applications,0004-LEC Eight Wk 2,Staff,30,0,30,0,0
5957,Homestead Campus,CGS 2108 - 0005   Advanced Desktop Applications,0005-LEC Eight Wk 2,Staff,30,0,30,0,0
5954,InterAmerican Campus,CGS 2108 - 0006   Advanced Desktop Applications,0006-LEC Main Sess,Staff,21,18,3,0,0
8678,Wolfson Campus,DAA 2107 - 0001   Advanced Modern 2,0001-LEC Main Sess,Staff,35,13,22,0,0
13905,Wolfson Campus,DAA 2106 - 0001   Modern 2,0001-LEC Main Sess,Staff,10,0,10,0,0
9627,North Campus,MAD 2104 - 0001   Discrete Mathematics,0001-LEC Main Sess,Staff,30,13,17,0,0
9628,Wolfson Campus,MAD 2104 - 0003   Discrete Mathematics,0003-LEC Main Sess,Staff,38,31,7,0,0
13098,Kendall Campus,PLA 2104 - 0001   Legal Research,0001-LEC Main Sess,Staff,25,15,10,0,0
13099,Wolfson Campus,PLA 2104 - 0002   Legal Research,0002-LEC Main Sess,Staff,25,23,2,0,0
13102,Wolfson Campus,PLA 2104 - 0003   Legal Research,0003-LEC Main Sess,Staff,25,0,25,0,0
13101,Wolfson Campus,PLA 2104 - 0004   Legal Research,0004-LEC Main Sess,Staff,25,17,8,0,0
13100,Wolfson Campus,PLA 2104 - 0005   Legal Research,0005-LEC Main Sess,Staff,25,0,25,0,0
14679,North Campus,MAS 2103 - 0001   Elementary Linear Algebra,0001-LEC Main Sess,Staff,30,11,19,0,0
14682,Kendall Campus,MAS 2103 - 0002   Elementary Linear Algebra,0002-LEC Main Sess,Staff,39,0,39,0,0
14681,Wolfson Campus,MAS 2103 - 0003   Elementary Linear Algebra,0003-LEC Main Sess,Staff,25,0,25,0,0
14680,Wolfson Campus,MAS 2103 - 0004   Elementary Linear Algebra,0004-LEC Main Sess,Staff,35,13,22,0,0
13846,North Campus,MSL 2102 - 0001   Second Year Basic Army ROTC,0001-LEC Main Sess,Staff,30,2,28,0,0
13845,Kendall Campus,MSL 2102 - 0002   Second Year Basic Army ROTC,0002-LEC Main Sess,Staff,20,8,12,0,0
12957,Wolfson Campus,MUC 2102 - 0001   Composition Skills 4,0001-LEC Main Sess,Staff,15,1,14,0,0
12956,Wolfson Campus,MUC 2102 - 0002   Composition Skills 4,0002-LEC Main Sess,Staff,5,0,5,0,0
8527,North Campus,CPO 2100 - 0001   Comparative European Government,0001-LEC Main Sess,Staff,40,0,40,0,0
8526,Kendall Campus,CPO 2100 - 0002   Comparative European Government,0002-LEC Main Sess,Staff,40,31,9,0,0
10765,North Campus,DAN 2100 - 0001   Dance Appreciation,0001-LEC Main Sess,Staff,30,14,16,0,0
10766,North Campus,DAN 2100 - 0002   Dance Appreciation,0002-LEC Main Sess,Staff,30,13,17,0,0
10767,Kendall Campus,DAN 2100 - 0003   Dance Appreciation,0003-LEC Main Sess,Staff,40,10,30,0,0
10768,Kendall Campus,DAN 2100 - 0004   Dance Appreciation,0004-LEC Main Sess,Staff,30,0,30,0,0
10771,Wolfson Campus,DAN 2100 - 0005   Dance Appreciation,0005-LEC Conversion,Staff,30,27,3,0,0
10769,West Campus,DAN 2100 - 0006   Dance Appreciation,0006-LEC Main Sess,Staff,30,0,30,0,0
10770,West Campus,DAN 2100 - 0007   Dance Appreciation,0007-LEC Main Sess,Staff,30,0,30,0,0
14190,North Campus,DEP 2100 - 0001   Child Growth And Development,0001-LEC Main Sess,Staff,40,29,11,0,0
14189,Kendall Campus,DEP 2100 - 0002   Child Growth And Development,0002-LEC Main Sess,Staff,45,36,9,0,0
14192,Medical Campus,DES 2100 - 0001   Dental Materials,0001-LEC Main Sess,Staff,50,38,12,0,0
6869,Kendall Campus,FIN 2100 - 0001   Personal Finance,0001-LEC Weekend,Staff,30,0,30,0,0
16247,North Campus,FSE 2100 - 0001   Embalming 1,0001-LEC Main Sess,Staff,30,28,2,0,0
10952,North Campus,QMB 2100 - 0001   Basic Business Statistics,0001-LEC Main Sess,Staff,30,16,14,0,0
10977,North Campus,QMB 2100 - 0002   Basic Business Statistics,0002-LEC Conversion,Staff,40,26,14,0,0
10976,North Campus,QMB 2100 - 0003   Basic Business Statistics,0003-LEC Conversion,Staff,40,0,40,0,0
10973,North Campus,QMB 2100 - 0004   Basic Business Statistics,0004-LEC Twelve Wk,Staff,40,15,25,0,0
10959,Kendall Campus,QMB 2100 - 0006   Basic Business Statistics,0006-LEC Main Sess,Staff,30,0,30,0,0
10960,Kendall Campus,QMB 2100 - 0007   Basic Business Statistics,0007-LEC Main Sess,Staff,30,21,9,0,0
10961,Kendall Campus,QMB 2100 - 0008   Basic Business Statistics,0008-LEC Main Sess,Staff,36,28,8,0,0
10962,Kendall Campus,QMB 2100 - 0009   Basic Business Statistics,0009-LEC Main Sess,Staff,35,19,16,0,0
10963,Kendall Campus,QMB 2100 - 0010   Basic Business Statistics,0010-LEC Main Sess,Staff,35,30,5,0,0
10964,Kendall Campus,QMB 2100 - 0011   Basic Business Statistics,0011-LEC Main Sess,Staff,36,13,23,0,0
10965,Kendall Campus,QMB 2100 - 0012   Basic Business Statistics,0012-LEC Main Sess,Staff,30,20,10,0,0
10966,Kendall Campus,QMB 2100 - 0013   Basic Business Statistics,0013-LEC Main Sess,Staff,30,9,21,0,0
10972,Wolfson Campus,QMB 2100 - 0014   Basic Business Statistics,0014-LEC Twelve Wk,Staff,35,32,3,0,0
10967,Wolfson Campus,QMB 2100 - 0015   Basic Business Statistics,0015-LEC Main Sess,Staff,35,34,1,0,0
10968,Wolfson Campus,QMB 2100 - 0016   Basic Business Statistics,0016-LEC Main Sess,Staff,30,14,16,0,0
10969,Wolfson Campus,QMB 2100 - 0017   Basic Business Statistics,0017-LEC Main Sess,Staff,35,11,24,0,0
10970,Wolfson Campus,QMB 2100 - 0018   Basic Business Statistics,0018-LEC Main Sess,Staff,30,23,7,0,0
10971,Homestead Campus,QMB 2100 - 0019   Basic Business Statistics,0019-LEC Main Sess,Staff,35,0,35,0,0
10958,Homestead Campus,QMB 2100 - 0020   Basic Business Statistics,0020-LEC Main Sess,Staff,25,11,14,0,0
10957,InterAmerican Campus,QMB 2100 - 0021   Basic Business Statistics,0021-LEC Main Sess,Staff,30,20,10,0,0
10956,Hialeah Campus,QMB 2100 - 0022   Basic Business Statistics,0022-LEC Main Sess,Staff,30,13,17,0,0
10974,Hialeah Campus,QMB 2100 - 0023   Basic Business Statistics,0023-LEC Eight Wk 1,Staff,30,16,14,0,0
10975,Hialeah Campus,QMB 2100 - 0024   Basic Business Statistics,0024-LEC Eight Wk 2,Staff,30,0,30,0,0
10955,West Campus,QMB 2100 - 0025   Basic Business Statistics,0025-LEC Main Sess,Staff,30,29,1,0,0
10954,West Campus,QMB 2100 - 0026   Basic Business Statistics,0026-LEC Main Sess,Staff,30,0,30,0,0
8688,Medical Campus,DES 2100L - 0001   Dental Materials Laboratory,0001-LAB Conversion,Staff,1,0,1,0,0
8691,Medical Campus,DES 2100L - 0002   Dental Materials Laboratory,0002-LAB 1st Mon Sp,Staff,15,14,1,0,0
8692,Medical Campus,DES 2100L - 0003   Dental Materials Laboratory,0003-LAB 1st Mon Sp,Staff,15,5,10,0,0
8690,Medical Campus,DES 2100L - 0004   Dental Materials Laboratory,0004-LAB 1st Mon Sp,Staff,15,6,9,0,0
8689,Medical Campus,DES 2100L - 0005   Dental Materials Laboratory,0005-LAB 1st Mon Sp,Staff,15,13,2,0,0
11150,North Campus,FSE 2100L - 0001   Embalming 1 Laboratory,0001-LAB Main Sess,Staff,10,5,5,0,0
11152,North Campus,FSE 2100L - 0003   Embalming 1 Laboratory,0003-LAB Main Sess,Staff,10,5,5,0,0
11151,North Campus,FSE 2100L - 0004   Embalming 1 Laboratory,0004-LAB Main Sess,Staff,10,0,10,0,0
12417,North Campus,QMB 2100L - 0001   Basic Statistics Laboratory,0001-LAB Conversion,Staff,999,0,999,0,0
12404,North Campus,QMB 2100L - 0002   Basic Statistics Laboratory,0002-LAB Main Sess,Staff,999,56,943,0,0
12412,North Campus,QMB 2100L - 0003   Basic Statistics Laboratory,0003-LAB Twelve Wk,Staff,30,15,15,0,0
12416,North Campus,QMB 2100L - 0004   Basic Statistics Laboratory,0004-LAB Conversion,Staff,999,26,973,0,0
12405,Kendall Campus,QMB 2100L - 0005   Basic Statistics Laboratory,0005-LAB Main Sess,Staff,500,140,360,0,0
12406,Wolfson Campus,QMB 2100L - 0006   Basic Statistics Laboratory,0006-LAB Main Sess,Staff,150,59,91,0,0
12413,Wolfson Campus,QMB 2100L - 0007   Basic Statistics Laboratory,0007-LAB Twelve Wk,Staff,150,32,118,0,0
12407,Wolfson Campus,QMB 2100L - 0008   Basic Statistics Laboratory,0008-LAB Main Sess,Staff,30,23,7,0,0
12408,Homestead Campus,QMB 2100L - 0009   Basic Statistics Laboratory,0009-LAB Main Sess,Staff,35,11,24,0,0
12409,InterAmerican Campus,QMB 2100L - 0010   Basic Statistics Laboratory,0010-LAB Main Sess,Staff,30,20,10,0,0
12414,Hialeah Campus,QMB 2100L - 0011   Basic Statistics Laboratory,0011-LAB Eight Wk 1,Staff,120,16,104,0,0
12410,Hialeah Campus,QMB 2100L - 0012   Basic Statistics Laboratory,0012-LAB Main Sess,Staff,120,13,107,0,0
12415,Hialeah Campus,QMB 2100L - 0013   Basic Statistics Laboratory,0013-LAB Eight Wk 2,Staff,120,0,120,0,0
12411,West Campus,QMB 2100L - 0014   Basic Statistics Laboratory,0014-LAB Main Sess,Staff,30,29,1,0,0
7253,Kendall Campus,AMH 2091 - 0001   Afro-American History,0001-LEC Main Sess,Staff,25,0,25,0,0
5929,Wolfson Campus,CGS 2091 - 0001   Professional Ethics And Social Issues In Cs,0001-LEC Main Sess,Staff,30,19,11,0,0
8128,North Campus,BSC 2086 - 0001   Human Anatomy & Physiology 2,0001-LEC Main Sess,Staff,48,39,9,0,0
8129,North Campus,BSC 2086 - 0002   Human Anatomy & Physiology 2,0002-LEC Main Sess,Staff,48,30,18,0,0
8142,North Campus,BSC 2086 - 0004   Human Anatomy & Physiology 2,0004-LEC Main Sess,Staff,40,12,28,0,0
8143,North Campus,BSC 2086 - 0005   Human Anatomy & Physiology 2,0005-LEC Main Sess,Staff,40,37,3,0,0
8181,North Campus,BSC 2086 - 0006   Human Anatomy & Physiology 2,0006-LEC Weekend,Staff,40,0,40,0,0
8144,North Campus,BSC 2086 - 0007   Human Anatomy & Physiology 2,0007-LEC Main Sess,Staff,40,24,16,0,0
8145,North Campus,BSC 2086 - 0008   Human Anatomy & Physiology 2,0008-LEC Main Sess,Staff,40,33,7,0,0
8177,North Campus,BSC 2086 - 0009   Human Anatomy & Physiology 2,0009-LEC Eight Wk 2,Staff,40,39,1,0,0
8180,North Campus,BSC 2086 - 0011   Human Anatomy & Physiology 2,0011-LEC Conversion,Staff,40,33,7,0,0
8146,Kendall Campus,BSC 2086 - 0012   Human Anatomy & Physiology 2,0012-LEC Main Sess,Staff,49,46,3,0,0
8147,Kendall Campus,BSC 2086 - 0013   Human Anatomy & Physiology 2,0013-LEC Main Sess,Staff,110,69,41,0,0
8148,Kendall Campus,BSC 2086 - 0014   Human Anatomy & Physiology 2,0014-LEC Main Sess,Staff,39,12,27,0,0
8183,Kendall Campus,BSC 2086 - 0015   Human Anatomy & Physiology 2,0015-LEC Weekend,Staff,79,64,15,0,0
8149,Kendall Campus,BSC 2086 - 0016   Human Anatomy & Physiology 2,0016-LEC Main Sess,Staff,40,15,25,0,0
8151,Kendall Campus,BSC 2086 - 0018   Human Anatomy & Physiology 2,0018-LEC Main Sess,Staff,49,44,5,0,0
8152,Kendall Campus,BSC 2086 - 0019   Human Anatomy & Physiology 2,0019-LEC Main Sess,Staff,48,42,6,0,0
8175,Kendall Campus,BSC 2086 - 0020   Human Anatomy & Physiology 2,0020-LEC Twelve Wk,Staff,39,25,14,0,0
8153,Kendall Campus,BSC 2086 - 0021   Human Anatomy & Physiology 2,0021-LEC Main Sess,Staff,38,37,1,0,0
8154,Kendall Campus,BSC 2086 - 0022   Human Anatomy & Physiology 2,0022-LEC Main Sess,Staff,38,36,2,0,0
8155,Kendall Campus,BSC 2086 - 0023   Human Anatomy & Physiology 2,0023-LEC Main Sess,Staff,25,7,18,0,0
8179,Kendall Campus,BSC 2086 - 0024   Human Anatomy & Physiology 2,0024-LEC Conversion,Staff,25,0,25,0,0
8156,Wolfson Campus,BSC 2086 - 0025   Human Anatomy & Physiology 2,0025-LEC Main Sess,Staff,35,34,1,0,0
8176,Wolfson Campus,BSC 2086 - 0026   Human Anatomy & Physiology 2,0026-LEC Eight Wk 2,Staff,35,34,1,0,0
8157,Wolfson Campus,BSC 2086 - 0027   Human Anatomy & Physiology 2,0027-LEC Main Sess,Staff,45,17,28,0,0
8158,Wolfson Campus,BSC 2086 - 0028   Human Anatomy & Physiology 2,0028-LEC Main Sess,Staff,45,0,45,0,0
8159,Wolfson Campus,BSC 2086 - 0029   Human Anatomy & Physiology 2,0029-LEC Main Sess,Staff,45,25,20,0,0
8186,Wolfson Campus,BSC 2086 - 0030   Human Anatomy & Physiology 2,0030-LEC Weekend,Staff,30,0,30,0,0
8160,Wolfson Campus,BSC 2086 - 0031   Human Anatomy & Physiology 2,0031-LEC Main Sess,Staff,45,25,20,0,0
8162,Wolfson Campus,BSC 2086 - 0033   Human Anatomy & Physiology 2,0033-LEC Main Sess,Staff,30,27,3,0,0
8163,Wolfson Campus,BSC 2086 - 0034   Human Anatomy & Physiology 2,0034-LEC Main Sess,Staff,30,27,3,0,0
8164,Wolfson Campus,BSC 2086 - 0035   Human Anatomy & Physiology 2,0035-LEC Main Sess,Staff,30,29,1,0,0
8166,Wolfson Campus,BSC 2086 - 0037   Human Anatomy & Physiology 2,0037-LEC Main Sess,Staff,30,25,5,0,0
8167,Wolfson Campus,BSC 2086 - 0038   Human Anatomy & Physiology 2,0038-LEC Main Sess,Staff,30,27,3,0,0
8168,Homestead Campus,BSC 2086 - 0039   Human Anatomy & Physiology 2,0039-LEC Main Sess,Staff,39,17,22,0,0
8169,Homestead Campus,BSC 2086 - 0040   Human Anatomy & Physiology 2,0040-LEC Main Sess,Staff,39,5,34,0,0
8184,Homestead Campus,BSC 2086 - 0041   Human Anatomy & Physiology 2,0041-LEC Weekend,Staff,39,24,15,0,0
8170,Homestead Campus,BSC 2086 - 0042   Human Anatomy & Physiology 2,0042-LEC Main Sess,Staff,39,20,19,0,0
8171,InterAmerican Campus,BSC 2086 - 0043   Human Anatomy & Physiology 2,0043-LEC Main Sess,Staff,45,38,7,0,0
8172,InterAmerican Campus,BSC 2086 - 0044   Human Anatomy & Physiology 2,0044-LEC Main Sess,Staff,45,44,1,0,0
8173,InterAmerican Campus,BSC 2086 - 0045   Human Anatomy & Physiology 2,0045-LEC Main Sess,Staff,45,42,3,0,0
8174,InterAmerican Campus,BSC 2086 - 0046   Human Anatomy & Physiology 2,0046-LEC Main Sess,Staff,40,7,33,0,0
8185,InterAmerican Campus,BSC 2086 - 0047   Human Anatomy & Physiology 2,0047-LEC Weekend,Staff,40,26,14,0,0
8178,InterAmerican Campus,BSC 2086 - 0048   Human Anatomy & Physiology 2,0048-LEC Eight Wk 2,Staff,40,0,40,0,0
8140,Hialeah Campus,BSC 2086 - 0049   Human Anatomy & Physiology 2,0049-LEC Main Sess,Staff,47,39,8,0,0
8139,Hialeah Campus,BSC 2086 - 0050   Human Anatomy & Physiology 2,0050-LEC Main Sess,Staff,30,0,30,0,0
8138,Hialeah Campus,BSC 2086 - 0051   Human Anatomy & Physiology 2,0051-LEC Main Sess,Staff,35,34,1,0,0
8137,Hialeah Campus,BSC 2086 - 0052   Human Anatomy & Physiology 2,0052-LEC Main Sess,Staff,44,23,21,0,0
8136,Hialeah Campus,BSC 2086 - 0053   Human Anatomy & Physiology 2,0053-LEC Main Sess,Staff,35,16,19,0,0
8135,Hialeah Campus,BSC 2086 - 0054   Human Anatomy & Physiology 2,0054-LEC Main Sess,Staff,30,0,30,0,0
8134,West Campus,BSC 2086 - 0055   Human Anatomy & Physiology 2,0055-LEC Main Sess,Staff,30,0,30,0,0
8133,West Campus,BSC 2086 - 0056   Human Anatomy & Physiology 2,0056-LEC Main Sess,Staff,35,10,25,0,0
8132,West Campus,BSC 2086 - 0057   Human Anatomy & Physiology 2,0057-LEC Main Sess,Staff,35,0,35,0,0
8131,West Campus,BSC 2086 - 0058   Human Anatomy & Physiology 2,0058-LEC Main Sess,Staff,35,17,18,0,0
8130,West Campus,BSC 2086 - 0059   Human Anatomy & Physiology 2,0059-LEC Main Sess,Staff,35,18,17,0,0
6739,North Campus,BSC 2086L - 0001   Human Anatomy & Physiology 2 Laboratory,0001-LAB Main Sess,Staff,24,0,24,0,0
6794,North Campus,BSC 2086L - 0003   Human Anatomy & Physiology 2 Laboratory,0003-LAB Main Sess,Staff,24,0,24,0,0
6795,North Campus,BSC 2086L - 0004   Human Anatomy & Physiology 2 Laboratory,0004-LAB Main Sess,Staff,24,20,4,0,0
6741,North Campus,BSC 2086L - 0007   Human Anatomy & Physiology 2 Laboratory,0007-LAB Main Sess,Staff,24,10,14,0,0
6742,North Campus,BSC 2086L - 0008   Human Anatomy & Physiology 2 Laboratory,0008-LAB Main Sess,Staff,24,18,6,0,0
6796,North Campus,BSC 2086L - 0009   Human Anatomy & Physiology 2 Laboratory,0009-LAB Main Sess,Staff,24,23,1,0,0
6743,North Campus,BSC 2086L - 0011   Human Anatomy & Physiology 2 Laboratory,0011-LAB Main Sess,Staff,24,22,2,0,0
6744,North Campus,BSC 2086L - 0012   Human Anatomy & Physiology 2 Laboratory,0012-LAB Main Sess,Staff,24,23,1,0,0
6745,North Campus,BSC 2086L - 0013   Human Anatomy & Physiology 2 Laboratory,0013-LAB Main Sess,Staff,24,0,24,0,0
6746,North Campus,BSC 2086L - 0014   Human Anatomy & Physiology 2 Laboratory,0014-LAB Main Sess,Staff,24,18,6,0,0
6797,North Campus,BSC 2086L - 0015   Human Anatomy & Physiology 2 Laboratory,0015-LAB Main Sess,Staff,24,23,1,0,0
6747,North Campus,BSC 2086L - 0016   Human Anatomy & Physiology 2 Laboratory,0016-LAB Main Sess,Staff,24,20,4,0,0
6748,North Campus,BSC 2086L - 0017   Human Anatomy & Physiology 2 Laboratory,0017-LAB Main Sess,Staff,24,20,4,0,0
6749,North Campus,BSC 2086L - 0018   Human Anatomy & Physiology 2 Laboratory,0018-LAB Main Sess,Staff,24,20,4,0,0
6750,Kendall Campus,BSC 2086L - 0019   Human Anatomy & Physiology 2 Laboratory,0019-LAB Main Sess,Staff,24,17,7,0,0
6751,Kendall Campus,BSC 2086L - 0020   Human Anatomy & Physiology 2 Laboratory,0020-LAB Main Sess,Staff,24,22,2,0,0
6752,Kendall Campus,BSC 2086L - 0021   Human Anatomy & Physiology 2 Laboratory,0021-LAB Main Sess,Staff,24,17,7,0,0
6812,Kendall Campus,BSC 2086L - 0023   Human Anatomy & Physiology 2 Laboratory,0023-LAB 1st Mon Sp,Staff,24,23,1,0,0
6811,Kendall Campus,BSC 2086L - 0024   Human Anatomy & Physiology 2 Laboratory,0024-LAB 1st Mon Sp,Staff,24,21,3,0,0
6802,Kendall Campus,BSC 2086L - 0025   Human Anatomy & Physiology 2 Laboratory,0025-LAB Twelve Wk,Staff,3,0,3,0,0
6754,Kendall Campus,BSC 2086L - 0026   Human Anatomy & Physiology 2 Laboratory,0026-LAB Main Sess,Staff,24,15,9,0,0
6755,Kendall Campus,BSC 2086L - 0027   Human Anatomy & Physiology 2 Laboratory,0027-LAB Main Sess,Staff,24,17,7,0,0
6756,Kendall Campus,BSC 2086L - 0028   Human Anatomy & Physiology 2 Laboratory,0028-LAB Main Sess,Staff,24,13,11,0,0
6757,Kendall Campus,BSC 2086L - 0029   Human Anatomy & Physiology 2 Laboratory,0029-LAB Main Sess,Staff,24,21,3,0,0
6758,Kendall Campus,BSC 2086L - 0030   Human Anatomy & Physiology 2 Laboratory,0030-LAB Main Sess,Staff,24,8,16,0,0
6815,Kendall Campus,BSC 2086L - 0031   Human Anatomy & Physiology 2 Laboratory,0031-LAB Weekend,Staff,24,12,12,0,0
6801,Kendall Campus,BSC 2086L - 0032   Human Anatomy & Physiology 2 Laboratory,0032-LAB Twelve Wk,Staff,24,13,11,0,0
6759,Kendall Campus,BSC 2086L - 0033   Human Anatomy & Physiology 2 Laboratory,0033-LAB Main Sess,Staff,24,11,13,0,0
6760,Kendall Campus,BSC 2086L - 0034   Human Anatomy & Physiology 2 Laboratory,0034-LAB Main Sess,Staff,24,0,24,0,0
6762,Kendall Campus,BSC 2086L - 0036   Human Anatomy & Physiology 2 Laboratory,0036-LAB Main Sess,Staff,24,16,8,0,0
6763,Kendall Campus,BSC 2086L - 0037   Human Anatomy & Physiology 2 Laboratory,0037-LAB Main Sess,Staff,24,15,9,0,0
6764,Kendall Campus,BSC 2086L - 0040   Human Anatomy & Physiology 2 Laboratory,0040-LAB Main Sess,Staff,24,23,1,0,0
6765,Kendall Campus,BSC 2086L - 0041   Human Anatomy & Physiology 2 Laboratory,0041-LAB Main Sess,Staff,24,23,1,0,0
6766,Kendall Campus,BSC 2086L - 0042   Human Anatomy & Physiology 2 Laboratory,0042-LAB Main Sess,Staff,24,18,6,0,0
6767,Kendall Campus,BSC 2086L - 0043   Human Anatomy & Physiology 2 Laboratory,0043-LAB Main Sess,Staff,24,23,1,0,0
6768,Kendall Campus,BSC 2086L - 0044   Human Anatomy & Physiology 2 Laboratory,0044-LAB Main Sess,Staff,24,19,5,0,0
6769,Kendall Campus,BSC 2086L - 0045   Human Anatomy & Physiology 2 Laboratory,0045-LAB Main Sess,Staff,24,15,9,0,0
6770,Kendall Campus,BSC 2086L - 0046   Human Anatomy & Physiology 2 Laboratory,0046-LAB Main Sess,Staff,24,12,12,0,0
6800,Kendall Campus,BSC 2086L - 0047   Human Anatomy & Physiology 2 Laboratory,0047-LAB Twelve Wk,Staff,24,11,13,0,0
6817,Wolfson Campus,BSC 2086L - 0048   Human Anatomy & Physiology 2 Laboratory,0048-LAB Weekend,Staff,24,13,11,0,0
6805,Wolfson Campus,BSC 2086L - 0049   Human Anatomy & Physiology 2 Laboratory,0049-LAB Eight Wk 2,Staff,22,21,1,0,0
6804,Wolfson Campus,BSC 2086L - 0050   Human Anatomy & Physiology 2 Laboratory,0050-LAB Eight Wk 2,Staff,22,20,2,0,0
6771,Wolfson Campus,BSC 2086L - 0052   Human Anatomy & Physiology 2 Laboratory,0052-LAB Main Sess,Staff,24,19,5,0,0
6772,Wolfson Campus,BSC 2086L - 0053   Human Anatomy & Physiology 2 Laboratory,0053-LAB Main Sess,Staff,24,22,2,0,0
6798,Wolfson Campus,BSC 2086L - 0054   Human Anatomy & Physiology 2 Laboratory,0054-LAB Main Sess,Staff,24,23,1,0,0
6773,Wolfson Campus,BSC 2086L - 0055   Human Anatomy & Physiology 2 Laboratory,0055-LAB Main Sess,Staff,30,28,2,0,0
6774,Wolfson Campus,BSC 2086L - 0056   Human Anatomy & Physiology 2 Laboratory,0056-LAB Main Sess,Staff,30,26,4,0,0
6775,Wolfson Campus,BSC 2086L - 0057   Human Anatomy & Physiology 2 Laboratory,0057-LAB Main Sess,Staff,30,29,1,0,0
6776,Wolfson Campus,BSC 2086L - 0058   Human Anatomy & Physiology 2 Laboratory,0058-LAB Main Sess,Staff,30,29,1,0,0
6777,Wolfson Campus,BSC 2086L - 0059   Human Anatomy & Physiology 2 Laboratory,0059-LAB Main Sess,Staff,30,28,2,0,0
6779,Wolfson Campus,BSC 2086L - 0061   Human Anatomy & Physiology 2 Laboratory,0061-LAB Main Sess,Staff,30,19,11,0,0
6780,Homestead Campus,BSC 2086L - 0062   Human Anatomy & Physiology 2 Laboratory,0062-LAB Main Sess,Staff,24,7,17,0,0
6781,Homestead Campus,BSC 2086L - 0064   Human Anatomy & Physiology 2 Laboratory,0064-LAB Main Sess,Staff,24,12,12,0,0
6782,Homestead Campus,BSC 2086L - 0065   Human Anatomy & Physiology 2 Laboratory,0065-LAB Main Sess,Staff,24,21,3,0,0
6783,InterAmerican Campus,BSC 2086L - 0067   Human Anatomy & Physiology 2 Laboratory,0067-LAB Main Sess,Staff,24,21,3,0,0
6784,InterAmerican Campus,BSC 2086L - 0068   Human Anatomy & Physiology 2 Laboratory,0068-LAB Main Sess,Staff,24,23,1,0,0
6785,InterAmerican Campus,BSC 2086L - 0069   Human Anatomy & Physiology 2 Laboratory,0069-LAB Main Sess,Staff,24,19,5,0,0
6803,InterAmerican Campus,BSC 2086L - 0070   Human Anatomy & Physiology 2 Laboratory,0070-LAB Eight Wk 2,Staff,30,0,30,0,0
6820,InterAmerican Campus,BSC 2086L - 0071   Human Anatomy & Physiology 2 Laboratory,0071-LAB Weekend,Staff,30,25,5,0,0
6799,Hialeah Campus,BSC 2086L - 0073   Human Anatomy & Physiology 2 Laboratory,0073-LAB Main Sess,Staff,24,22,2,0,0
6787,Hialeah Campus,BSC 2086L - 0074   Human Anatomy & Physiology 2 Laboratory,0074-LAB Main Sess,Staff,24,23,1,0,0
6788,Hialeah Campus,BSC 2086L - 0076   Human Anatomy & Physiology 2 Laboratory,0076-LAB Main Sess,Staff,24,18,6,0,0
6789,Hialeah Campus,BSC 2086L - 0077   Human Anatomy & Physiology 2 Laboratory,0077-LAB Main Sess,Staff,24,10,14,0,0
6790,Hialeah Campus,BSC 2086L - 0078   Human Anatomy & Physiology 2 Laboratory,0078-LAB Main Sess,Staff,24,8,16,0,0
6791,West Campus,BSC 2086L - 0079   Human Anatomy & Physiology 2 Laboratory,0079-LAB Main Sess,Staff,24,19,5,0,0
6792,West Campus,BSC 2086L - 0080   Human Anatomy & Physiology 2 Laboratory,0080-LAB Main Sess,Staff,24,12,12,0,0
6793,West Campus,BSC 2086L - 0081   Human Anatomy & Physiology 2 Laboratory,0081-LAB Main Sess,Staff,26,0,26,0,0
6808,West Campus,BSC 2086L - 0082   Human Anatomy & Physiology 2 Laboratory,0082-LAB 1st Mon Sp,Staff,24,14,10,0,0
7862,North Campus,BSC 2085 - 0001   Human Anatomy And Physiology 1,0001-LEC Main Sess,Staff,40,36,4,0,0
7863,North Campus,BSC 2085 - 0002   Human Anatomy And Physiology 1,0002-LEC Main Sess,Staff,40,18,22,0,0
7878,North Campus,BSC 2085 - 0003   Human Anatomy And Physiology 1,0003-LEC Main Sess,Staff,40,37,3,0,0
7879,North Campus,BSC 2085 - 0004   Human Anatomy And Physiology 1,0004-LEC Main Sess,Staff,40,39,1,0,0
7880,North Campus,BSC 2085 - 0005   Human Anatomy And Physiology 1,0005-LEC Main Sess,Staff,40,28,12,0,0
7923,North Campus,BSC 2085 - 0006   Human Anatomy And Physiology 1,0006-LEC Weekend,Staff,35,0,35,0,0
7917,North Campus,BSC 2085 - 0007   Human Anatomy And Physiology 1,0007-LEC 1st Mon Sp,Staff,40,0,40,0,0
7882,North Campus,BSC 2085 - 0009   Human Anatomy And Physiology 1,0009-LEC Main Sess,Staff,40,0,40,0,0
7864,North Campus,BSC 2085 - 0010   Human Anatomy And Physiology 1,0010-LEC Main Sess,Staff,40,0,40,0,0
7912,North Campus,BSC 2085 - 0011   Human Anatomy And Physiology 1,0011-LEC Eight Wk 1,Staff,40,35,5,0,0
7883,North Campus,BSC 2085 - 0012   Human Anatomy And Physiology 1,0012-LEC Main Sess,Staff,40,36,4,0,0
7885,North Campus,BSC 2085 - 0014   Human Anatomy And Physiology 1,0014-LEC Main Sess,Staff,40,21,19,0,0
7909,North Campus,BSC 2085 - 0015   Human Anatomy And Physiology 1,0015-LEC Twelve Wk,Staff,22,19,3,0,0
7886,Kendall Campus,BSC 2085 - 0016   Human Anatomy And Physiology 1,0016-LEC Main Sess,Staff,49,47,2,0,0
7887,Kendall Campus,BSC 2085 - 0017   Human Anatomy And Physiology 1,0017-LEC Main Sess,Staff,49,47,2,0,0
7922,Kendall Campus,BSC 2085 - 0018   Human Anatomy And Physiology 1,0018-LEC Weekend,Staff,110,58,52,0,0
7888,Kendall Campus,BSC 2085 - 0019   Human Anatomy And Physiology 1,0019-LEC Main Sess,Staff,49,45,4,0,0
7889,Kendall Campus,BSC 2085 - 0020   Human Anatomy And Physiology 1,0020-LEC Main Sess,Staff,110,99,11,0,0
7890,Kendall Campus,BSC 2085 - 0021   Human Anatomy And Physiology 1,0021-LEC Main Sess,Staff,110,61,49,0,0
7891,Kendall Campus,BSC 2085 - 0022   Human Anatomy And Physiology 1,0022-LEC Main Sess,Staff,49,21,28,0,0
7892,Kendall Campus,BSC 2085 - 0023   Human Anatomy And Physiology 1,0023-LEC Main Sess,Staff,39,37,2,0,0
7893,Kendall Campus,BSC 2085 - 0024   Human Anatomy And Physiology 1,0024-LEC Main Sess,Staff,110,94,16,0,0
7894,Kendall Campus,BSC 2085 - 0025   Human Anatomy And Physiology 1,0025-LEC Main Sess,Staff,49,33,16,0,0
7895,Kendall Campus,BSC 2085 - 0026   Human Anatomy And Physiology 1,0026-LEC Main Sess,Staff,39,37,2,0,0
7896,Kendall Campus,BSC 2085 - 0027   Human Anatomy And Physiology 1,0027-LEC Main Sess,Staff,75,63,12,0,0
7911,Kendall Campus,BSC 2085 - 0028   Human Anatomy And Physiology 1,0028-LEC Twelve Wk,Staff,49,22,27,0,0
7918,Kendall Campus,BSC 2085 - 0029   Human Anatomy And Physiology 1,0029-LEC 1st Mon Sp,Staff,25,0,25,0,0
7897,Wolfson Campus,BSC 2085 - 0030   Human Anatomy And Physiology 1,0030-LEC Main Sess,Staff,45,34,11,0,0
7913,Wolfson Campus,BSC 2085 - 0031   Human Anatomy And Physiology 1,0031-LEC Eight Wk 1,Staff,45,31,14,0,0
7898,Wolfson Campus,BSC 2085 - 0032   Human Anatomy And Physiology 1,0032-LEC Main Sess,Staff,45,29,16,0,0
7920,Wolfson Campus,BSC 2085 - 0033   Human Anatomy And Physiology 1,0033-LEC Weekend,Staff,45,0,45,0,0
7910,Wolfson Campus,BSC 2085 - 0034   Human Anatomy And Physiology 1,0034-LEC Twelve Wk,Staff,45,37,8,0,0
7899,Wolfson Campus,BSC 2085 - 0035   Human Anatomy And Physiology 1,0035-LEC Main Sess,Staff,45,27,18,0,0
7900,Wolfson Campus,BSC 2085 - 0036   Human Anatomy And Physiology 1,0036-LEC Main Sess,Staff,45,29,16,0,0
7901,Wolfson Campus,BSC 2085 - 0037   Human Anatomy And Physiology 1,0037-LEC Main Sess,Staff,45,42,3,0,0
7902,Wolfson Campus,BSC 2085 - 0038   Human Anatomy And Physiology 1,0038-LEC Main Sess,Staff,30,24,6,0,0
7903,Wolfson Campus,BSC 2085 - 0039   Human Anatomy And Physiology 1,0039-LEC Main Sess,Staff,30,24,6,0,0
7905,Wolfson Campus,BSC 2085 - 0041   Human Anatomy And Physiology 1,0041-LEC Main Sess,Staff,30,26,4,0,0
7906,Wolfson Campus,BSC 2085 - 0042   Human Anatomy And Physiology 1,0042-LEC Main Sess,Staff,30,25,5,0,0
7916,Wolfson Campus,BSC 2085 - 0043   Human Anatomy And Physiology 1,0043-LEC Conversion,Staff,30,26,4,0,0
7907,Homestead Campus,BSC 2085 - 0044   Human Anatomy And Physiology 1,0044-LEC Main Sess,Staff,39,33,6,0,0
7908,Homestead Campus,BSC 2085 - 0045   Human Anatomy And Physiology 1,0045-LEC Main Sess,Staff,39,34,5,0,0
7877,Homestead Campus,BSC 2085 - 0046   Human Anatomy And Physiology 1,0046-LEC Main Sess,Staff,39,21,18,0,0
7876,InterAmerican Campus,BSC 2085 - 0047   Human Anatomy And Physiology 1,0047-LEC Main Sess,Staff,36,28,8,0,0
7874,InterAmerican Campus,BSC 2085 - 0049   Human Anatomy And Physiology 1,0049-LEC Main Sess,Staff,45,43,2,0,0
7915,InterAmerican Campus,BSC 2085 - 0050   Human Anatomy And Physiology 1,0050-LEC Conversion,Staff,35,33,2,0,0
7921,InterAmerican Campus,BSC 2085 - 0051   Human Anatomy And Physiology 1,0051-LEC Weekend,Staff,40,34,6,0,0
7919,InterAmerican Campus,BSC 2085 - 0052   Human Anatomy And Physiology 1,0052-LEC Weekend,Staff,30,0,30,0,0
7914,InterAmerican Campus,BSC 2085 - 0053   Human Anatomy And Physiology 1,0053-LEC Eight Wk 1,Staff,30,0,30,0,0
7873,Hialeah Campus,BSC 2085 - 0054   Human Anatomy And Physiology 1,0054-LEC Main Sess,Staff,34,33,1,0,0
7872,Hialeah Campus,BSC 2085 - 0055   Human Anatomy And Physiology 1,0055-LEC Main Sess,Staff,35,32,3,0,0
7871,Hialeah Campus,BSC 2085 - 0056   Human Anatomy And Physiology 1,0056-LEC Main Sess,Staff,32,24,8,0,0
7870,Hialeah Campus,BSC 2085 - 0057   Human Anatomy And Physiology 1,0057-LEC Main Sess,Staff,44,35,9,0,0
7868,West Campus,BSC 2085 - 0059   Human Anatomy And Physiology 1,0059-LEC Main Sess,Staff,35,32,3,0,0
7867,West Campus,BSC 2085 - 0060   Human Anatomy And Physiology 1,0060-LEC Main Sess,Staff,35,14,21,0,0
7866,West Campus,BSC 2085 - 0061   Human Anatomy And Physiology 1,0061-LEC Main Sess,Staff,35,0,35,0,0
7865,West Campus,BSC 2085 - 0062   Human Anatomy And Physiology 1,0062-LEC Main Sess,Staff,35,0,35,0,0
6301,North Campus,EDF 2085 - 0003   Introduction To Diversity,0003-LEC Eight Wk 2,Staff,30,0,30,0,0
6293,Kendall Campus,EDF 2085 - 0004   Introduction To Diversity,0004-LEC Main Sess,Staff,36,33,3,0,0
6302,Kendall Campus,EDF 2085 - 0005   Introduction To Diversity,0005-LEC Eight Wk 2,Staff,30,0,30,0,0
6295,Wolfson Campus,EDF 2085 - 0007   Introduction To Diversity,0007-LEC Main Sess,Staff,30,0,30,0,0
6296,Wolfson Campus,EDF 2085 - 0008   Introduction To Diversity,0008-LEC Main Sess,Staff,30,26,4,0,0
6297,Wolfson Campus,EDF 2085 - 0009   Introduction To Diversity,0009-LEC Main Sess,Staff,30,27,3,0,0
6300,Wolfson Campus,EDF 2085 - 0010   Introduction To Diversity,0010-LEC Main Sess,Staff,30,29,1,0,0
6299,Homestead Campus,EDF 2085 - 0011   Introduction To Diversity,0011-LEC Main Sess,Staff,28,25,3,0,0
6298,InterAmerican Campus,EDF 2085 - 0012   Introduction To Diversity,0012-LEC Main Sess,Staff,21,19,2,0,0
6303,InterAmerican Campus,EDF 2085 - 0013   Introduction To Diversity,0013-LEC 1st Mon Sp,Staff,25,22,3,0,0
5664,North Campus,BSC 2085L - 0003   Human Anatomy And Physiology 1 Laboratory,0003-LAB 1st Mon Sp,Staff,24,0,24,0,0
5665,North Campus,BSC 2085L - 0004   Human Anatomy And Physiology 1 Laboratory,0004-LAB 1st Mon Sp,Staff,24,0,24,0,0
5666,North Campus,BSC 2085L - 0005   Human Anatomy And Physiology 1 Laboratory,0005-LAB 1st Mon Sp,Staff,24,0,24,0,0
5572,North Campus,BSC 2085L - 0006   Human Anatomy And Physiology 1 Laboratory,0006-LAB Main Sess,Staff,24,0,24,0,0
5574,North Campus,BSC 2085L - 0008   Human Anatomy And Physiology 1 Laboratory,0008-LAB Main Sess,Staff,24,22,2,0,0
5641,North Campus,BSC 2085L - 0009   Human Anatomy And Physiology 1 Laboratory,0009-LAB Main Sess,Staff,24,22,2,0,0
5673,North Campus,BSC 2085L - 0010   Human Anatomy And Physiology 1 Laboratory,0010-LAB Weekend,Staff,24,0,24,0,0
5674,North Campus,BSC 2085L - 0011   Human Anatomy And Physiology 1 Laboratory,0011-LAB Weekend,Staff,24,23,1,0,0
5652,North Campus,BSC 2085L - 0012   Human Anatomy And Physiology 1 Laboratory,0012-LAB Eight Wk 1,Staff,24,20,4,0,0
5667,North Campus,BSC 2085L - 0013   Human Anatomy And Physiology 1 Laboratory,0013-LAB 1st Mon Sp,Staff,24,0,24,0,0
5576,North Campus,BSC 2085L - 0016   Human Anatomy And Physiology 1 Laboratory,0016-LAB Main Sess,Staff,24,21,3,0,0
5577,North Campus,BSC 2085L - 0017   Human Anatomy And Physiology 1 Laboratory,0017-LAB Main Sess,Staff,24,0,24,0,0
5578,North Campus,BSC 2085L - 0018   Human Anatomy And Physiology 1 Laboratory,0018-LAB Main Sess,Staff,24,23,1,0,0
5580,North Campus,BSC 2085L - 0020   Human Anatomy And Physiology 1 Laboratory,0020-LAB Main Sess,Staff,24,22,2,0,0
5581,North Campus,BSC 2085L - 0021   Human Anatomy And Physiology 1 Laboratory,0021-LAB Main Sess,Staff,24,0,24,0,0
5582,North Campus,BSC 2085L - 0022   Human Anatomy And Physiology 1 Laboratory,0022-LAB Main Sess,Staff,24,0,24,0,0
5583,North Campus,BSC 2085L - 0023   Human Anatomy And Physiology 1 Laboratory,0023-LAB Main Sess,Staff,24,22,2,0,0
5585,North Campus,BSC 2085L - 0025   Human Anatomy And Physiology 1 Laboratory,0025-LAB Main Sess,Staff,24,0,24,0,0
5642,North Campus,BSC 2085L - 0026   Human Anatomy And Physiology 1 Laboratory,0026-LAB Main Sess,Staff,24,23,1,0,0
5668,North Campus,BSC 2085L - 0028   Human Anatomy And Physiology 1 Laboratory,0028-LAB 1st Mon Sp,Staff,24,0,24,0,0
5669,North Campus,BSC 2085L - 0029   Human Anatomy And Physiology 1 Laboratory,0029-LAB 1st Mon Sp,Staff,24,23,1,0,0
5587,Kendall Campus,BSC 2085L - 0031   Human Anatomy And Physiology 1 Laboratory,0031-LAB Main Sess,Staff,24,20,4,0,0
5588,Kendall Campus,BSC 2085L - 0032   Human Anatomy And Physiology 1 Laboratory,0032-LAB Main Sess,Staff,24,20,4,0,0
5590,Kendall Campus,BSC 2085L - 0034   Human Anatomy And Physiology 1 Laboratory,0034-LAB Main Sess,Staff,24,0,24,0,0
5591,Kendall Campus,BSC 2085L - 0035   Human Anatomy And Physiology 1 Laboratory,0035-LAB Main Sess,Staff,24,0,24,0,0
5592,Kendall Campus,BSC 2085L - 0036   Human Anatomy And Physiology 1 Laboratory,0036-LAB Main Sess,Staff,24,0,24,0,0
5593,Kendall Campus,BSC 2085L - 0037   Human Anatomy And Physiology 1 Laboratory,0037-LAB Main Sess,Staff,24,20,4,0,0
5670,Kendall Campus,BSC 2085L - 0038   Human Anatomy And Physiology 1 Laboratory,0038-LAB 1st Mon Sp,Staff,24,13,11,0,0
5671,Kendall Campus,BSC 2085L - 0039   Human Anatomy And Physiology 1 Laboratory,0039-LAB 1st Mon Sp,Staff,24,21,3,0,0
5594,Kendall Campus,BSC 2085L - 0040   Human Anatomy And Physiology 1 Laboratory,0040-LAB Main Sess,Staff,24,23,1,0,0
5595,Kendall Campus,BSC 2085L - 0041   Human Anatomy And Physiology 1 Laboratory,0041-LAB Main Sess,Staff,24,23,1,0,0
5596,Kendall Campus,BSC 2085L - 0042   Human Anatomy And Physiology 1 Laboratory,0042-LAB Main Sess,Staff,24,23,1,0,0
5597,Kendall Campus,BSC 2085L - 0043   Human Anatomy And Physiology 1 Laboratory,0043-LAB Main Sess,Staff,24,6,18,0,0
5598,Kendall Campus,BSC 2085L - 0044   Human Anatomy And Physiology 1 Laboratory,0044-LAB Main Sess,Staff,24,22,2,0,0
5599,Kendall Campus,BSC 2085L - 0045   Human Anatomy And Physiology 1 Laboratory,0045-LAB Main Sess,Staff,24,21,3,0,0
5600,Kendall Campus,BSC 2085L - 0046   Human Anatomy And Physiology 1 Laboratory,0046-LAB Main Sess,Staff,24,0,24,0,0
5675,Kendall Campus,BSC 2085L - 0048   Human Anatomy And Physiology 1 Laboratory,0048-LAB Weekend,Staff,24,23,1,0,0
5646,Kendall Campus,BSC 2085L - 0049   Human Anatomy And Physiology 1 Laboratory,0049-LAB Twelve Wk,Staff,24,21,3,0,0
5601,Kendall Campus,BSC 2085L - 0050   Human Anatomy And Physiology 1 Laboratory,0050-LAB Main Sess,Staff,24,20,4,0,0
5602,Kendall Campus,BSC 2085L - 0051   Human Anatomy And Physiology 1 Laboratory,0051-LAB Main Sess,Staff,24,23,1,0,0
5603,Kendall Campus,BSC 2085L - 0052   Human Anatomy And Physiology 1 Laboratory,0052-LAB Main Sess,Staff,24,23,1,0,0
5604,Kendall Campus,BSC 2085L - 0053   Human Anatomy And Physiology 1 Laboratory,0053-LAB Main Sess,Staff,24,22,2,0,0
5605,Kendall Campus,BSC 2085L - 0054   Human Anatomy And Physiology 1 Laboratory,0054-LAB Main Sess,Staff,24,21,3,0,0
5649,Kendall Campus,BSC 2085L - 0055   Human Anatomy And Physiology 1 Laboratory,0055-LAB Twelve Wk,Staff,24,23,1,0,0
5661,Kendall Campus,BSC 2085L - 0057   Human Anatomy And Physiology 1 Laboratory,0057-LAB 1st Mon Sp,Staff,24,17,7,0,0
5606,Kendall Campus,BSC 2085L - 0058   Human Anatomy And Physiology 1 Laboratory,0058-LAB Main Sess,Staff,24,23,1,0,0
5607,Kendall Campus,BSC 2085L - 0059   Human Anatomy And Physiology 1 Laboratory,0059-LAB Main Sess,Staff,24,22,2,0,0
5611,Kendall Campus,BSC 2085L - 0063   Human Anatomy And Physiology 1 Laboratory,0063-LAB Main Sess,Staff,24,23,1,0,0
5612,Kendall Campus,BSC 2085L - 0064   Human Anatomy And Physiology 1 Laboratory,0064-LAB Main Sess,Staff,24,23,1,0,0
5676,Kendall Campus,BSC 2085L - 0065   Human Anatomy And Physiology 1 Laboratory,0065-LAB Weekend,Staff,24,23,1,0,0
5613,Wolfson Campus,BSC 2085L - 0066   Human Anatomy And Physiology 1 Laboratory,0066-LAB Main Sess,Staff,24,22,2,0,0
5614,Wolfson Campus,BSC 2085L - 0067   Human Anatomy And Physiology 1 Laboratory,0067-LAB Main Sess,Staff,24,13,11,0,0
5651,Wolfson Campus,BSC 2085L - 0068   Human Anatomy And Physiology 1 Laboratory,0068-LAB Eight Wk 1,Staff,24,21,3,0,0
5660,Wolfson Campus,BSC 2085L - 0069   Human Anatomy And Physiology 1 Laboratory,0069-LAB 1st Mon Sp,Staff,24,0,24,0,0
5615,Wolfson Campus,BSC 2085L - 0070   Human Anatomy And Physiology 1 Laboratory,0070-LAB Main Sess,Staff,24,22,2,0,0
5616,Wolfson Campus,BSC 2085L - 0071   Human Anatomy And Physiology 1 Laboratory,0071-LAB Main Sess,Staff,24,9,15,0,0
5650,Wolfson Campus,BSC 2085L - 0072   Human Anatomy And Physiology 1 Laboratory,0072-LAB Eight Wk 1,Staff,24,9,15,0,0
5659,Wolfson Campus,BSC 2085L - 0073   Human Anatomy And Physiology 1 Laboratory,0073-LAB 1st Mon Sp,Staff,24,16,8,0,0
5617,Wolfson Campus,BSC 2085L - 0074   Human Anatomy And Physiology 1 Laboratory,0074-LAB Main Sess,Staff,24,19,5,0,0
5677,Wolfson Campus,BSC 2085L - 0076   Human Anatomy And Physiology 1 Laboratory,0076-LAB Weekend,Staff,24,0,24,0,0
5648,Wolfson Campus,BSC 2085L - 0077   Human Anatomy And Physiology 1 Laboratory,0077-LAB Twelve Wk,Staff,24,22,2,0,0
5618,Wolfson Campus,BSC 2085L - 0078   Human Anatomy And Physiology 1 Laboratory,0078-LAB Main Sess,Staff,24,23,1,0,0
5619,Wolfson Campus,BSC 2085L - 0079   Human Anatomy And Physiology 1 Laboratory,0079-LAB Main Sess,Staff,24,16,8,0,0
5620,Wolfson Campus,BSC 2085L - 0081   Human Anatomy And Physiology 1 Laboratory,0081-LAB Main Sess,Staff,30,23,7,0,0
5621,Wolfson Campus,BSC 2085L - 0082   Human Anatomy And Physiology 1 Laboratory,0082-LAB Main Sess,Staff,30,25,5,0,0
5622,Wolfson Campus,BSC 2085L - 0083   Human Anatomy And Physiology 1 Laboratory,0083-LAB Main Sess,Staff,30,27,3,0,0
5624,Wolfson Campus,BSC 2085L - 0085   Human Anatomy And Physiology 1 Laboratory,0085-LAB Main Sess,Staff,30,25,5,0,0
5655,Wolfson Campus,BSC 2085L - 0086   Human Anatomy And Physiology 1 Laboratory,0086-LAB Conversion,Staff,30,28,2,0,0
5625,Homestead Campus,BSC 2085L - 0087   Human Anatomy And Physiology 1 Laboratory,0087-LAB Main Sess,Staff,24,18,6,0,0
5626,Homestead Campus,BSC 2085L - 0088   Human Anatomy And Physiology 1 Laboratory,0088-LAB Main Sess,Staff,24,0,24,0,0
5627,Homestead Campus,BSC 2085L - 0089   Human Anatomy And Physiology 1 Laboratory,0089-LAB Main Sess,Staff,24,20,4,0,0
5628,Homestead Campus,BSC 2085L - 0090   Human Anatomy And Physiology 1 Laboratory,0090-LAB Main Sess,Staff,24,23,1,0,0
5629,Homestead Campus,BSC 2085L - 0091   Human Anatomy And Physiology 1 Laboratory,0091-LAB Main Sess,Staff,24,20,4,0,0
5630,InterAmerican Campus,BSC 2085L - 0092   Human Anatomy And Physiology 1 Laboratory,0092-LAB Main Sess,Staff,24,23,1,0,0
5678,InterAmerican Campus,BSC 2085L - 0094   Human Anatomy And Physiology 1 Laboratory,0094-LAB Weekend,Staff,24,21,3,0,0
5658,InterAmerican Campus,BSC 2085L - 0095   Human Anatomy And Physiology 1 Laboratory,0095-LAB 1st Mon Sp,Staff,24,18,6,0,0
5632,InterAmerican Campus,BSC 2085L - 0097   Human Anatomy And Physiology 1 Laboratory,0097-LAB Main Sess,Staff,24,23,1,0,0
5653,InterAmerican Campus,BSC 2085L - 0098   Human Anatomy And Physiology 1 Laboratory,0098-LAB Conversion,Staff,24,0,24,0,0
5672,InterAmerican Campus,BSC 2085L - 0099   Human Anatomy And Physiology 1 Laboratory,0099-LAB Weekend,Staff,24,0,24,0,0
5633,Hialeah Campus,BSC 2085L - 0100   Human Anatomy And Physiology 1 Laboratory,0100-LAB Main Sess,Staff,24,23,1,0,0
5636,Hialeah Campus,BSC 2085L - 0104   Human Anatomy And Physiology 1 Laboratory,0104-LAB Main Sess,Staff,24,23,1,0,0
5663,West Campus,BSC 2085L - 0106   Human Anatomy And Physiology 1 Laboratory,0106-LAB 1st Mon Sp,Staff,24,22,2,0,0
5638,West Campus,BSC 2085L - 0107   Human Anatomy And Physiology 1 Laboratory,0107-LAB Main Sess,Staff,24,14,10,0,0
5639,West Campus,BSC 2085L - 0108   Human Anatomy And Physiology 1 Laboratory,0108-LAB Main Sess,Staff,26,0,26,0,0
11890,Wolfson Campus,THE 2083 - 0001   Theatre Problems,0001-LEC Main Sess,Staff,3,1,2,0,0
8671,Wolfson Campus,AMH 2079 - 0001   History Of South Florida,0001-LEC Main Sess,Staff,49,44,5,0,0
7267,North Campus,ACG 2071 - 0001   Managerial Accounting,0001-LEC Main Sess,Staff,35,23,12,0,0
7268,North Campus,ACG 2071 - 0002   Managerial Accounting,0002-LEC Main Sess,Staff,24,12,12,0,0
7292,North Campus,ACG 2071 - 0003   Managerial Accounting,0003-LEC Main Sess,Staff,24,0,24,0,0
7307,North Campus,ACG 2071 - 0004   Managerial Accounting,0004-LEC Eight Wk 2,Staff,35,23,12,0,0
7306,North Campus,ACG 2071 - 0005   Managerial Accounting,0005-LEC Eight Wk 2,Staff,30,0,30,0,0
7305,North Campus,ACG 2071 - 0006   Managerial Accounting,0006-LEC Eight Wk 1,Staff,30,27,3,0,0
7293,North Campus,ACG 2071 - 0007   Managerial Accounting,0007-LEC Main Sess,Staff,35,24,11,0,0
7294,North Campus,ACG 2071 - 0008   Managerial Accounting,0008-LEC Main Sess,Staff,30,28,2,0,0
7314,North Campus,ACG 2071 - 0009   Managerial Accounting,0009-LEC Conversion,Staff,30,18,12,0,0
7295,North Campus,ACG 2071 - 0010   Managerial Accounting,0010-LEC Main Sess,Staff,30,13,17,0,0
7300,North Campus,ACG 2071 - 0011   Managerial Accounting,0011-LEC Twelve Wk,Staff,30,0,30,0,0
7296,Kendall Campus,ACG 2071 - 0012   Managerial Accounting,0012-LEC Main Sess,Staff,36,35,1,0,0
7308,Kendall Campus,ACG 2071 - 0014   Managerial Accounting,0014-LEC Eight Wk 2,Staff,40,19,21,0,0
7309,Kendall Campus,ACG 2071 - 0015   Managerial Accounting,0015-LEC Eight Wk 2,Staff,35,18,17,0,0
7291,Kendall Campus,ACG 2071 - 0017   Managerial Accounting,0017-LEC Main Sess,Staff,25,0,25,0,0
7290,Kendall Campus,ACG 2071 - 0018   Managerial Accounting,0018-LEC Main Sess,Staff,35,30,5,0,0
7289,Kendall Campus,ACG 2071 - 0019   Managerial Accounting,0019-LEC Main Sess,Staff,36,19,17,0,0
7288,Kendall Campus,ACG 2071 - 0020   Managerial Accounting,0020-LEC Main Sess,Staff,36,22,14,0,0
7287,Kendall Campus,ACG 2071 - 0021   Managerial Accounting,0021-LEC Main Sess,Staff,25,22,3,0,0
7322,Kendall Campus,ACG 2071 - 0022   Managerial Accounting,0022-LEC Weekend,Staff,36,20,16,0,0
7285,Kendall Campus,ACG 2071 - 0025   Managerial Accounting,0025-LEC Main Sess,Staff,30,21,9,0,0
7321,Wolfson Campus,ACG 2071 - 0027   Managerial Accounting,0027-LEC 1st Mon Sp,Staff,40,31,9,0,0
7316,Wolfson Campus,ACG 2071 - 0028   Managerial Accounting,0028-LEC Conversion,Staff,40,0,40,0,0
7318,Wolfson Campus,ACG 2071 - 0030   Managerial Accounting,0030-LEC Conversion,Staff,40,11,29,0,0
7282,Wolfson Campus,ACG 2071 - 0031   Managerial Accounting,0031-LEC Main Sess,Staff,40,16,24,0,0
7317,Wolfson Campus,ACG 2071 - 0032   Managerial Accounting,0032-LEC Conversion,Staff,40,29,11,0,0
7281,Wolfson Campus,ACG 2071 - 0033   Managerial Accounting,0033-LEC Main Sess,Staff,40,17,23,0,0
7279,Wolfson Campus,ACG 2071 - 0035   Managerial Accounting,0035-LEC Main Sess,Staff,30,26,4,0,0
7278,Wolfson Campus,ACG 2071 - 0036   Managerial Accounting,0036-LEC Main Sess,Staff,30,28,2,0,0
7277,Homestead Campus,ACG 2071 - 0037   Managerial Accounting,0037-LEC Main Sess,Staff,35,11,24,0,0
7276,Homestead Campus,ACG 2071 - 0038   Managerial Accounting,0038-LEC Main Sess,Staff,35,27,8,0,0
7319,Homestead Campus,ACG 2071 - 0039   Managerial Accounting,0039-LEC Conversion,Staff,35,19,16,0,0
7275,InterAmerican Campus,ACG 2071 - 0040   Managerial Accounting,0040-LEC Main Sess,Staff,33,13,20,0,0
7299,InterAmerican Campus,ACG 2071 - 0041   Managerial Accounting,0041-LEC Twelve Wk,Staff,5,0,5,0,0
7274,InterAmerican Campus,ACG 2071 - 0042   Managerial Accounting,0042-LEC Main Sess,Staff,33,20,13,0,0
7302,InterAmerican Campus,ACG 2071 - 0043   Managerial Accounting,0043-LEC Twelve Wk,Staff,30,22,8,0,0
7273,InterAmerican Campus,ACG 2071 - 0044   Managerial Accounting,0044-LEC Main Sess,Staff,30,28,2,0,0
7311,Hialeah Campus,ACG 2071 - 0046   Managerial Accounting,0046-LEC Eight Wk 2,Staff,30,0,30,0,0
7272,Hialeah Campus,ACG 2071 - 0047   Managerial Accounting,0047-LEC Main Sess,Staff,30,19,11,0,0
7304,Hialeah Campus,ACG 2071 - 0048   Managerial Accounting,0048-LEC Eight Wk 1,Staff,30,0,30,0,0
7271,Hialeah Campus,ACG 2071 - 0049   Managerial Accounting,0049-LEC Main Sess,Staff,30,24,6,0,0
7270,Hialeah Campus,ACG 2071 - 0050   Managerial Accounting,0050-LEC Main Sess,Staff,30,25,5,0,0
7312,Hialeah Campus,ACG 2071 - 0051   Managerial Accounting,0051-LEC Eight Wk 2,Staff,30,29,1,0,0
7303,Hialeah Campus,ACG 2071 - 0052   Managerial Accounting,0052-LEC Eight Wk 1,Staff,30,17,13,0,0
7315,West Campus,ACG 2071 - 0053   Managerial Accounting,0053-LEC Conversion,Staff,35,0,35,0,0
7320,West Campus,ACG 2071 - 0054   Managerial Accounting,0054-LEC 1st Mon Sp,Staff,35,0,35,0,0
7313,West Campus,ACG 2071 - 0056   Managerial Accounting,0056-LEC Eight Wk 2,Staff,30,10,20,0,0
7536,North Campus,ACG 2071L - 0001   Managerial Accounting Lab,0001-LAB Main Sess,Staff,999,99,900,0,0
7559,North Campus,ACG 2071L - 0002   Managerial Accounting Lab,0002-LAB Eight Wk 2,Staff,30,0,30,0,0
7552,North Campus,ACG 2071L - 0003   Managerial Accounting Lab,0003-LAB Eight Wk 1,Staff,30,27,3,0,0
7560,North Campus,ACG 2071L - 0004   Managerial Accounting Lab,0004-LAB Conversion,Staff,30,18,12,0,0
7558,North Campus,ACG 2071L - 0005   Managerial Accounting Lab,0005-LAB Eight Wk 2,Staff,99,25,74,0,0
7548,North Campus,ACG 2071L - 0006   Managerial Accounting Lab,0006-LAB Twelve Wk,Staff,30,0,30,0,0
7551,North Campus,ACG 2071L - 0007   Managerial Accounting Lab,0007-LAB Twelve Wk,Staff,999,0,999,0,0
7537,Kendall Campus,ACG 2071L - 0008   Managerial Accounting Lab,0008-LAB Main Sess,Staff,500,250,250,0,0
7549,Kendall Campus,ACG 2071L - 0009   Managerial Accounting Lab,0009-LAB Twelve Wk,Staff,200,43,157,0,0
7557,Kendall Campus,ACG 2071L - 0010   Managerial Accounting Lab,0010-LAB Eight Wk 2,Staff,75,35,40,0,0
7564,Wolfson Campus,ACG 2071L - 0011   Managerial Accounting Lab,0011-LAB Conversion,Staff,150,0,150,0,0
7561,Wolfson Campus,ACG 2071L - 0012   Managerial Accounting Lab,0012-LAB Conversion,Staff,150,11,139,0,0
7556,Wolfson Campus,ACG 2071L - 0013   Managerial Accounting Lab,0013-LAB Eight Wk 2,Staff,60,29,31,0,0
7544,Wolfson Campus,ACG 2071L - 0014   Managerial Accounting Lab,0014-LAB Main Sess,Staff,250,125,125,0,0
7545,Wolfson Campus,ACG 2071L - 0015   Managerial Accounting Lab,0015-LAB Main Sess,Staff,45,44,1,0,0
7546,Wolfson Campus,ACG 2071L - 0016   Managerial Accounting Lab,0016-LAB Main Sess,Staff,45,40,5,0,0
7543,Homestead Campus,ACG 2071L - 0017   Managerial Accounting Lab,0017-LAB Main Sess,Staff,70,37,33,0,0
7562,Homestead Campus,ACG 2071L - 0018   Managerial Accounting Lab,0018-LAB Conversion,Staff,70,19,51,0,0
7542,InterAmerican Campus,ACG 2071L - 0019   Managerial Accounting Lab,0019-LAB Main Sess,Staff,33,13,20,0,0
7550,InterAmerican Campus,ACG 2071L - 0020   Managerial Accounting Lab,0020-LAB Twelve Wk,Staff,30,22,8,0,0
7541,InterAmerican Campus,ACG 2071L - 0021   Managerial Accounting Lab,0021-LAB Main Sess,Staff,33,20,13,0,0
7540,InterAmerican Campus,ACG 2071L - 0022   Managerial Accounting Lab,0022-LAB Main Sess,Staff,30,28,2,0,0
7547,InterAmerican Campus,ACG 2071L - 0023   Managerial Accounting Lab,0023-LAB Twelve Wk,Staff,5,0,5,0,0
7539,Hialeah Campus,ACG 2071L - 0024   Managerial Accounting Lab,0024-LAB Main Sess,Staff,120,70,50,0,0
7554,Hialeah Campus,ACG 2071L - 0025   Managerial Accounting Lab,0025-LAB Eight Wk 2,Staff,120,60,60,0,0
7553,Hialeah Campus,ACG 2071L - 0026   Managerial Accounting Lab,0026-LAB Eight Wk 1,Staff,120,20,100,0,0
7555,West Campus,ACG 2071L - 0027   Managerial Accounting Lab,0027-LAB Eight Wk 2,Staff,30,10,20,0,0
7538,West Campus,ACG 2071L - 0028   Managerial Accounting Lab,0028-LAB Main Sess,Staff,100,37,63,0,0
7563,West Campus,ACG 2071L - 0029   Managerial Accounting Lab,0029-LAB Conversion,Staff,80,0,80,0,0
13073,Medical Campus,OPT 2070L - 0001   Computers For Vision Care,0001-LAB Conversion,Staff,30,28,2,0,0
8532,North Campus,CJL 2062 - 0002   Constitutional Law And Legal Procedure Or Evidence,0002-LEC Twelve Wk,Staff,30,0,30,0,0
8529,North Campus,CJL 2062 - 0003   Constitutional Law And Legal Procedure Or Evidence,0003-LEC Main Sess,Staff,30,0,30,0,0
8530,Wolfson Campus,CJL 2062 - 0004   Constitutional Law And Legal Procedure Or Evidence,0004-LEC Main Sess,Staff,30,27,3,0,0
8533,Wolfson Campus,CJL 2062 - 0005   Constitutional Law And Legal Procedure Or Evidence,0005-LEC Twelve Wk,Staff,40,39,1,0,0
8531,Homestead Campus,CJL 2062 - 0006   Constitutional Law And Legal Procedure Or Evidence,0006-LEC Main Sess,Staff,30,0,30,0,0
12137,North Campus,FSE 2061 - 0001   Thanatology,0001-LEC Main Sess,Staff,30,29,1,0,0
12136,North Campus,FSE 2061 - 0002   Thanatology,0002-LEC Main Sess,Staff,30,28,2,0,0
15261,North Campus,FSE 2060 - 0001   Funeral Directing,0001-LEC Main Sess,Staff,30,17,13,0,0
10803,Medical Campus,OPT 2060 - 0001   Ophthalmic Management Policy & Procedures,0001-LEC 1st Mon Sp,Staff,30,24,6,0,0
5283,North Campus,ARC 2056 - 0001   Computer Aided Architectural Presentation,0001-LEC Main Sess,Staff,30,9,21,0,0
5282,Kendall Campus,ARC 2056 - 0002   Computer Aided Architectural Presentation,0002-LEC Main Sess,Staff,23,7,16,0,0
11980,North Campus,PHY 2054 - 0001   Physics (Without Calculus) 2,0001-LEC Main Sess,Staff,32,17,15,0,0
11981,Kendall Campus,PHY 2054 - 0002   Physics (Without Calculus) 2,0002-LEC Main Sess,Staff,36,9,27,0,0
11985,Kendall Campus,PHY 2054 - 0003   Physics (Without Calculus) 2,0003-LEC Main Sess,Staff,30,12,18,0,0
11983,Wolfson Campus,PHY 2054 - 0004   Physics (Without Calculus) 2,0004-LEC Main Sess,Staff,30,13,17,0,0
11984,Homestead Campus,PHY 2054 - 0005   Physics (Without Calculus) 2,0005-LEC Main Sess,Staff,24,0,24,0,0
11982,InterAmerican Campus,PHY 2054 - 0006   Physics (Without Calculus) 2,0006-LEC Main Sess,Staff,28,20,8,0,0
16928,North Campus,PHY 2054L - 0001   Physics (Without Calculus) 2 Lab,0001-LAB Main Sess,Staff,32,18,14,0,0
16929,Kendall Campus,PHY 2054L - 0002   Physics (Without Calculus) 2 Lab,0002-LAB Main Sess,Staff,16,9,7,0,0
16934,Kendall Campus,PHY 2054L - 0003   Physics (Without Calculus) 2 Lab,0003-LAB 1st Mon Sp,Staff,16,12,4,0,0
16930,Kendall Campus,PHY 2054L - 0004   Physics (Without Calculus) 2 Lab,0004-LAB Main Sess,Staff,16,0,16,0,0
16931,Wolfson Campus,PHY 2054L - 0005   Physics (Without Calculus) 2 Lab,0005-LAB Main Sess,Staff,21,13,8,0,0
16932,Homestead Campus,PHY 2054L - 0006   Physics (Without Calculus) 2 Lab,0006-LAB Main Sess,Staff,24,0,24,0,0
16933,InterAmerican Campus,PHY 2054L - 0007   Physics (Without Calculus) 2 Lab,0007-LAB Main Sess,Staff,20,19,1,0,0
5420,North Campus,CCJ 2053 - 0001   Criminal Justice Ethics And Professionalism,0001-LEC Twelve Wk,Staff,30,14,16,0,0
8914,North Campus,PHY 2053 - 0001   Physics (Without Calculus) 1,0001-LEC Main Sess,Staff,32,31,1,0,0
8915,North Campus,PHY 2053 - 0002   Physics (Without Calculus) 1,0002-LEC Main Sess,Staff,32,25,7,0,0
8916,Kendall Campus,PHY 2053 - 0003   Physics (Without Calculus) 1,0003-LEC Main Sess,Staff,50,47,3,0,0
8917,Kendall Campus,PHY 2053 - 0004   Physics (Without Calculus) 1,0004-LEC Main Sess,Staff,50,39,11,0,0
8918,Wolfson Campus,PHY 2053 - 0005   Physics (Without Calculus) 1,0005-LEC Main Sess,Staff,35,21,14,0,0
8920,Wolfson Campus,PHY 2053 - 0006   Physics (Without Calculus) 1,0006-LEC Weekend,Staff,35,26,9,0,0
8919,InterAmerican Campus,PHY 2053 - 0007   Physics (Without Calculus) 1,0007-LEC Main Sess,Staff,28,27,1,0,0
13081,North Campus,PHY 2053L - 0001   Physics (Without Calculus) 1 Lab,0001-LAB Main Sess,Staff,32,25,7,0,0
13082,North Campus,PHY 2053L - 0002   Physics (Without Calculus) 1 Lab,0002-LAB Main Sess,Staff,32,30,2,0,0
13083,Kendall Campus,PHY 2053L - 0003   Physics (Without Calculus) 1 Lab,0003-LAB Main Sess,Staff,18,17,1,0,0
13084,Kendall Campus,PHY 2053L - 0004   Physics (Without Calculus) 1 Lab,0004-LAB Main Sess,Staff,18,17,1,0,0
13086,Kendall Campus,PHY 2053L - 0006   Physics (Without Calculus) 1 Lab,0006-LAB Main Sess,Staff,18,15,3,0,0
13087,Kendall Campus,PHY 2053L - 0007   Physics (Without Calculus) 1 Lab,0007-LAB Main Sess,Staff,18,16,2,0,0
13089,Wolfson Campus,PHY 2053L - 0008   Physics (Without Calculus) 1 Lab,0008-LAB Main Sess,Staff,24,23,1,0,0
13088,InterAmerican Campus,PHY 2053L - 0010   Physics (Without Calculus) 1 Lab,0010-LAB Main Sess,Staff,20,18,2,0,0
5829,North Campus,ARH 2051 - 0001   Art History 2,0001-LEC Main Sess,Staff,30,25,5,0,0
5830,North Campus,ARH 2051 - 0002   Art History 2,0002-LEC Main Sess,Staff,30,8,22,0,0
5831,Kendall Campus,ARH 2051 - 0003   Art History 2,0003-LEC Main Sess,Staff,38,26,12,0,0
5835,Kendall Campus,ARH 2051 - 0004   Art History 2,0004-LEC Main Sess,Staff,40,19,21,0,0
5833,Wolfson Campus,ARH 2051 - 0005   Art History 2,0005-LEC Main Sess,Staff,40,26,14,0,0
5832,Homestead Campus,ARH 2051 - 0007   Art History 2,0007-LEC Main Sess,Staff,39,13,26,0,0
6047,North Campus,ARH 2050 - 0001   Art History 1,0001-LEC Main Sess,Staff,30,26,4,0,0
6048,Kendall Campus,ARH 2050 - 0002   Art History 1,0002-LEC Main Sess,Staff,38,35,3,0,0
6049,Kendall Campus,ARH 2050 - 0003   Art History 1,0003-LEC Main Sess,Staff,38,34,4,0,0
6050,West Campus,ARH 2050 - 0004   Art History 1,0004-LEC Conversion,Staff,35,10,25,0,0
9791,Kendall Campus,PSY 2050 - 0001   Introduction To Forensic Psychology,0001-LEC Eight Wk 1,Staff,30,0,30,0,0
9790,Kendall Campus,PSY 2050 - 0003   Introduction To Forensic Psychology,0003-LEC Main Sess,Staff,36,0,36,0,0
5848,Medical Campus,ATE 2050L - 0001   Animal Nursing & Medicine Laboratory 2,0001-LAB Main Sess,Staff,6,4,2,0,0
8767,North Campus,PHY 2049 - 0001   Physics With Calculus 2,0001-LEC Main Sess,Staff,32,25,7,0,0
8769,Kendall Campus,PHY 2049 - 0003   Physics With Calculus 2,0003-LEC Main Sess,Staff,36,34,2,0,0
8771,Wolfson Campus,PHY 2049 - 0005   Physics With Calculus 2,0005-LEC Main Sess,Staff,35,23,12,0,0
8772,Homestead Campus,PHY 2049 - 0006   Physics With Calculus 2,0006-LEC Main Sess,Staff,15,0,15,0,0
8773,InterAmerican Campus,PHY 2049 - 0007   Physics With Calculus 2,0007-LEC Main Sess,Staff,28,27,1,0,0
8770,InterAmerican Campus,PHY 2049 - 0008   Physics With Calculus 2,0008-LEC Main Sess,Staff,28,18,10,0,0
9760,North Campus,PHY 2049L - 0001   Physics With Calculus 2 Lab,0001-LAB Main Sess,Staff,32,25,7,0,0
9762,Kendall Campus,PHY 2049L - 0003   Physics With Calculus 2 Lab,0003-LAB Main Sess,Staff,24,22,2,0,0
9763,Kendall Campus,PHY 2049L - 0004   Physics With Calculus 2 Lab,0004-LAB Main Sess,Staff,16,0,16,0,0
9771,Kendall Campus,PHY 2049L - 0005   Physics With Calculus 2 Lab,0005-LAB Main Sess,Staff,16,8,8,0,0
9765,Kendall Campus,PHY 2049L - 0007   Physics With Calculus 2 Lab,0007-LAB Main Sess,Staff,16,0,16,0,0
9772,Wolfson Campus,PHY 2049L - 0008   Physics With Calculus 2 Lab,0008-LAB Main Sess,Staff,26,25,1,0,0
9766,Homestead Campus,PHY 2049L - 0010   Physics With Calculus 2 Lab,0010-LAB Main Sess,Staff,24,0,24,0,0
9768,Homestead Campus,PHY 2049L - 0011   Physics With Calculus 2 Lab,0011-LAB Main Sess,Staff,24,0,24,0,0
9770,InterAmerican Campus,PHY 2049L - 0013   Physics With Calculus 2 Lab,0013-LAB Main Sess,Staff,20,19,1,0,0
10819,North Campus,PHY 2048 - 0001   Physics With Calculus 1,0001-LEC Twelve Wk,Staff,32,10,22,0,0
10811,Kendall Campus,PHY 2048 - 0004   Physics With Calculus 1,0004-LEC Main Sess,Staff,49,32,17,0,0
10813,Kendall Campus,PHY 2048 - 0006   Physics With Calculus 1,0006-LEC Main Sess,Staff,30,29,1,0,0
10815,Wolfson Campus,PHY 2048 - 0008   Physics With Calculus 1,0008-LEC Main Sess,Staff,34,32,2,0,0
10816,Wolfson Campus,PHY 2048 - 0009   Physics With Calculus 1,0009-LEC Main Sess,Staff,35,23,12,0,0
10817,Homestead Campus,PHY 2048 - 0010   Physics With Calculus 1,0010-LEC Main Sess,Staff,1,0,1,0,0
10818,InterAmerican Campus,PHY 2048 - 0011   Physics With Calculus 1,0011-LEC Main Sess,Staff,28,27,1,0,0
12384,North Campus,PHY 2048L - 0001   Physics With Calculus 1 Lab,0001-LAB Main Sess,Staff,32,31,1,0,0
12394,North Campus,PHY 2048L - 0002   Physics With Calculus 1 Lab,0002-LAB Twelve Wk,Staff,32,13,19,0,0
12385,North Campus,PHY 2048L - 0003   Physics With Calculus 1 Lab,0003-LAB Main Sess,Staff,32,29,3,0,0
12393,Kendall Campus,PHY 2048L - 0004   Physics With Calculus 1 Lab,0004-LAB Main Sess,Staff,24,14,10,0,0
12386,Kendall Campus,PHY 2048L - 0007   Physics With Calculus 1 Lab,0007-LAB Main Sess,Staff,24,21,3,0,0
12387,Kendall Campus,PHY 2048L - 0008   Physics With Calculus 1 Lab,0008-LAB Main Sess,Staff,24,19,5,0,0
12391,Wolfson Campus,PHY 2048L - 0011   Physics With Calculus 1 Lab,0011-LAB Main Sess,Staff,26,24,2,0,0
13104,North Campus,POS 2041 - 0001   American Federal Government,0001-LEC Main Sess,Staff,40,38,2,0,0
13105,North Campus,POS 2041 - 0002   American Federal Government,0002-LEC Main Sess,Staff,40,38,2,0,0
13112,North Campus,POS 2041 - 0003   American Federal Government,0003-LEC Main Sess,Staff,40,36,4,0,0
13113,North Campus,POS 2041 - 0004   American Federal Government,0004-LEC Main Sess,Staff,40,37,3,0,0
13114,North Campus,POS 2041 - 0006   American Federal Government,0006-LEC Main Sess,Staff,40,36,4,0,0
13115,North Campus,POS 2041 - 0007   American Federal Government,0007-LEC Main Sess,Staff,25,19,6,0,0
13116,Kendall Campus,POS 2041 - 0008   American Federal Government,0008-LEC Main Sess,Staff,48,46,2,0,0
13117,Kendall Campus,POS 2041 - 0009   American Federal Government,0009-LEC Main Sess,Staff,47,45,2,0,0
13118,Kendall Campus,POS 2041 - 0010   American Federal Government,0010-LEC Main Sess,Staff,49,48,1,0,0
13120,Kendall Campus,POS 2041 - 0012   American Federal Government,0012-LEC Main Sess,Staff,25,18,7,0,0
13121,Kendall Campus,POS 2041 - 0013   American Federal Government,0013-LEC Main Sess,Staff,40,0,40,0,0
13122,Kendall Campus,POS 2041 - 0014   American Federal Government,0014-LEC Main Sess,Staff,40,30,10,0,0
13123,Kendall Campus,POS 2041 - 0015   American Federal Government,0015-LEC Main Sess,Staff,25,22,3,0,0
13124,Kendall Campus,POS 2041 - 0016   American Federal Government,0016-LEC Main Sess,Staff,30,0,30,0,0
13125,Kendall Campus,POS 2041 - 0017   American Federal Government,0017-LEC Main Sess,Staff,36,34,2,0,0
13126,Kendall Campus,POS 2041 - 0018   American Federal Government,0018-LEC Main Sess,Staff,40,39,1,0,0
13127,Wolfson Campus,POS 2041 - 0020   American Federal Government,0020-LEC Main Sess,Staff,47,44,3,0,0
13128,Wolfson Campus,POS 2041 - 0021   American Federal Government,0021-LEC Main Sess,Staff,47,0,47,0,0
13129,Wolfson Campus,POS 2041 - 0022   American Federal Government,0022-LEC Main Sess,Staff,45,43,2,0,0
13130,Wolfson Campus,POS 2041 - 0023   American Federal Government,0023-LEC Main Sess,Staff,45,41,4,0,0
13131,Wolfson Campus,POS 2041 - 0024   American Federal Government,0024-LEC Main Sess,Staff,30,26,4,0,0
13132,Wolfson Campus,POS 2041 - 0025   American Federal Government,0025-LEC Main Sess,Staff,30,22,8,0,0
13143,Wolfson Campus,POS 2041 - 0026   American Federal Government,0026-LEC Conversion,Staff,34,28,6,0,0
13142,Wolfson Campus,POS 2041 - 0027   American Federal Government,0027-LEC Conversion,Staff,34,0,34,0,0
13133,Wolfson Campus,POS 2041 - 0028   American Federal Government,0028-LEC Main Sess,Staff,30,29,1,0,0
13141,Wolfson Campus,POS 2041 - 0030   American Federal Government,0030-LEC Conversion,Staff,30,28,2,0,0
13140,Wolfson Campus,POS 2041 - 0031   American Federal Government,0031-LEC Conversion,Staff,34,0,34,0,0
13135,InterAmerican Campus,POS 2041 - 0032   American Federal Government,0032-LEC Main Sess,Staff,37,0,37,0,0
13136,InterAmerican Campus,POS 2041 - 0033   American Federal Government,0033-LEC Main Sess,Staff,40,22,18,0,0
13137,Hialeah Campus,POS 2041 - 0034   American Federal Government,0034-LEC Main Sess,Staff,35,26,9,0,0
13111,Hialeah Campus,POS 2041 - 0035   American Federal Government,0035-LEC Main Sess,Staff,33,15,18,0,0
13110,Hialeah Campus,POS 2041 - 0036   American Federal Government,0036-LEC Main Sess,Staff,30,28,2,0,0
13109,Hialeah Campus,POS 2041 - 0037   American Federal Government,0037-LEC Main Sess,Staff,32,28,4,0,0
13108,Hialeah Campus,POS 2041 - 0038   American Federal Government,0038-LEC Main Sess,Staff,36,31,5,0,0
13107,Hialeah Campus,POS 2041 - 0039   American Federal Government,0039-LEC Main Sess,Staff,30,0,30,0,0
13144,West Campus,POS 2041 - 0040   American Federal Government,0040-LEC Conversion,Staff,35,25,10,0,0
13106,West Campus,POS 2041 - 0041   American Federal Government,0041-LEC Main Sess,Staff,35,34,1,0,0
8075,North Campus,EME 2040 - 0001   Introduction To Technology For Educators,0001-LEC Main Sess,Staff,30,28,2,0,0
8077,Kendall Campus,EME 2040 - 0003   Introduction To Technology For Educators,0003-LEC Main Sess,Staff,30,29,1,0,0
8078,Wolfson Campus,EME 2040 - 0004   Introduction To Technology For Educators,0004-LEC Main Sess,Staff,30,20,10,0,0
8080,Wolfson Campus,EME 2040 - 0006   Introduction To Technology For Educators,0006-LEC Main Sess,Staff,30,26,4,0,0
8081,Wolfson Campus,EME 2040 - 0007   Introduction To Technology For Educators,0007-LEC Main Sess,Staff,30,26,4,0,0
8082,Homestead Campus,EME 2040 - 0008   Introduction To Technology For Educators,0008-LEC Main Sess,Staff,25,23,2,0,0
8083,Homestead Campus,EME 2040 - 0009   Introduction To Technology For Educators,0009-LEC Main Sess,Staff,25,12,13,0,0
8084,InterAmerican Campus,EME 2040 - 0010   Introduction To Technology For Educators,0010-LEC Main Sess,Staff,21,15,6,0,0
8085,InterAmerican Campus,EME 2040 - 0011   Introduction To Technology For Educators,0011-LEC Main Sess,Staff,25,14,11,0,0
8088,InterAmerican Campus,EME 2040 - 0012   Introduction To Technology For Educators,0012-LEC 1st Mon Sp,Staff,21,15,6,0,0
8086,InterAmerican Campus,EME 2040 - 0013   Introduction To Technology For Educators,0013-LEC Main Sess,Staff,25,11,14,0,0
8087,InterAmerican Campus,EME 2040 - 0014   Introduction To Technology For Educators,0014-LEC Main Sess,Staff,25,20,5,0,0
12002,North Campus,REE 2040 - 0001   Real Estate Principles And Practices (P&P 1),0001-LEC Main Sess,Staff,25,10,15,0,0
12005,Kendall Campus,REE 2040 - 0002   Real Estate Principles And Practices (P&P 1),0002-LEC Main Sess,Staff,25,7,18,0,0
12004,Wolfson Campus,REE 2040 - 0003   Real Estate Principles And Practices (P&P 1),0003-LEC Main Sess,Staff,25,23,2,0,0
12003,Wolfson Campus,REE 2040 - 0004   Real Estate Principles And Practices (P&P 1),0004-LEC Main Sess,Staff,25,0,25,0,0
11977,Wolfson Campus,PCB 2033 - 0001   Introduction To Ecology,0001-LEC Main Sess,Staff,30,24,6,0,0
11330,Wolfson Campus,EUH 2032 - 0001   History Of The Holocaust,0001-LEC Main Sess,Staff,30,17,13,0,0
11329,Homestead Campus,EUH 2032 - 0002   History Of The Holocaust,0002-LEC Main Sess,Staff,39,31,8,0,0
6627,Wolfson Campus,ACG 2031 - 0001   Accounting Theory,0001-LEC Conversion,Staff,30,29,1,0,0
7833,Kendall Campus,MUN 2030 - 0001   Performance Lab,0001-LEC Main Sess,Staff,25,3,22,0,0
9275,North Campus,ECO 2023 - 0001   Principles Of Economics (Micro),0001-LEC Main Sess,Staff,20,13,7,0,0
9276,North Campus,ECO 2023 - 0002   Principles Of Economics (Micro),0002-LEC Main Sess,Staff,40,0,40,0,0
9291,North Campus,ECO 2023 - 0003   Principles Of Economics (Micro),0003-LEC Main Sess,Staff,40,17,23,0,0
9292,North Campus,ECO 2023 - 0004   Principles Of Economics (Micro),0004-LEC Main Sess,Staff,40,34,6,0,0
9316,North Campus,ECO 2023 - 0005   Principles Of Economics (Micro),0005-LEC Twelve Wk,Staff,40,14,26,0,0
9293,North Campus,ECO 2023 - 0006   Principles Of Economics (Micro),0006-LEC Main Sess,Staff,40,38,2,0,0
9315,North Campus,ECO 2023 - 0007   Principles Of Economics (Micro),0007-LEC Twelve Wk,Staff,45,32,13,0,0
9325,North Campus,ECO 2023 - 0008   Principles Of Economics (Micro),0008-LEC Eight Wk 2,Staff,40,16,24,0,0
9294,North Campus,ECO 2023 - 0009   Principles Of Economics (Micro),0009-LEC Main Sess,Staff,40,39,1,0,0
9295,North Campus,ECO 2023 - 0010   Principles Of Economics (Micro),0010-LEC Main Sess,Staff,45,40,5,0,0
9296,North Campus,ECO 2023 - 0011   Principles Of Economics (Micro),0011-LEC Main Sess,Staff,40,0,40,0,0
9317,North Campus,ECO 2023 - 0012   Principles Of Economics (Micro),0012-LEC Twelve Wk,Staff,40,0,40,0,0
9297,Kendall Campus,ECO 2023 - 0013   Principles Of Economics (Micro),0013-LEC Main Sess,Staff,40,30,10,0,0
9300,Kendall Campus,ECO 2023 - 0016   Principles Of Economics (Micro),0016-LEC Main Sess,Staff,45,41,4,0,0
9301,Kendall Campus,ECO 2023 - 0017   Principles Of Economics (Micro),0017-LEC Main Sess,Staff,45,44,1,0,0
9302,Kendall Campus,ECO 2023 - 0018   Principles Of Economics (Micro),0018-LEC Main Sess,Staff,45,35,10,0,0
9303,Kendall Campus,ECO 2023 - 0019   Principles Of Economics (Micro),0019-LEC Main Sess,Staff,35,32,3,0,0
9304,Kendall Campus,ECO 2023 - 0020   Principles Of Economics (Micro),0020-LEC Main Sess,Staff,45,14,31,0,0
9305,Kendall Campus,ECO 2023 - 0021   Principles Of Economics (Micro),0021-LEC Main Sess,Staff,45,44,1,0,0
9306,Kendall Campus,ECO 2023 - 0022   Principles Of Economics (Micro),0022-LEC Main Sess,Staff,49,48,1,0,0
9307,Kendall Campus,ECO 2023 - 0023   Principles Of Economics (Micro),0023-LEC Main Sess,Staff,36,14,22,0,0
9308,Kendall Campus,ECO 2023 - 0024   Principles Of Economics (Micro),0024-LEC Main Sess,Staff,45,38,7,0,0
9309,Kendall Campus,ECO 2023 - 0025   Principles Of Economics (Micro),0025-LEC Main Sess,Staff,11,0,11,0,0
9329,Kendall Campus,ECO 2023 - 0027   Principles Of Economics (Micro),0027-LEC Weekend,Staff,36,0,36,0,0
9311,Wolfson Campus,ECO 2023 - 0028   Principles Of Economics (Micro),0028-LEC Main Sess,Staff,40,37,3,0,0
9313,Wolfson Campus,ECO 2023 - 0030   Principles Of Economics (Micro),0030-LEC Main Sess,Staff,30,27,3,0,0
9327,Wolfson Campus,ECO 2023 - 0031   Principles Of Economics (Micro),0031-LEC 1st Mon Sp,Staff,45,25,20,0,0
9326,Wolfson Campus,ECO 2023 - 0032   Principles Of Economics (Micro),0032-LEC Conversion,Staff,30,28,2,0,0
9314,Wolfson Campus,ECO 2023 - 0033   Principles Of Economics (Micro),0033-LEC Main Sess,Staff,30,26,4,0,0
9290,Wolfson Campus,ECO 2023 - 0034   Principles Of Economics (Micro),0034-LEC Main Sess,Staff,30,25,5,0,0
9289,Wolfson Campus,ECO 2023 - 0035   Principles Of Economics (Micro),0035-LEC Main Sess,Staff,30,29,1,0,0
9288,Wolfson Campus,ECO 2023 - 0036   Principles Of Economics (Micro),0036-LEC Main Sess,Staff,30,27,3,0,0
9287,Wolfson Campus,ECO 2023 - 0037   Principles Of Economics (Micro),0037-LEC Main Sess,Staff,30,24,6,0,0
9286,Wolfson Campus,ECO 2023 - 0038   Principles Of Economics (Micro),0038-LEC Main Sess,Staff,30,27,3,0,0
9285,Homestead Campus,ECO 2023 - 0039   Principles Of Economics (Micro),0039-LEC Main Sess,Staff,35,0,35,0,0
9284,Homestead Campus,ECO 2023 - 0040   Principles Of Economics (Micro),0040-LEC Main Sess,Staff,35,14,21,0,0
9322,Homestead Campus,ECO 2023 - 0041   Principles Of Economics (Micro),0041-LEC Eight Wk 2,Staff,35,5,30,0,0
9320,Homestead Campus,ECO 2023 - 0042   Principles Of Economics (Micro),0042-LEC Eight Wk 1,Staff,35,15,20,0,0
9283,InterAmerican Campus,ECO 2023 - 0044   Principles Of Economics (Micro),0044-LEC Main Sess,Staff,29,24,5,0,0
9282,InterAmerican Campus,ECO 2023 - 0045   Principles Of Economics (Micro),0045-LEC Main Sess,Staff,35,33,2,0,0
9318,InterAmerican Campus,ECO 2023 - 0046   Principles Of Economics (Micro),0046-LEC Twelve Wk,Staff,30,18,12,0,0
9319,Hialeah Campus,ECO 2023 - 0047   Principles Of Economics (Micro),0047-LEC Eight Wk 1,Staff,25,0,25,0,0
9323,Hialeah Campus,ECO 2023 - 0048   Principles Of Economics (Micro),0048-LEC Eight Wk 2,Staff,30,12,18,0,0
9324,Hialeah Campus,ECO 2023 - 0049   Principles Of Economics (Micro),0049-LEC Eight Wk 2,Staff,30,28,2,0,0
9328,Hialeah Campus,ECO 2023 - 0050   Principles Of Economics (Micro),0050-LEC 1st Mon Sp,Staff,30,0,30,0,0
9281,Hialeah Campus,ECO 2023 - 0051   Principles Of Economics (Micro),0051-LEC Main Sess,Staff,25,22,3,0,0
9280,West Campus,ECO 2023 - 0052   Principles Of Economics (Micro),0052-LEC Main Sess,Staff,35,20,15,0,0
9279,West Campus,ECO 2023 - 0053   Principles Of Economics (Micro),0053-LEC Main Sess,Staff,35,0,35,0,0
9278,West Campus,ECO 2023 - 0054   Principles Of Economics (Micro),0054-LEC Main Sess,Staff,35,33,2,0,0
9277,West Campus,ECO 2023 - 0055   Principles Of Economics (Micro),0055-LEC Main Sess,Staff,35,26,9,0,0
11742,North Campus,STA 2023 - 0001   Statistical Methods,0001-LEC Main Sess,Staff,40,21,19,0,0
11743,North Campus,STA 2023 - 0002   Statistical Methods,0002-LEC Main Sess,Staff,40,38,2,0,0
11745,North Campus,STA 2023 - 0004   Statistical Methods,0004-LEC Main Sess,Staff,40,30,10,0,0
11869,North Campus,STA 2023 - 0005   Statistical Methods,0005-LEC Weekend,Staff,40,25,15,0,0
11746,North Campus,STA 2023 - 0006   Statistical Methods,0006-LEC Main Sess,Staff,40,39,1,0,0
11747,North Campus,STA 2023 - 0007   Statistical Methods,0007-LEC Main Sess,Staff,40,26,14,0,0
11748,North Campus,STA 2023 - 0008   Statistical Methods,0008-LEC Main Sess,Staff,40,38,2,0,0
11749,North Campus,STA 2023 - 0009   Statistical Methods,0009-LEC Main Sess,Staff,40,38,2,0,0
11850,North Campus,STA 2023 - 0010   Statistical Methods,0010-LEC Twelve Wk,Staff,40,39,1,0,0
11860,North Campus,STA 2023 - 0012   Statistical Methods,0012-LEC Conversion,Staff,30,27,3,0,0
11751,North Campus,STA 2023 - 0013   Statistical Methods,0013-LEC Main Sess,Staff,40,36,4,0,0
11753,North Campus,STA 2023 - 0015   Statistical Methods,0015-LEC Main Sess,Staff,40,26,14,0,0
11841,North Campus,STA 2023 - 0016   Statistical Methods,0016-LEC Main Sess,Staff,40,36,4,0,0
11754,North Campus,STA 2023 - 0017   Statistical Methods,0017-LEC Main Sess,Staff,20,19,1,0,0
11755,North Campus,STA 2023 - 0018   Statistical Methods,0018-LEC Main Sess,Staff,40,0,40,0,0
11756,North Campus,STA 2023 - 0019   Statistical Methods,0019-LEC Main Sess,Staff,40,34,6,0,0
11859,North Campus,STA 2023 - 0020   Statistical Methods,0020-LEC Eight Wk 2,Staff,40,38,2,0,0
11757,North Campus,STA 2023 - 0023   Statistical Methods,0023-LEC Main Sess,Staff,40,24,16,0,0
11758,Kendall Campus,STA 2023 - 0024   Statistical Methods,0024-LEC Main Sess,Staff,49,47,2,0,0
11759,Kendall Campus,STA 2023 - 0025   Statistical Methods,0025-LEC Main Sess,Staff,38,37,1,0,0
11760,Kendall Campus,STA 2023 - 0026   Statistical Methods,0026-LEC Main Sess,Staff,110,106,4,0,0
11761,Kendall Campus,STA 2023 - 0027   Statistical Methods,0027-LEC Main Sess,Staff,49,42,7,0,0
11762,Kendall Campus,STA 2023 - 0028   Statistical Methods,0028-LEC Main Sess,Staff,40,35,5,0,0
11763,Kendall Campus,STA 2023 - 0029   Statistical Methods,0029-LEC Main Sess,Staff,39,0,39,0,0
11861,Kendall Campus,STA 2023 - 0030   Statistical Methods,0030-LEC Conversion,Staff,38,37,1,0,0
11849,Kendall Campus,STA 2023 - 0031   Statistical Methods,0031-LEC Twelve Wk,Staff,49,46,3,0,0
11852,Kendall Campus,STA 2023 - 0032   Statistical Methods,0032-LEC Eight Wk 1,Staff,30,0,30,0,0
11858,Kendall Campus,STA 2023 - 0033   Statistical Methods,0033-LEC Eight Wk 2,Staff,40,36,4,0,0
11764,Kendall Campus,STA 2023 - 0034   Statistical Methods,0034-LEC Main Sess,Staff,39,37,2,0,0
11765,Kendall Campus,STA 2023 - 0035   Statistical Methods,0035-LEC Main Sess,Staff,40,0,40,0,0
11766,Kendall Campus,STA 2023 - 0036   Statistical Methods,0036-LEC Main Sess,Staff,49,42,7,0,0
11767,Kendall Campus,STA 2023 - 0037   Statistical Methods,0037-LEC Main Sess,Staff,49,46,3,0,0
11768,Kendall Campus,STA 2023 - 0038   Statistical Methods,0038-LEC Main Sess,Staff,49,48,1,0,0
11769,Kendall Campus,STA 2023 - 0039   Statistical Methods,0039-LEC Main Sess,Staff,110,107,3,0,0
11770,Kendall Campus,STA 2023 - 0040   Statistical Methods,0040-LEC Main Sess,Staff,39,26,13,0,0
11772,Kendall Campus,STA 2023 - 0042   Statistical Methods,0042-LEC Main Sess,Staff,40,12,28,0,0
11774,Kendall Campus,STA 2023 - 0044   Statistical Methods,0044-LEC Main Sess,Staff,45,36,9,0,0
11775,Kendall Campus,STA 2023 - 0045   Statistical Methods,0045-LEC Main Sess,Staff,27,26,1,0,0
11777,Kendall Campus,STA 2023 - 0047   Statistical Methods,0047-LEC Main Sess,Staff,110,108,2,0,0
11870,Kendall Campus,STA 2023 - 0049   Statistical Methods,0049-LEC Weekend,Staff,49,27,22,0,0
11779,Kendall Campus,STA 2023 - 0050   Statistical Methods,0050-LEC Main Sess,Staff,49,48,1,0,0
11780,Kendall Campus,STA 2023 - 0051   Statistical Methods,0051-LEC Main Sess,Staff,49,44,5,0,0
11781,Kendall Campus,STA 2023 - 0052   Statistical Methods,0052-LEC Main Sess,Staff,39,37,2,0,0
11782,Kendall Campus,STA 2023 - 0053   Statistical Methods,0053-LEC Main Sess,Staff,39,37,2,0,0
11783,Kendall Campus,STA 2023 - 0054   Statistical Methods,0054-LEC Main Sess,Staff,40,0,40,0,0
11785,Kendall Campus,STA 2023 - 0056   Statistical Methods,0056-LEC Main Sess,Staff,49,23,26,0,0
11786,Kendall Campus,STA 2023 - 0057   Statistical Methods,0057-LEC Main Sess,Staff,30,0,30,0,0
11787,Kendall Campus,STA 2023 - 0058   Statistical Methods,0058-LEC Main Sess,Staff,38,0,38,0,0
11868,Kendall Campus,STA 2023 - 0060   Statistical Methods,0060-LEC Weekend,Staff,40,0,40,0,0
11848,Kendall Campus,STA 2023 - 0061   Statistical Methods,0061-LEC Twelve Wk,Staff,45,0,45,0,0
11789,Wolfson Campus,STA 2023 - 0062   Statistical Methods,0062-LEC Main Sess,Staff,38,36,2,0,0
11791,Wolfson Campus,STA 2023 - 0064   Statistical Methods,0064-LEC Main Sess,Staff,38,26,12,0,0
11865,Wolfson Campus,STA 2023 - 0065   Statistical Methods,0065-LEC Conversion,Staff,20,0,20,0,0
11792,Wolfson Campus,STA 2023 - 0066   Statistical Methods,0066-LEC Main Sess,Staff,37,33,4,0,0
11795,Wolfson Campus,STA 2023 - 0069   Statistical Methods,0069-LEC Main Sess,Staff,38,36,2,0,0
11796,Wolfson Campus,STA 2023 - 0070   Statistical Methods,0070-LEC Main Sess,Staff,38,37,1,0,0
11797,Wolfson Campus,STA 2023 - 0071   Statistical Methods,0071-LEC Main Sess,Staff,38,36,2,0,0
11846,Wolfson Campus,STA 2023 - 0073   Statistical Methods,0073-LEC Twelve Wk,Staff,38,36,2,0,0
11857,Wolfson Campus,STA 2023 - 0074   Statistical Methods,0074-LEC Eight Wk 2,Staff,35,0,35,0,0
11798,Wolfson Campus,STA 2023 - 0075   Statistical Methods,0075-LEC Main Sess,Staff,38,35,3,0,0
11799,Wolfson Campus,STA 2023 - 0076   Statistical Methods,0076-LEC Main Sess,Staff,38,35,3,0,0
11800,Wolfson Campus,STA 2023 - 0077   Statistical Methods,0077-LEC Main Sess,Staff,38,0,38,0,0
11801,Wolfson Campus,STA 2023 - 0078   Statistical Methods,0078-LEC Main Sess,Staff,37,34,3,0,0
11866,Wolfson Campus,STA 2023 - 0079   Statistical Methods,0079-LEC 1st Mon Sp,Staff,35,32,3,0,0
11802,Wolfson Campus,STA 2023 - 0080   Statistical Methods,0080-LEC Main Sess,Staff,30,24,6,0,0
11803,Wolfson Campus,STA 2023 - 0081   Statistical Methods,0081-LEC Main Sess,Staff,30,29,1,0,0
11804,Wolfson Campus,STA 2023 - 0082   Statistical Methods,0082-LEC Main Sess,Staff,30,25,5,0,0
11805,Wolfson Campus,STA 2023 - 0083   Statistical Methods,0083-LEC Main Sess,Staff,30,25,5,0,0
11806,Wolfson Campus,STA 2023 - 0084   Statistical Methods,0084-LEC Main Sess,Staff,30,28,2,0,0
11807,Wolfson Campus,STA 2023 - 0085   Statistical Methods,0085-LEC Main Sess,Staff,30,26,4,0,0
11808,Wolfson Campus,STA 2023 - 0086   Statistical Methods,0086-LEC Main Sess,Staff,30,28,2,0,0
11809,Wolfson Campus,STA 2023 - 0087   Statistical Methods,0087-LEC Main Sess,Staff,30,23,7,0,0
11810,Wolfson Campus,STA 2023 - 0088   Statistical Methods,0088-LEC Main Sess,Staff,30,23,7,0,0
11811,Wolfson Campus,STA 2023 - 0089   Statistical Methods,0089-LEC Main Sess,Staff,30,25,5,0,0
11812,Wolfson Campus,STA 2023 - 0090   Statistical Methods,0090-LEC Main Sess,Staff,30,27,3,0,0
11813,Wolfson Campus,STA 2023 - 0091   Statistical Methods,0091-LEC Main Sess,Staff,30,27,3,0,0
11814,Wolfson Campus,STA 2023 - 0092   Statistical Methods,0092-LEC Main Sess,Staff,30,26,4,0,0
11815,Wolfson Campus,STA 2023 - 0093   Statistical Methods,0093-LEC Main Sess,Staff,30,25,5,0,0
11816,Wolfson Campus,STA 2023 - 0094   Statistical Methods,0094-LEC Main Sess,Staff,30,25,5,0,0
11817,Wolfson Campus,STA 2023 - 0095   Statistical Methods,0095-LEC Main Sess,Staff,30,28,2,0,0
11818,Wolfson Campus,STA 2023 - 0096   Statistical Methods,0096-LEC Main Sess,Staff,30,24,6,0,0
11819,Homestead Campus,STA 2023 - 0097   Statistical Methods,0097-LEC Main Sess,Staff,35,34,1,0,0
11821,Homestead Campus,STA 2023 - 0099   Statistical Methods,0099-LEC Main Sess,Staff,30,27,3,0,0
11822,Homestead Campus,STA 2023 - 0100   Statistical Methods,0100-LEC Main Sess,Staff,35,34,1,0,0
11863,Homestead Campus,STA 2023 - 0101   Statistical Methods,0101-LEC Conversion,Staff,35,29,6,0,0
11823,Homestead Campus,STA 2023 - 0102   Statistical Methods,0102-LEC Main Sess,Staff,35,33,2,0,0
11824,InterAmerican Campus,STA 2023 - 0103   Statistical Methods,0103-LEC Main Sess,Staff,37,34,3,0,0
11825,InterAmerican Campus,STA 2023 - 0104   Statistical Methods,0104-LEC Main Sess,Staff,20,19,1,0,0
11845,InterAmerican Campus,STA 2023 - 0105   Statistical Methods,0105-LEC Twelve Wk,Staff,30,0,30,0,0
11826,InterAmerican Campus,STA 2023 - 0106   Statistical Methods,0106-LEC Main Sess,Staff,37,36,1,0,0
11827,InterAmerican Campus,STA 2023 - 0107   Statistical Methods,0107-LEC Main Sess,Staff,37,31,6,0,0
11851,InterAmerican Campus,STA 2023 - 0108   Statistical Methods,0108-LEC Eight Wk 1,Staff,30,23,7,0,0
11856,InterAmerican Campus,STA 2023 - 0109   Statistical Methods,0109-LEC Eight Wk 2,Staff,30,21,9,0,0
11829,InterAmerican Campus,STA 2023 - 0111   Statistical Methods,0111-LEC Main Sess,Staff,37,34,3,0,0
11843,InterAmerican Campus,STA 2023 - 0112   Statistical Methods,0112-LEC Main Sess,Staff,37,35,2,0,0
11855,InterAmerican Campus,STA 2023 - 0113   Statistical Methods,0113-LEC Eight Wk 2,Staff,30,25,5,0,0
11854,InterAmerican Campus,STA 2023 - 0114   Statistical Methods,0114-LEC Eight Wk 2,Staff,30,29,1,0,0
11830,InterAmerican Campus,STA 2023 - 0115   Statistical Methods,0115-LEC Main Sess,Staff,37,0,37,0,0
11853,InterAmerican Campus,STA 2023 - 0116   Statistical Methods,0116-LEC Eight Wk 2,Staff,30,0,30,0,0
11864,InterAmerican Campus,STA 2023 - 0117   Statistical Methods,0117-LEC Conversion,Staff,35,33,2,0,0
11831,Hialeah Campus,STA 2023 - 0118   Statistical Methods,0118-LEC Main Sess,Staff,30,12,18,0,0
11832,Hialeah Campus,STA 2023 - 0119   Statistical Methods,0119-LEC Main Sess,Staff,30,27,3,0,0
11833,Hialeah Campus,STA 2023 - 0120   Statistical Methods,0120-LEC Main Sess,Staff,30,28,2,0,0
11844,Hialeah Campus,STA 2023 - 0121   Statistical Methods,0121-LEC Main Sess,Staff,35,32,3,0,0
11834,Hialeah Campus,STA 2023 - 0122   Statistical Methods,0122-LEC Main Sess,Staff,33,32,1,0,0
11835,Hialeah Campus,STA 2023 - 0123   Statistical Methods,0123-LEC Main Sess,Staff,38,32,6,0,0
11867,Hialeah Campus,STA 2023 - 0124   Statistical Methods,0124-LEC Weekend,Staff,32,27,5,0,0
11837,Hialeah Campus,STA 2023 - 0126   Statistical Methods,0126-LEC Main Sess,Staff,35,33,2,0,0
11838,Hialeah Campus,STA 2023 - 0127   Statistical Methods,0127-LEC Main Sess,Staff,35,25,10,0,0
11839,West Campus,STA 2023 - 0128   Statistical Methods,0128-LEC Main Sess,Staff,35,33,2,0,0
11840,West Campus,STA 2023 - 0129   Statistical Methods,0129-LEC Main Sess,Staff,35,16,19,0,0
8295,Kendall Campus,ENL 2022 - 0001   English Literature 2,0001-LEC Main Sess,Staff,28,0,28,0,0
15793,Kendall Campus,WOH 2022 - 0001   History Of World Civilization From 1789,0001-LEC Main Sess,Staff,45,41,4,0,0
15794,Kendall Campus,WOH 2022 - 0002   History Of World Civilization From 1789,0002-LEC Main Sess,Staff,45,26,19,0,0
15798,Kendall Campus,WOH 2022 - 0003   History Of World Civilization From 1789,0003-LEC Main Sess,Staff,45,12,33,0,0
15796,Wolfson Campus,WOH 2022 - 0004   History Of World Civilization From 1789,0004-LEC Main Sess,Staff,47,19,28,0,0
15797,InterAmerican Campus,WOH 2022 - 0005   History Of World Civilization From 1789,0005-LEC Main Sess,Staff,25,7,18,0,0
15795,InterAmerican Campus,WOH 2022 - 0006   History Of World Civilization From 1789,0006-LEC Main Sess,Staff,10,8,2,0,0
6506,North Campus,ACG 2021 - 0001   Financial Accounting,0001-LEC Main Sess,Staff,40,38,2,0,0
6545,North Campus,ACG 2021 - 0002   Financial Accounting,0002-LEC Eight Wk 1,Staff,35,19,16,0,0
6560,North Campus,ACG 2021 - 0003   Financial Accounting,0003-LEC Conversion,Staff,35,23,12,0,0
6507,North Campus,ACG 2021 - 0004   Financial Accounting,0004-LEC Main Sess,Staff,35,34,1,0,0
6563,North Campus,ACG 2021 - 0005   Financial Accounting,0005-LEC Conversion,Staff,35,0,35,0,0
6552,North Campus,ACG 2021 - 0007   Financial Accounting,0007-LEC Eight Wk 2,Staff,35,32,3,0,0
6534,North Campus,ACG 2021 - 0008   Financial Accounting,0008-LEC Main Sess,Staff,35,30,5,0,0
6535,North Campus,ACG 2021 - 0009   Financial Accounting,0009-LEC Main Sess,Staff,35,0,35,0,0
6536,North Campus,ACG 2021 - 0010   Financial Accounting,0010-LEC Main Sess,Staff,40,32,8,0,0
6537,Kendall Campus,ACG 2021 - 0011   Financial Accounting,0011-LEC Main Sess,Staff,36,30,6,0,0
6538,Kendall Campus,ACG 2021 - 0012   Financial Accounting,0012-LEC Main Sess,Staff,36,35,1,0,0
6539,Kendall Campus,ACG 2021 - 0013   Financial Accounting,0013-LEC Main Sess,Staff,36,35,1,0,0
6533,Kendall Campus,ACG 2021 - 0014   Financial Accounting,0014-LEC Main Sess,Staff,36,32,4,0,0
6532,Kendall Campus,ACG 2021 - 0015   Financial Accounting,0015-LEC Main Sess,Staff,36,34,2,0,0
6530,Kendall Campus,ACG 2021 - 0018   Financial Accounting,0018-LEC Main Sess,Staff,36,35,1,0,0
6551,Kendall Campus,ACG 2021 - 0021   Financial Accounting,0021-LEC Eight Wk 1,Staff,40,38,2,0,0
6527,Kendall Campus,ACG 2021 - 0023   Financial Accounting,0023-LEC Main Sess,Staff,36,32,4,0,0
6526,Kendall Campus,ACG 2021 - 0024   Financial Accounting,0024-LEC Main Sess,Staff,36,35,1,0,0
6566,Kendall Campus,ACG 2021 - 0025   Financial Accounting,0025-LEC Weekend,Staff,36,35,1,0,0
6553,Kendall Campus,ACG 2021 - 0026   Financial Accounting,0026-LEC Eight Wk 2,Staff,40,16,24,0,0
6554,Kendall Campus,ACG 2021 - 0027   Financial Accounting,0027-LEC Eight Wk 2,Staff,40,0,40,0,0
6525,Wolfson Campus,ACG 2021 - 0028   Financial Accounting,0028-LEC Main Sess,Staff,35,34,1,0,0
6564,Wolfson Campus,ACG 2021 - 0029   Financial Accounting,0029-LEC Conversion,Staff,38,36,2,0,0
6561,Wolfson Campus,ACG 2021 - 0030   Financial Accounting,0030-LEC Conversion,Staff,30,22,8,0,0
6542,Wolfson Campus,ACG 2021 - 0031   Financial Accounting,0031-LEC Twelve Wk,Staff,45,43,2,0,0
6524,Wolfson Campus,ACG 2021 - 0032   Financial Accounting,0032-LEC Main Sess,Staff,30,26,4,0,0
6522,Wolfson Campus,ACG 2021 - 0034   Financial Accounting,0034-LEC Main Sess,Staff,30,28,2,0,0
6520,Wolfson Campus,ACG 2021 - 0036   Financial Accounting,0036-LEC Main Sess,Staff,30,27,3,0,0
6518,Wolfson Campus,ACG 2021 - 0038   Financial Accounting,0038-LEC Main Sess,Staff,30,26,4,0,0
6517,Homestead Campus,ACG 2021 - 0039   Financial Accounting,0039-LEC Main Sess,Staff,35,20,15,0,0
6559,Homestead Campus,ACG 2021 - 0040   Financial Accounting,0040-LEC Conversion,Staff,35,0,35,0,0
6546,Homestead Campus,ACG 2021 - 0041   Financial Accounting,0041-LEC Eight Wk 1,Staff,35,0,35,0,0
6558,Homestead Campus,ACG 2021 - 0042   Financial Accounting,0042-LEC Conversion,Staff,35,0,35,0,0
6562,Homestead Campus,ACG 2021 - 0043   Financial Accounting,0043-LEC Conversion,Staff,30,15,15,0,0
6516,Homestead Campus,ACG 2021 - 0044   Financial Accounting,0044-LEC Main Sess,Staff,35,24,11,0,0
6513,InterAmerican Campus,ACG 2021 - 0047   Financial Accounting,0047-LEC Main Sess,Staff,32,30,2,0,0
6543,InterAmerican Campus,ACG 2021 - 0048   Financial Accounting,0048-LEC Twelve Wk,Staff,21,19,2,0,0
6547,Hialeah Campus,ACG 2021 - 0049   Financial Accounting,0049-LEC Eight Wk 1,Staff,30,17,13,0,0
6512,Hialeah Campus,ACG 2021 - 0050   Financial Accounting,0050-LEC Main Sess,Staff,30,27,3,0,0
6511,Hialeah Campus,ACG 2021 - 0051   Financial Accounting,0051-LEC Main Sess,Staff,30,27,3,0,0
6548,Hialeah Campus,ACG 2021 - 0052   Financial Accounting,0052-LEC Eight Wk 1,Staff,30,0,30,0,0
6555,Hialeah Campus,ACG 2021 - 0053   Financial Accounting,0053-LEC Eight Wk 2,Staff,30,0,30,0,0
6510,Hialeah Campus,ACG 2021 - 0054   Financial Accounting,0054-LEC Main Sess,Staff,30,25,5,0,0
6549,Hialeah Campus,ACG 2021 - 0055   Financial Accounting,0055-LEC Eight Wk 1,Staff,30,29,1,0,0
6550,Hialeah Campus,ACG 2021 - 0056   Financial Accounting,0056-LEC Eight Wk 1,Staff,30,0,30,0,0
6509,Hialeah Campus,ACG 2021 - 0057   Financial Accounting,0057-LEC Main Sess,Staff,30,0,30,0,0
6565,West Campus,ACG 2021 - 0058   Financial Accounting,0058-LEC 1st Mon Sp,Staff,30,28,2,0,0
6556,West Campus,ACG 2021 - 0059   Financial Accounting,0059-LEC Eight Wk 2,Staff,30,15,15,0,0
6557,West Campus,ACG 2021 - 0060   Financial Accounting,0060-LEC Eight Wk 2,Staff,30,0,30,0,0
11445,North Campus,MAN 2021 - 0001   Principles Of Management,0001-LEC Main Sess,Staff,30,26,4,0,0
11482,North Campus,MAN 2021 - 0002   Principles Of Management,0002-LEC Eight Wk 2,Staff,40,37,3,0,0
11466,North Campus,MAN 2021 - 0003   Principles Of Management,0003-LEC Twelve Wk,Staff,30,17,13,0,0
11472,North Campus,MAN 2021 - 0004   Principles Of Management,0004-LEC Eight Wk 1,Staff,40,0,40,0,0
11446,North Campus,MAN 2021 - 0005   Principles Of Management,0005-LEC Main Sess,Staff,30,9,21,0,0
11458,North Campus,MAN 2021 - 0006   Principles Of Management,0006-LEC Main Sess,Staff,30,18,12,0,0
11459,North Campus,MAN 2021 - 0007   Principles Of Management,0007-LEC Main Sess,Staff,30,0,30,0,0
11481,North Campus,MAN 2021 - 0008   Principles Of Management,0008-LEC Eight Wk 2,Staff,40,39,1,0,0
11480,North Campus,MAN 2021 - 0009   Principles Of Management,0009-LEC Eight Wk 2,Staff,40,0,40,0,0
11486,North Campus,MAN 2021 - 0010   Principles Of Management,0010-LEC Conversion,Staff,40,25,15,0,0
11476,North Campus,MAN 2021 - 0011   Principles Of Management,0011-LEC Eight Wk 1,Staff,40,15,25,0,0
11485,North Campus,MAN 2021 - 0012   Principles Of Management,0012-LEC Conversion,Staff,40,0,40,0,0
11488,North Campus,MAN 2021 - 0013   Principles Of Management,0013-LEC Conversion,Staff,30,0,30,0,0
11487,North Campus,MAN 2021 - 0014   Principles Of Management,0014-LEC Conversion,Staff,40,6,34,0,0
11470,North Campus,MAN 2021 - 0015   Principles Of Management,0015-LEC Twelve Wk,Staff,30,0,30,0,0
11471,North Campus,MAN 2021 - 0016   Principles Of Management,0016-LEC Twelve Wk,Staff,30,0,30,0,0
11460,Kendall Campus,MAN 2021 - 0017   Principles Of Management,0017-LEC Main Sess,Staff,45,27,18,0,0
11461,Kendall Campus,MAN 2021 - 0018   Principles Of Management,0018-LEC Main Sess,Staff,36,19,17,0,0
11469,Kendall Campus,MAN 2021 - 0019   Principles Of Management,0019-LEC Twelve Wk,Staff,45,9,36,0,0
11462,Kendall Campus,MAN 2021 - 0020   Principles Of Management,0020-LEC Main Sess,Staff,45,14,31,0,0
11463,Kendall Campus,MAN 2021 - 0021   Principles Of Management,0021-LEC Main Sess,Staff,30,25,5,0,0
11491,Kendall Campus,MAN 2021 - 0022   Principles Of Management,0022-LEC Weekend,Staff,25,22,3,0,0
11464,Kendall Campus,MAN 2021 - 0023   Principles Of Management,0023-LEC Main Sess,Staff,36,20,16,0,0
11479,Kendall Campus,MAN 2021 - 0024   Principles Of Management,0024-LEC Eight Wk 2,Staff,36,9,27,0,0
11489,Wolfson Campus,MAN 2021 - 0026   Principles Of Management,0026-LEC 1st Mon Sp,Staff,35,31,4,0,0
11457,Wolfson Campus,MAN 2021 - 0027   Principles Of Management,0027-LEC Main Sess,Staff,30,24,6,0,0
11456,Wolfson Campus,MAN 2021 - 0028   Principles Of Management,0028-LEC Main Sess,Staff,25,22,3,0,0
11468,Wolfson Campus,MAN 2021 - 0029   Principles Of Management,0029-LEC Twelve Wk,Staff,30,23,7,0,0
11455,Wolfson Campus,MAN 2021 - 0030   Principles Of Management,0030-LEC Main Sess,Staff,40,13,27,0,0
11484,Wolfson Campus,MAN 2021 - 0031   Principles Of Management,0031-LEC Conversion,Staff,35,0,35,0,0
11454,Wolfson Campus,MAN 2021 - 0032   Principles Of Management,0032-LEC Main Sess,Staff,30,28,2,0,0
11453,Wolfson Campus,MAN 2021 - 0033   Principles Of Management,0033-LEC Main Sess,Staff,30,23,7,0,0
11452,Wolfson Campus,MAN 2021 - 0034   Principles Of Management,0034-LEC Main Sess,Staff,30,27,3,0,0
11451,Wolfson Campus,MAN 2021 - 0035   Principles Of Management,0035-LEC Main Sess,Staff,30,27,3,0,0
11450,Homestead Campus,MAN 2021 - 0036   Principles Of Management,0036-LEC Main Sess,Staff,30,17,13,0,0
11490,Homestead Campus,MAN 2021 - 0037   Principles Of Management,0037-LEC Weekend,Staff,30,0,30,0,0
11449,Homestead Campus,MAN 2021 - 0038   Principles Of Management,0038-LEC Main Sess,Staff,30,23,7,0,0
11483,Homestead Campus,MAN 2021 - 0039   Principles Of Management,0039-LEC Conversion,Staff,30,13,17,0,0
11467,InterAmerican Campus,MAN 2021 - 0040   Principles Of Management,0040-LEC Twelve Wk,Staff,30,18,12,0,0
11473,Hialeah Campus,MAN 2021 - 0041   Principles Of Management,0041-LEC Eight Wk 1,Staff,30,13,17,0,0
11477,Hialeah Campus,MAN 2021 - 0042   Principles Of Management,0042-LEC Eight Wk 1,Staff,34,12,22,0,0
11475,Hialeah Campus,MAN 2021 - 0043   Principles Of Management,0043-LEC Eight Wk 1,Staff,25,0,25,0,0
11474,Hialeah Campus,MAN 2021 - 0044   Principles Of Management,0044-LEC Eight Wk 1,Staff,30,0,30,0,0
11478,Hialeah Campus,MAN 2021 - 0045   Principles Of Management,0045-LEC Eight Wk 2,Staff,30,4,26,0,0
11448,West Campus,MAN 2021 - 0046   Principles Of Management,0046-LEC Main Sess,Staff,35,15,20,0,0
11447,West Campus,MAN 2021 - 0047   Principles Of Management,0047-LEC Main Sess,Staff,30,27,3,0,0
5815,North Campus,ACG 2021L - 0001   Financial Accounting Lab,0001-LAB Eight Wk 1,Staff,120,17,103,0,0
5821,North Campus,ACG 2021L - 0002   Financial Accounting Lab,0002-LAB Eight Wk 2,Staff,120,28,92,0,0
5800,North Campus,ACG 2021L - 0003   Financial Accounting Lab,0003-LAB Main Sess,Staff,999,134,865,0,0
5824,North Campus,ACG 2021L - 0004   Financial Accounting Lab,0004-LAB Conversion,Staff,999,23,976,0,0
5813,North Campus,ACG 2021L - 0005   Financial Accounting Lab,0005-LAB Twelve Wk,Staff,999,45,954,0,0
5822,Kendall Campus,ACG 2021L - 0006   Financial Accounting Lab,0006-LAB Eight Wk 2,Staff,40,0,40,0,0
5801,Kendall Campus,ACG 2021L - 0007   Financial Accounting Lab,0007-LAB Main Sess,Staff,600,422,178,0,0
5812,Kendall Campus,ACG 2021L - 0009   Financial Accounting Lab,0009-LAB Twelve Wk,Staff,70,60,10,0,0
5820,Kendall Campus,ACG 2021L - 0010   Financial Accounting Lab,0010-LAB Eight Wk 2,Staff,30,17,13,0,0
5811,Wolfson Campus,ACG 2021L - 0011   Financial Accounting Lab,0011-LAB Twelve Wk,Staff,150,43,107,0,0
5808,Wolfson Campus,ACG 2021L - 0012   Financial Accounting Lab,0012-LAB Main Sess,Staff,300,158,142,0,0
5825,Wolfson Campus,ACG 2021L - 0013   Financial Accounting Lab,0013-LAB Conversion,Staff,150,58,92,0,0
5809,Wolfson Campus,ACG 2021L - 0014   Financial Accounting Lab,0014-LAB Main Sess,Staff,45,41,4,0,0
5810,Wolfson Campus,ACG 2021L - 0015   Financial Accounting Lab,0015-LAB Main Sess,Staff,45,42,3,0,0
5807,Homestead Campus,ACG 2021L - 0016   Financial Accounting Lab,0016-LAB Main Sess,Staff,70,44,26,0,0
5823,Homestead Campus,ACG 2021L - 0017   Financial Accounting Lab,0017-LAB Conversion,Staff,70,15,55,0,0
5814,InterAmerican Campus,ACG 2021L - 0019   Financial Accounting Lab,0019-LAB Twelve Wk,Staff,21,19,2,0,0
5817,Hialeah Campus,ACG 2021L - 0022   Financial Accounting Lab,0022-LAB Eight Wk 1,Staff,120,55,65,0,0
5818,Hialeah Campus,ACG 2021L - 0023   Financial Accounting Lab,0023-LAB Eight Wk 2,Staff,120,0,120,0,0
5803,Hialeah Campus,ACG 2021L - 0024   Financial Accounting Lab,0024-LAB Main Sess,Staff,120,78,42,0,0
5802,West Campus,ACG 2021L - 0025   Financial Accounting Lab,0025-LAB Main Sess,Staff,100,65,35,0,0
5819,West Campus,ACG 2021L - 0026   Financial Accounting Lab,0026-LAB Eight Wk 2,Staff,100,14,86,0,0
5680,North Campus,AMH 2020 - 0001   History of  the US Since 1877,0001-LEC Main Sess,Staff,40,14,26,0,0
5681,North Campus,AMH 2020 - 0002   History of  the US Since 1877,0002-LEC Main Sess,Staff,40,33,7,0,0
5689,North Campus,AMH 2020 - 0003   History of  the US Since 1877,0003-LEC Main Sess,Staff,40,37,3,0,0
5703,North Campus,AMH 2020 - 0004   History of  the US Since 1877,0004-LEC Twelve Wk,Staff,40,15,25,0,0
5702,North Campus,AMH 2020 - 0005   History of  the US Since 1877,0005-LEC Twelve Wk,Staff,40,0,40,0,0
5690,Kendall Campus,AMH 2020 - 0006   History of  the US Since 1877,0006-LEC Main Sess,Staff,49,28,21,0,0
5691,Kendall Campus,AMH 2020 - 0007   History of  the US Since 1877,0007-LEC Main Sess,Staff,49,47,2,0,0
5692,Kendall Campus,AMH 2020 - 0008   History of  the US Since 1877,0008-LEC Main Sess,Staff,48,11,37,0,0
5693,Kendall Campus,AMH 2020 - 0009   History of  the US Since 1877,0009-LEC Main Sess,Staff,49,19,30,0,0
5695,Kendall Campus,AMH 2020 - 0011   History of  the US Since 1877,0011-LEC Main Sess,Staff,30,28,2,0,0
5696,Kendall Campus,AMH 2020 - 0012   History of  the US Since 1877,0012-LEC Main Sess,Staff,49,48,1,0,0
5697,Kendall Campus,AMH 2020 - 0013   History of  the US Since 1877,0013-LEC Main Sess,Staff,49,40,9,0,0
5705,Kendall Campus,AMH 2020 - 0014   History of  the US Since 1877,0014-LEC Eight Wk 2,Staff,35,34,1,0,0
5698,Wolfson Campus,AMH 2020 - 0015   History of  the US Since 1877,0015-LEC Main Sess,Staff,30,0,30,0,0
5699,Wolfson Campus,AMH 2020 - 0016   History of  the US Since 1877,0016-LEC Main Sess,Staff,45,22,23,0,0
5707,Wolfson Campus,AMH 2020 - 0017   History of  the US Since 1877,0017-LEC Conversion,Staff,45,0,45,0,0
5700,Wolfson Campus,AMH 2020 - 0018   History of  the US Since 1877,0018-LEC Main Sess,Staff,45,42,3,0,0
5701,Wolfson Campus,AMH 2020 - 0019   History of  the US Since 1877,0019-LEC Main Sess,Staff,45,23,22,0,0
5688,Wolfson Campus,AMH 2020 - 0020   History of  the US Since 1877,0020-LEC Main Sess,Staff,30,26,4,0,0
5708,Wolfson Campus,AMH 2020 - 0022   History of  the US Since 1877,0022-LEC Conversion,Staff,34,30,4,0,0
5704,Homestead Campus,AMH 2020 - 0023   History of  the US Since 1877,0023-LEC Eight Wk 1,Staff,39,0,39,0,0
5686,Homestead Campus,AMH 2020 - 0025   History of  the US Since 1877,0025-LEC Main Sess,Staff,39,0,39,0,0
5685,InterAmerican Campus,AMH 2020 - 0026   History of  the US Since 1877,0026-LEC Main Sess,Staff,37,23,14,0,0
5684,InterAmerican Campus,AMH 2020 - 0027   History of  the US Since 1877,0027-LEC Main Sess,Staff,29,20,9,0,0
5683,West Campus,AMH 2020 - 0028   History of  the US Since 1877,0028-LEC Main Sess,Staff,35,13,22,0,0
5682,West Campus,AMH 2020 - 0029   History of  the US Since 1877,0029-LEC Main Sess,Staff,35,16,19,0,0
5709,West Campus,AMH 2020 - 0030   History of  the US Since 1877,0030-LEC Weekend,Staff,35,0,35,0,0
7109,North Campus,AML 2020 - 0001   American Literature 2,0001-LEC Main Sess,Staff,28,0,28,0,0
7108,Kendall Campus,AML 2020 - 0002   American Literature 2,0002-LEC Main Sess,Staff,28,15,13,0,0
7019,Kendall Campus,BSC 2020 - 0001   Human Biology: Fundamentals Of Anatomy/Physiology,0001-LEC Main Sess,Staff,40,0,40,0,0
7020,Kendall Campus,BSC 2020 - 0002   Human Biology: Fundamentals Of Anatomy/Physiology,0002-LEC Main Sess,Staff,39,11,28,0,0
7021,Kendall Campus,BSC 2020 - 0003   Human Biology: Fundamentals Of Anatomy/Physiology,0003-LEC Main Sess,Staff,40,36,4,0,0
7022,InterAmerican Campus,BSC 2020 - 0004   Human Biology: Fundamentals Of Anatomy/Physiology,0004-LEC 1st Mon Sp,Staff,24,0,24,0,0
9843,InterAmerican Campus,SPW 2020 - 0001   Selected Readings In Latin American Literature,0001-LEC Main Sess,Staff,16,9,7,0,0
9842,InterAmerican Campus,SPW 2020 - 0002   Selected Readings In Latin American Literature,0002-LEC Main Sess,Staff,25,9,16,0,0
10820,North Campus,ECO 2013 - 0001   Principles Of Economics (Macro),0001-LEC Main Sess,Staff,40,17,23,0,0
10821,North Campus,ECO 2013 - 0002   Principles Of Economics (Macro),0002-LEC Main Sess,Staff,40,37,3,0,0
10822,North Campus,ECO 2013 - 0003   Principles Of Economics (Macro),0003-LEC Main Sess,Staff,45,43,2,0,0
10823,North Campus,ECO 2013 - 0004   Principles Of Economics (Macro),0004-LEC Main Sess,Staff,40,23,17,0,0
10900,North Campus,ECO 2013 - 0005   Principles Of Economics (Macro),0005-LEC Eight Wk 2,Staff,30,28,2,0,0
10824,North Campus,ECO 2013 - 0006   Principles Of Economics (Macro),0006-LEC Main Sess,Staff,45,42,3,0,0
10825,North Campus,ECO 2013 - 0007   Principles Of Economics (Macro),0007-LEC Main Sess,Staff,45,44,1,0,0
10826,North Campus,ECO 2013 - 0008   Principles Of Economics (Macro),0008-LEC Main Sess,Staff,40,36,4,0,0
10899,North Campus,ECO 2013 - 0009   Principles Of Economics (Macro),0009-LEC Eight Wk 2,Staff,40,0,40,0,0
10827,North Campus,ECO 2013 - 0010   Principles Of Economics (Macro),0010-LEC Main Sess,Staff,40,35,5,0,0
10905,North Campus,ECO 2013 - 0012   Principles Of Economics (Macro),0012-LEC Weekend,Staff,45,33,12,0,0
10889,North Campus,ECO 2013 - 0013   Principles Of Economics (Macro),0013-LEC Twelve Wk,Staff,45,43,2,0,0
10829,North Campus,ECO 2013 - 0014   Principles Of Economics (Macro),0014-LEC Main Sess,Staff,40,36,4,0,0
10830,North Campus,ECO 2013 - 0015   Principles Of Economics (Macro),0015-LEC Main Sess,Staff,45,40,5,0,0
10831,North Campus,ECO 2013 - 0016   Principles Of Economics (Macro),0016-LEC Main Sess,Staff,45,41,4,0,0
10832,North Campus,ECO 2013 - 0017   Principles Of Economics (Macro),0017-LEC Main Sess,Staff,40,9,31,0,0
10890,North Campus,ECO 2013 - 0018   Principles Of Economics (Macro),0018-LEC Twelve Wk,Staff,40,13,27,0,0
10833,Kendall Campus,ECO 2013 - 0019   Principles Of Economics (Macro),0019-LEC Main Sess,Staff,45,43,2,0,0
10834,Kendall Campus,ECO 2013 - 0020   Principles Of Economics (Macro),0020-LEC Main Sess,Staff,45,43,2,0,0
10835,Kendall Campus,ECO 2013 - 0021   Principles Of Economics (Macro),0021-LEC Main Sess,Staff,45,43,2,0,0
10836,Kendall Campus,ECO 2013 - 0022   Principles Of Economics (Macro),0022-LEC Main Sess,Staff,36,30,6,0,0
10837,Kendall Campus,ECO 2013 - 0023   Principles Of Economics (Macro),0023-LEC Main Sess,Staff,45,38,7,0,0
10841,Kendall Campus,ECO 2013 - 0027   Principles Of Economics (Macro),0027-LEC Main Sess,Staff,45,41,4,0,0
10843,Kendall Campus,ECO 2013 - 0029   Principles Of Economics (Macro),0029-LEC Main Sess,Staff,45,44,1,0,0
10844,Kendall Campus,ECO 2013 - 0030   Principles Of Economics (Macro),0030-LEC Main Sess,Staff,35,31,4,0,0
10888,Kendall Campus,ECO 2013 - 0031   Principles Of Economics (Macro),0031-LEC Twelve Wk,Staff,45,43,2,0,0
10887,Kendall Campus,ECO 2013 - 0032   Principles Of Economics (Macro),0032-LEC Twelve Wk,Staff,36,31,5,0,0
10845,Kendall Campus,ECO 2013 - 0033   Principles Of Economics (Macro),0033-LEC Main Sess,Staff,45,42,3,0,0
10846,Kendall Campus,ECO 2013 - 0034   Principles Of Economics (Macro),0034-LEC Main Sess,Staff,45,44,1,0,0
10847,Kendall Campus,ECO 2013 - 0035   Principles Of Economics (Macro),0035-LEC Main Sess,Staff,36,33,3,0,0
10848,Kendall Campus,ECO 2013 - 0036   Principles Of Economics (Macro),0036-LEC Main Sess,Staff,45,44,1,0,0
10849,Kendall Campus,ECO 2013 - 0037   Principles Of Economics (Macro),0037-LEC Main Sess,Staff,45,16,29,0,0
10906,Kendall Campus,ECO 2013 - 0038   Principles Of Economics (Macro),0038-LEC Weekend,Staff,30,0,30,0,0
10850,Wolfson Campus,ECO 2013 - 0039   Principles Of Economics (Macro),0039-LEC Main Sess,Staff,25,23,2,0,0
10902,Wolfson Campus,ECO 2013 - 0041   Principles Of Economics (Macro),0041-LEC Conversion,Staff,30,0,30,0,0
10901,Wolfson Campus,ECO 2013 - 0042   Principles Of Economics (Macro),0042-LEC Conversion,Staff,35,34,1,0,0
10852,Wolfson Campus,ECO 2013 - 0043   Principles Of Economics (Macro),0043-LEC Main Sess,Staff,45,42,3,0,0
10853,Wolfson Campus,ECO 2013 - 0044   Principles Of Economics (Macro),0044-LEC Main Sess,Staff,45,40,5,0,0
10854,Wolfson Campus,ECO 2013 - 0045   Principles Of Economics (Macro),0045-LEC Main Sess,Staff,45,43,2,0,0
10855,Wolfson Campus,ECO 2013 - 0046   Principles Of Economics (Macro),0046-LEC Main Sess,Staff,45,44,1,0,0
10898,Wolfson Campus,ECO 2013 - 0047   Principles Of Economics (Macro),0047-LEC Eight Wk 2,Staff,35,33,2,0,0
10904,Wolfson Campus,ECO 2013 - 0048   Principles Of Economics (Macro),0048-LEC Conversion,Staff,35,0,35,0,0
10856,Wolfson Campus,ECO 2013 - 0049   Principles Of Economics (Macro),0049-LEC Main Sess,Staff,47,43,4,0,0
10857,Wolfson Campus,ECO 2013 - 0050   Principles Of Economics (Macro),0050-LEC Main Sess,Staff,35,32,3,0,0
10859,Wolfson Campus,ECO 2013 - 0052   Principles Of Economics (Macro),0052-LEC Main Sess,Staff,30,21,9,0,0
10860,Wolfson Campus,ECO 2013 - 0053   Principles Of Economics (Macro),0053-LEC Main Sess,Staff,30,25,5,0,0
10861,Wolfson Campus,ECO 2013 - 0054   Principles Of Economics (Macro),0054-LEC Main Sess,Staff,30,29,1,0,0
10862,Wolfson Campus,ECO 2013 - 0055   Principles Of Economics (Macro),0055-LEC Main Sess,Staff,30,28,2,0,0
10863,Wolfson Campus,ECO 2013 - 0056   Principles Of Economics (Macro),0056-LEC Main Sess,Staff,30,25,5,0,0
10864,Wolfson Campus,ECO 2013 - 0058   Principles Of Economics (Macro),0058-LEC Main Sess,Staff,30,24,6,0,0
10865,Wolfson Campus,ECO 2013 - 0059   Principles Of Economics (Macro),0059-LEC Main Sess,Staff,30,24,6,0,0
10866,Homestead Campus,ECO 2013 - 0060   Principles Of Economics (Macro),0060-LEC Main Sess,Staff,25,24,1,0,0
10867,Homestead Campus,ECO 2013 - 0061   Principles Of Economics (Macro),0061-LEC Main Sess,Staff,35,21,14,0,0
10868,Homestead Campus,ECO 2013 - 0062   Principles Of Economics (Macro),0062-LEC Main Sess,Staff,35,29,6,0,0
10869,Homestead Campus,ECO 2013 - 0063   Principles Of Economics (Macro),0063-LEC Main Sess,Staff,35,33,2,0,0
10897,Homestead Campus,ECO 2013 - 0064   Principles Of Economics (Macro),0064-LEC Eight Wk 2,Staff,25,0,25,0,0
10870,Homestead Campus,ECO 2013 - 0065   Principles Of Economics (Macro),0065-LEC Main Sess,Staff,25,20,5,0,0
10871,InterAmerican Campus,ECO 2013 - 0066   Principles Of Economics (Macro),0066-LEC Main Sess,Staff,29,27,2,0,0
10872,InterAmerican Campus,ECO 2013 - 0067   Principles Of Economics (Macro),0067-LEC Main Sess,Staff,29,14,15,0,0
10873,InterAmerican Campus,ECO 2013 - 0068   Principles Of Economics (Macro),0068-LEC Main Sess,Staff,35,33,2,0,0
10874,InterAmerican Campus,ECO 2013 - 0069   Principles Of Economics (Macro),0069-LEC Main Sess,Staff,29,23,6,0,0
10896,InterAmerican Campus,ECO 2013 - 0071   Principles Of Economics (Macro),0071-LEC Eight Wk 2,Staff,29,16,13,0,0
10875,Hialeah Campus,ECO 2013 - 0072   Principles Of Economics (Macro),0072-LEC Main Sess,Staff,30,24,6,0,0
10876,Hialeah Campus,ECO 2013 - 0073   Principles Of Economics (Macro),0073-LEC Main Sess,Staff,30,27,3,0,0
10892,Hialeah Campus,ECO 2013 - 0074   Principles Of Economics (Macro),0074-LEC Eight Wk 1,Staff,30,0,30,0,0
10877,Hialeah Campus,ECO 2013 - 0075   Principles Of Economics (Macro),0075-LEC Main Sess,Staff,30,19,11,0,0
10878,Hialeah Campus,ECO 2013 - 0076   Principles Of Economics (Macro),0076-LEC Main Sess,Staff,35,0,35,0,0
10894,Hialeah Campus,ECO 2013 - 0077   Principles Of Economics (Macro),0077-LEC Eight Wk 2,Staff,25,20,5,0,0
10891,Hialeah Campus,ECO 2013 - 0078   Principles Of Economics (Macro),0078-LEC Eight Wk 1,Staff,25,18,7,0,0
10895,Hialeah Campus,ECO 2013 - 0079   Principles Of Economics (Macro),0079-LEC Eight Wk 2,Staff,30,17,13,0,0
10879,Hialeah Campus,ECO 2013 - 0080   Principles Of Economics (Macro),0080-LEC Main Sess,Staff,35,15,20,0,0
10880,West Campus,ECO 2013 - 0081   Principles Of Economics (Macro),0081-LEC Main Sess,Staff,35,13,22,0,0
10881,West Campus,ECO 2013 - 0082   Principles Of Economics (Macro),0082-LEC Main Sess,Staff,35,0,35,0,0
10886,West Campus,ECO 2013 - 0083   Principles Of Economics (Macro),0083-LEC Twelve Wk,Staff,30,16,14,0,0
10883,West Campus,ECO 2013 - 0085   Principles Of Economics (Macro),0085-LEC Main Sess,Staff,35,21,14,0,0
10884,West Campus,ECO 2013 - 0086   Principles Of Economics (Macro),0086-LEC Main Sess,Staff,35,0,35,0,0
10885,West Campus,ECO 2013 - 0087   Principles Of Economics (Macro),0087-LEC Main Sess,Staff,27,23,4,0,0
11377,Medical Campus,HIM 2012 - 0001   Legal Aspects Of Health Care,0001-LEC Conversion,Staff,25,8,17,0,0
11378,Medical Campus,HIM 2012 - 0002   Legal Aspects Of Health Care,0002-LEC Conversion,Staff,10,0,10,0,0
15584,North Campus,PSY 2012 - 0001   Introduction To Psychology,0001-LEC Main Sess,Staff,40,37,3,0,0
15585,North Campus,PSY 2012 - 0002   Introduction To Psychology,0002-LEC Main Sess,Staff,80,34,46,0,0
15586,North Campus,PSY 2012 - 0003   Introduction To Psychology,0003-LEC Main Sess,Staff,40,36,4,0,0
15587,North Campus,PSY 2012 - 0004   Introduction To Psychology,0004-LEC Main Sess,Staff,40,36,4,0,0
15671,North Campus,PSY 2012 - 0005   Introduction To Psychology,0005-LEC Twelve Wk,Staff,40,39,1,0,0
15588,North Campus,PSY 2012 - 0006   Introduction To Psychology,0006-LEC Main Sess,Staff,40,32,8,0,0
15589,North Campus,PSY 2012 - 0007   Introduction To Psychology,0007-LEC Main Sess,Staff,40,39,1,0,0
15590,North Campus,PSY 2012 - 0008   Introduction To Psychology,0008-LEC Main Sess,Staff,40,23,17,0,0
15591,North Campus,PSY 2012 - 0009   Introduction To Psychology,0009-LEC Main Sess,Staff,40,34,6,0,0
15592,North Campus,PSY 2012 - 0010   Introduction To Psychology,0010-LEC Main Sess,Staff,40,31,9,0,0
15593,North Campus,PSY 2012 - 0011   Introduction To Psychology,0011-LEC Main Sess,Staff,40,38,2,0,0
15594,North Campus,PSY 2012 - 0012   Introduction To Psychology,0012-LEC Main Sess,Staff,35,30,5,0,0
15595,North Campus,PSY 2012 - 0013   Introduction To Psychology,0013-LEC Main Sess,Staff,40,0,40,0,0
15596,North Campus,PSY 2012 - 0014   Introduction To Psychology,0014-LEC Main Sess,Staff,40,36,4,0,0
15597,North Campus,PSY 2012 - 0015   Introduction To Psychology,0015-LEC Main Sess,Staff,40,25,15,0,0
15692,North Campus,PSY 2012 - 0016   Introduction To Psychology,0016-LEC Conversion,Staff,40,0,40,0,0
15676,North Campus,PSY 2012 - 0018   Introduction To Psychology,0018-LEC Twelve Wk,Staff,40,39,1,0,0
15598,North Campus,PSY 2012 - 0019   Introduction To Psychology,0019-LEC Main Sess,Staff,40,0,40,0,0
15679,North Campus,PSY 2012 - 0021   Introduction To Psychology,0021-LEC Twelve Wk,Staff,40,25,15,0,0
15599,Kendall Campus,PSY 2012 - 0022   Introduction To Psychology,0022-LEC Main Sess,Staff,49,48,1,0,0
15601,Kendall Campus,PSY 2012 - 0024   Introduction To Psychology,0024-LEC Main Sess,Staff,49,47,2,0,0
15602,Kendall Campus,PSY 2012 - 0025   Introduction To Psychology,0025-LEC Main Sess,Staff,49,47,2,0,0
15603,Kendall Campus,PSY 2012 - 0026   Introduction To Psychology,0026-LEC Main Sess,Staff,42,34,8,0,0
15680,Kendall Campus,PSY 2012 - 0027   Introduction To Psychology,0027-LEC Eight Wk 1,Staff,30,29,1,0,0
15684,Kendall Campus,PSY 2012 - 0028   Introduction To Psychology,0028-LEC Eight Wk 2,Staff,30,26,4,0,0
15683,Kendall Campus,PSY 2012 - 0029   Introduction To Psychology,0029-LEC Eight Wk 2,Staff,30,25,5,0,0
15605,Kendall Campus,PSY 2012 - 0031   Introduction To Psychology,0031-LEC Main Sess,Staff,49,47,2,0,0
15606,Kendall Campus,PSY 2012 - 0032   Introduction To Psychology,0032-LEC Main Sess,Staff,45,42,3,0,0
15607,Kendall Campus,PSY 2012 - 0033   Introduction To Psychology,0033-LEC Main Sess,Staff,49,15,34,0,0
15608,Kendall Campus,PSY 2012 - 0034   Introduction To Psychology,0034-LEC Main Sess,Staff,48,46,2,0,0
15610,Kendall Campus,PSY 2012 - 0036   Introduction To Psychology,0036-LEC Main Sess,Staff,45,42,3,0,0
15611,Kendall Campus,PSY 2012 - 0037   Introduction To Psychology,0037-LEC Main Sess,Staff,40,22,18,0,0
15612,Kendall Campus,PSY 2012 - 0038   Introduction To Psychology,0038-LEC Main Sess,Staff,49,46,3,0,0
15613,Kendall Campus,PSY 2012 - 0039   Introduction To Psychology,0039-LEC Main Sess,Staff,49,46,3,0,0
15614,Kendall Campus,PSY 2012 - 0040   Introduction To Psychology,0040-LEC Main Sess,Staff,48,20,28,0,0
15615,Kendall Campus,PSY 2012 - 0041   Introduction To Psychology,0041-LEC Main Sess,Staff,40,19,21,0,0
15616,Kendall Campus,PSY 2012 - 0042   Introduction To Psychology,0042-LEC Main Sess,Staff,45,17,28,0,0
15618,Kendall Campus,PSY 2012 - 0044   Introduction To Psychology,0044-LEC Main Sess,Staff,44,23,21,0,0
15619,Kendall Campus,PSY 2012 - 0045   Introduction To Psychology,0045-LEC Main Sess,Staff,30,27,3,0,0
15678,Kendall Campus,PSY 2012 - 0046   Introduction To Psychology,0046-LEC Twelve Wk,Staff,36,31,5,0,0
15677,Kendall Campus,PSY 2012 - 0047   Introduction To Psychology,0047-LEC Twelve Wk,Staff,40,38,2,0,0
15620,Kendall Campus,PSY 2012 - 0048   Introduction To Psychology,0048-LEC Main Sess,Staff,30,29,1,0,0
15621,Kendall Campus,PSY 2012 - 0049   Introduction To Psychology,0049-LEC Main Sess,Staff,48,37,11,0,0
15624,Kendall Campus,PSY 2012 - 0052   Introduction To Psychology,0052-LEC Main Sess,Staff,42,41,1,0,0
15625,Kendall Campus,PSY 2012 - 0053   Introduction To Psychology,0053-LEC Main Sess,Staff,28,19,9,0,0
15626,Kendall Campus,PSY 2012 - 0054   Introduction To Psychology,0054-LEC Main Sess,Staff,30,29,1,0,0
15696,Kendall Campus,PSY 2012 - 0055   Introduction To Psychology,0055-LEC Weekend,Staff,40,9,31,0,0
15627,Wolfson Campus,PSY 2012 - 0056   Introduction To Psychology,0056-LEC Main Sess,Staff,47,39,8,0,0
15628,Wolfson Campus,PSY 2012 - 0057   Introduction To Psychology,0057-LEC Main Sess,Staff,47,45,2,0,0
15629,Wolfson Campus,PSY 2012 - 0058   Introduction To Psychology,0058-LEC Main Sess,Staff,47,46,1,0,0
15630,Wolfson Campus,PSY 2012 - 0059   Introduction To Psychology,0059-LEC Main Sess,Staff,47,42,5,0,0
15632,Wolfson Campus,PSY 2012 - 0061   Introduction To Psychology,0061-LEC Main Sess,Staff,47,40,7,0,0
15633,Wolfson Campus,PSY 2012 - 0062   Introduction To Psychology,0062-LEC Main Sess,Staff,47,37,10,0,0
15670,Wolfson Campus,PSY 2012 - 0063   Introduction To Psychology,0063-LEC Twelve Wk,Staff,47,42,5,0,0
15635,Wolfson Campus,PSY 2012 - 0065   Introduction To Psychology,0065-LEC Main Sess,Staff,47,42,5,0,0
15636,Wolfson Campus,PSY 2012 - 0066   Introduction To Psychology,0066-LEC Main Sess,Staff,23,22,1,0,0
15637,Wolfson Campus,PSY 2012 - 0067   Introduction To Psychology,0067-LEC Main Sess,Staff,47,43,4,0,0
15694,Wolfson Campus,PSY 2012 - 0068   Introduction To Psychology,0068-LEC Conversion,Staff,47,0,47,0,0
15690,Wolfson Campus,PSY 2012 - 0069   Introduction To Psychology,0069-LEC Conversion,Staff,34,29,5,0,0
15638,Wolfson Campus,PSY 2012 - 0070   Introduction To Psychology,0070-LEC Main Sess,Staff,30,27,3,0,0
15639,Wolfson Campus,PSY 2012 - 0071   Introduction To Psychology,0071-LEC Main Sess,Staff,30,29,1,0,0
15641,Wolfson Campus,PSY 2012 - 0073   Introduction To Psychology,0073-LEC Main Sess,Staff,30,27,3,0,0
15642,Wolfson Campus,PSY 2012 - 0074   Introduction To Psychology,0074-LEC Main Sess,Staff,30,27,3,0,0
15643,Wolfson Campus,PSY 2012 - 0075   Introduction To Psychology,0075-LEC Main Sess,Staff,30,26,4,0,0
15689,Wolfson Campus,PSY 2012 - 0076   Introduction To Psychology,0076-LEC Conversion,Staff,34,33,1,0,0
15645,Wolfson Campus,PSY 2012 - 0078   Introduction To Psychology,0078-LEC Main Sess,Staff,30,28,2,0,0
15646,Wolfson Campus,PSY 2012 - 0079   Introduction To Psychology,0079-LEC Main Sess,Staff,30,28,2,0,0
15647,Wolfson Campus,PSY 2012 - 0080   Introduction To Psychology,0080-LEC Main Sess,Staff,30,27,3,0,0
15648,Wolfson Campus,PSY 2012 - 0081   Introduction To Psychology,0081-LEC Main Sess,Staff,30,26,4,0,0
15687,Wolfson Campus,PSY 2012 - 0083   Introduction To Psychology,0083-LEC Conversion,Staff,30,26,4,0,0
15649,Homestead Campus,PSY 2012 - 0084   Introduction To Psychology,0084-LEC Main Sess,Staff,39,27,12,0,0
15650,Homestead Campus,PSY 2012 - 0085   Introduction To Psychology,0085-LEC Main Sess,Staff,39,20,19,0,0
15651,Homestead Campus,PSY 2012 - 0086   Introduction To Psychology,0086-LEC Main Sess,Staff,39,33,6,0,0
15681,Homestead Campus,PSY 2012 - 0087   Introduction To Psychology,0087-LEC Eight Wk 1,Staff,39,0,39,0,0
15652,Homestead Campus,PSY 2012 - 0088   Introduction To Psychology,0088-LEC Main Sess,Staff,39,35,4,0,0
15653,Homestead Campus,PSY 2012 - 0089   Introduction To Psychology,0089-LEC Main Sess,Staff,39,36,3,0,0
15654,Homestead Campus,PSY 2012 - 0090   Introduction To Psychology,0090-LEC Main Sess,Staff,39,0,39,0,0
15655,InterAmerican Campus,PSY 2012 - 0091   Introduction To Psychology,0091-LEC Main Sess,Staff,40,38,2,0,0
15656,InterAmerican Campus,PSY 2012 - 0092   Introduction To Psychology,0092-LEC Main Sess,Staff,25,11,14,0,0
15695,InterAmerican Campus,PSY 2012 - 0093   Introduction To Psychology,0093-LEC 1st Mon Sp,Staff,40,39,1,0,0
15657,InterAmerican Campus,PSY 2012 - 0094   Introduction To Psychology,0094-LEC Main Sess,Staff,40,4,36,0,0
15658,InterAmerican Campus,PSY 2012 - 0095   Introduction To Psychology,0095-LEC Main Sess,Staff,40,21,19,0,0
15659,InterAmerican Campus,PSY 2012 - 0096   Introduction To Psychology,0096-LEC Main Sess,Staff,40,38,2,0,0
15660,InterAmerican Campus,PSY 2012 - 0097   Introduction To Psychology,0097-LEC Main Sess,Staff,40,39,1,0,0
15661,Hialeah Campus,PSY 2012 - 0098   Introduction To Psychology,0098-LEC Main Sess,Staff,30,29,1,0,0
15662,Hialeah Campus,PSY 2012 - 0099   Introduction To Psychology,0099-LEC Main Sess,Staff,36,34,2,0,0
15663,Hialeah Campus,PSY 2012 - 0100   Introduction To Psychology,0100-LEC Main Sess,Staff,35,23,12,0,0
15664,Hialeah Campus,PSY 2012 - 0101   Introduction To Psychology,0101-LEC Main Sess,Staff,36,30,6,0,0
15675,Hialeah Campus,PSY 2012 - 0102   Introduction To Psychology,0102-LEC Twelve Wk,Staff,43,25,18,0,0
15674,Hialeah Campus,PSY 2012 - 0103   Introduction To Psychology,0103-LEC Twelve Wk,Staff,33,15,18,0,0
15673,Hialeah Campus,PSY 2012 - 0104   Introduction To Psychology,0104-LEC Twelve Wk,Staff,36,35,1,0,0
15697,Hialeah Campus,PSY 2012 - 0105   Introduction To Psychology,0105-LEC Weekend,Staff,36,0,36,0,0
15665,Hialeah Campus,PSY 2012 - 0106   Introduction To Psychology,0106-LEC Main Sess,Staff,45,34,11,0,0
15691,Hialeah Campus,PSY 2012 - 0107   Introduction To Psychology,0107-LEC Conversion,Staff,36,15,21,0,0
15666,Hialeah Campus,PSY 2012 - 0108   Introduction To Psychology,0108-LEC Main Sess,Staff,30,29,1,0,0
15682,West Campus,PSY 2012 - 0110   Introduction To Psychology,0110-LEC Eight Wk 1,Staff,35,33,2,0,0
15693,West Campus,PSY 2012 - 0111   Introduction To Psychology,0111-LEC Conversion,Staff,35,30,5,0,0
15686,West Campus,PSY 2012 - 0112   Introduction To Psychology,0112-LEC Conversion,Staff,35,24,11,0,0
15668,West Campus,PSY 2012 - 0113   Introduction To Psychology,0113-LEC Main Sess,Staff,35,31,4,0,0
15669,West Campus,PSY 2012 - 0114   Introduction To Psychology,0114-LEC Main Sess,Staff,30,20,10,0,0
13242,North Campus,WOH 2012 - 0001   History of World Civilization to 1789,0001-LEC Main Sess,Staff,20,15,5,0,0
13243,Kendall Campus,WOH 2012 - 0002   History of World Civilization to 1789,0002-LEC Main Sess,Staff,45,28,17,0,0
13244,Kendall Campus,WOH 2012 - 0003   History of World Civilization to 1789,0003-LEC Main Sess,Staff,30,22,8,0,0
13248,Kendall Campus,WOH 2012 - 0004   History of World Civilization to 1789,0004-LEC Conversion,Staff,25,11,14,0,0
13245,Kendall Campus,WOH 2012 - 0005   History of World Civilization to 1789,0005-LEC Main Sess,Staff,45,24,21,0,0
13246,Wolfson Campus,WOH 2012 - 0006   History of World Civilization to 1789,0006-LEC Main Sess,Staff,30,27,3,0,0
13247,Wolfson Campus,WOH 2012 - 0007   History of World Civilization to 1789,0007-LEC Main Sess,Staff,34,27,7,0,0
6256,North Campus,ACG 2011 - 0001   Principles Of Accounting 2,0001-LEC Main Sess,Staff,35,16,19,0,0
6259,Wolfson Campus,ACG 2011 - 0002   Principles Of Accounting 2,0002-LEC Eight Wk 2,Staff,35,9,26,0,0
6257,Wolfson Campus,ACG 2011 - 0003   Principles Of Accounting 2,0003-LEC Main Sess,Staff,25,0,25,0,0
6258,Wolfson Campus,ACG 2011 - 0004   Principles Of Accounting 2,0004-LEC Main Sess,Staff,30,22,8,0,0
5402,North Campus,BSC 2011 - 0001   Principles Of Biology 2,0001-LEC Main Sess,Staff,20,14,6,0,0
5403,North Campus,BSC 2011 - 0002   Principles Of Biology 2,0002-LEC Main Sess,Staff,40,6,34,0,0
5407,North Campus,BSC 2011 - 0004   Principles Of Biology 2,0004-LEC Main Sess,Staff,45,40,5,0,0
5408,Kendall Campus,BSC 2011 - 0005   Principles Of Biology 2,0005-LEC Main Sess,Staff,49,46,3,0,0
5409,Kendall Campus,BSC 2011 - 0006   Principles Of Biology 2,0006-LEC Main Sess,Staff,49,21,28,0,0
5415,Kendall Campus,BSC 2011 - 0007   Principles Of Biology 2,0007-LEC Twelve Wk,Staff,39,14,25,0,0
5410,Kendall Campus,BSC 2011 - 0008   Principles Of Biology 2,0008-LEC Main Sess,Staff,40,38,2,0,0
5416,Kendall Campus,BSC 2011 - 0009   Principles Of Biology 2,0009-LEC Twelve Wk,Staff,1,0,1,0,0
5411,Wolfson Campus,BSC 2011 - 0010   Principles Of Biology 2,0010-LEC Main Sess,Staff,45,43,2,0,0
5412,Wolfson Campus,BSC 2011 - 0011   Principles Of Biology 2,0011-LEC Main Sess,Staff,12,0,12,0,0
5413,Wolfson Campus,BSC 2011 - 0012   Principles Of Biology 2,0012-LEC Main Sess,Staff,45,19,26,0,0
5414,Homestead Campus,BSC 2011 - 0013   Principles Of Biology 2,0013-LEC Main Sess,Staff,39,9,30,0,0
5405,InterAmerican Campus,BSC 2011 - 0014   Principles Of Biology 2,0014-LEC Main Sess,Staff,35,22,13,0,0
5417,InterAmerican Campus,BSC 2011 - 0015   Principles Of Biology 2,0015-LEC Weekend,Staff,40,20,20,0,0
6855,North Campus,ACG 2011L - 0001   Principles Of Accounting 2 Lab,0001-LAB Main Sess,Staff,999,16,983,0,0
6858,Wolfson Campus,ACG 2011L - 0002   Principles Of Accounting 2 Lab,0002-LAB Eight Wk 2,Staff,30,9,21,0,0
6856,Wolfson Campus,ACG 2011L - 0003   Principles Of Accounting 2 Lab,0003-LAB Main Sess,Staff,200,0,200,0,0
6857,Wolfson Campus,ACG 2011L - 0004   Principles Of Accounting 2 Lab,0004-LAB Main Sess,Staff,30,22,8,0,0
5341,North Campus,BSC 2011L - 0001   Principles Of Biology Lab 2,0001-LAB Main Sess,Staff,24,22,2,0,0
5342,North Campus,BSC 2011L - 0002   Principles Of Biology Lab 2,0002-LAB Main Sess,Staff,24,0,24,0,0
5348,North Campus,BSC 2011L - 0003   Principles Of Biology Lab 2,0003-LAB Main Sess,Staff,24,6,18,0,0
5351,North Campus,BSC 2011L - 0006   Principles Of Biology Lab 2,0006-LAB Main Sess,Staff,24,23,1,0,0
5360,Kendall Campus,BSC 2011L - 0007   Principles Of Biology Lab 2,0007-LAB Twelve Wk,Staff,24,16,8,0,0
5361,Kendall Campus,BSC 2011L - 0008   Principles Of Biology Lab 2,0008-LAB 1st Mon Sp,Staff,24,6,18,0,0
5359,Kendall Campus,BSC 2011L - 0009   Principles Of Biology Lab 2,0009-LAB Twelve Wk,Staff,24,7,17,0,0
5352,Kendall Campus,BSC 2011L - 0010   Principles Of Biology Lab 2,0010-LAB Main Sess,Staff,24,19,5,0,0
5353,Kendall Campus,BSC 2011L - 0011   Principles Of Biology Lab 2,0011-LAB Main Sess,Staff,24,9,15,0,0
5354,Kendall Campus,BSC 2011L - 0012   Principles Of Biology Lab 2,0012-LAB Main Sess,Staff,24,23,1,0,0
5355,Kendall Campus,BSC 2011L - 0013   Principles Of Biology Lab 2,0013-LAB Main Sess,Staff,24,14,10,0,0
5356,Kendall Campus,BSC 2011L - 0014   Principles Of Biology Lab 2,0014-LAB Main Sess,Staff,24,23,1,0,0
5357,Wolfson Campus,BSC 2011L - 0015   Principles Of Biology Lab 2,0015-LAB Main Sess,Staff,22,20,2,0,0
5358,Wolfson Campus,BSC 2011L - 0016   Principles Of Biology Lab 2,0016-LAB Main Sess,Staff,22,16,6,0,0
5347,Wolfson Campus,BSC 2011L - 0018   Principles Of Biology Lab 2,0018-LAB Main Sess,Staff,22,0,22,0,0
5364,Wolfson Campus,BSC 2011L - 0019   Principles Of Biology Lab 2,0019-LAB Weekend,Staff,22,9,13,0,0
5346,Homestead Campus,BSC 2011L - 0020   Principles Of Biology Lab 2,0020-LAB Main Sess,Staff,24,9,15,0,0
5345,InterAmerican Campus,BSC 2011L - 0021   Principles Of Biology Lab 2,0021-LAB Main Sess,Staff,20,11,9,0,0
5344,InterAmerican Campus,BSC 2011L - 0022   Principles Of Biology Lab 2,0022-LAB Main Sess,Staff,20,18,2,0,0
5363,InterAmerican Campus,BSC 2011L - 0023   Principles Of Biology Lab 2,0023-LAB 1st Mon Sp,Staff,20,16,4,0,0
5343,Hialeah Campus,BSC 2011L - 0024   Principles Of Biology Lab 2,0024-LAB Main Sess,Staff,24,19,5,0,0
7082,North Campus,AMH 2010 - 0001   History of the US to 1877,0001-LEC Main Sess,Staff,40,31,9,0,0
7083,North Campus,AMH 2010 - 0002   History of the US to 1877,0002-LEC Main Sess,Staff,40,15,25,0,0
7090,Kendall Campus,AMH 2010 - 0003   History of the US to 1877,0003-LEC Main Sess,Staff,30,13,17,0,0
7091,Kendall Campus,AMH 2010 - 0004   History of the US to 1877,0004-LEC Main Sess,Staff,42,15,27,0,0
7092,Kendall Campus,AMH 2010 - 0005   History of the US to 1877,0005-LEC Main Sess,Staff,48,26,22,0,0
7093,Kendall Campus,AMH 2010 - 0006   History of the US to 1877,0006-LEC Main Sess,Staff,49,26,23,0,0
7094,Kendall Campus,AMH 2010 - 0007   History of the US to 1877,0007-LEC Main Sess,Staff,48,0,48,0,0
7095,Kendall Campus,AMH 2010 - 0008   History of the US to 1877,0008-LEC Main Sess,Staff,35,34,1,0,0
7096,Kendall Campus,AMH 2010 - 0009   History of the US to 1877,0009-LEC Main Sess,Staff,30,22,8,0,0
7104,Kendall Campus,AMH 2010 - 0010   History of the US to 1877,0010-LEC Eight Wk 2,Staff,30,27,3,0,0
7097,Wolfson Campus,AMH 2010 - 0011   History of the US to 1877,0011-LEC Main Sess,Staff,45,35,10,0,0
7098,Wolfson Campus,AMH 2010 - 0012   History of the US to 1877,0012-LEC Main Sess,Staff,45,18,27,0,0
7099,Wolfson Campus,AMH 2010 - 0013   History of the US to 1877,0013-LEC Main Sess,Staff,47,0,47,0,0
7106,Wolfson Campus,AMH 2010 - 0014   History of the US to 1877,0014-LEC Conversion,Staff,34,33,1,0,0
7107,Wolfson Campus,AMH 2010 - 0015   History of the US to 1877,0015-LEC Conversion,Staff,34,28,6,0,0
7100,Wolfson Campus,AMH 2010 - 0016   History of the US to 1877,0016-LEC Main Sess,Staff,30,28,2,0,0
7089,Wolfson Campus,AMH 2010 - 0017   History of the US to 1877,0017-LEC Main Sess,Staff,34,32,2,0,0
7102,Homestead Campus,AMH 2010 - 0019   History of the US to 1877,0019-LEC Twelve Wk,Staff,39,0,39,0,0
7103,Homestead Campus,AMH 2010 - 0020   History of the US to 1877,0020-LEC Eight Wk 1,Staff,39,0,39,0,0
7105,Homestead Campus,AMH 2010 - 0021   History of the US to 1877,0021-LEC Eight Wk 2,Staff,39,0,39,0,0
7087,InterAmerican Campus,AMH 2010 - 0022   History of the US to 1877,0022-LEC Main Sess,Staff,37,21,16,0,0
7086,InterAmerican Campus,AMH 2010 - 0023   History of the US to 1877,0023-LEC Main Sess,Staff,29,7,22,0,0
7085,West Campus,AMH 2010 - 0024   History of the US to 1877,0024-LEC Main Sess,Staff,35,14,21,0,0
7101,West Campus,AMH 2010 - 0025   History of the US to 1877,0025-LEC Twelve Wk,Staff,30,0,30,0,0
7084,West Campus,AMH 2010 - 0026   History of the US to 1877,0026-LEC Main Sess,Staff,35,0,35,0,0
7514,North Campus,BSC 2010 - 0001   Principles Of Biology,0001-LEC Main Sess,Staff,45,42,3,0,0
7515,North Campus,BSC 2010 - 0002   Principles Of Biology,0002-LEC Main Sess,Staff,45,25,20,0,0
7518,Kendall Campus,BSC 2010 - 0004   Principles Of Biology,0004-LEC Main Sess,Staff,49,25,24,0,0
7519,Kendall Campus,BSC 2010 - 0005   Principles Of Biology,0005-LEC Main Sess,Staff,49,31,18,0,0
7520,Kendall Campus,BSC 2010 - 0006   Principles Of Biology,0006-LEC Main Sess,Staff,49,18,31,0,0
7521,Kendall Campus,BSC 2010 - 0007   Principles Of Biology,0007-LEC Main Sess,Staff,40,29,11,0,0
7522,Kendall Campus,BSC 2010 - 0008   Principles Of Biology,0008-LEC Main Sess,Staff,49,25,24,0,0
7523,Kendall Campus,BSC 2010 - 0009   Principles Of Biology,0009-LEC Main Sess,Staff,49,29,20,0,0
7532,Kendall Campus,BSC 2010 - 0010   Principles Of Biology,0010-LEC Twelve Wk,Staff,49,26,23,0,0
7525,Wolfson Campus,BSC 2010 - 0012   Principles Of Biology,0012-LEC Main Sess,Staff,45,35,10,0,0
7526,Wolfson Campus,BSC 2010 - 0013   Principles Of Biology,0013-LEC Main Sess,Staff,25,22,3,0,0
7527,Wolfson Campus,BSC 2010 - 0014   Principles Of Biology,0014-LEC Main Sess,Staff,45,0,45,0,0
7528,Wolfson Campus,BSC 2010 - 0015   Principles Of Biology,0015-LEC Main Sess,Staff,30,23,7,0,0
7533,Wolfson Campus,BSC 2010 - 0016   Principles Of Biology,0016-LEC Conversion,Staff,30,20,10,0,0
7529,Homestead Campus,BSC 2010 - 0017   Principles Of Biology,0017-LEC Main Sess,Staff,24,23,1,0,0
7530,InterAmerican Campus,BSC 2010 - 0018   Principles Of Biology,0018-LEC Main Sess,Staff,40,19,21,0,0
7531,InterAmerican Campus,BSC 2010 - 0019   Principles Of Biology,0019-LEC Main Sess,Staff,40,23,17,0,0
7516,Hialeah Campus,BSC 2010 - 0021   Principles Of Biology,0021-LEC Main Sess,Staff,32,0,32,0,0
11337,Kendall Campus,FIN 2010 - 0001   Investments In Stocks And Bonds,0001-LEC Weekend,Staff,32,0,32,0,0
11336,Wolfson Campus,FIN 2010 - 0002   Investments In Stocks And Bonds,0002-LEC Main Sess,Staff,30,19,11,0,0
16305,North Campus,MCB 2010 - 0001   Microbiology,0001-LEC Main Sess,Staff,40,21,19,0,0
16306,North Campus,MCB 2010 - 0002   Microbiology,0002-LEC Main Sess,Staff,40,35,5,0,0
16334,North Campus,MCB 2010 - 0003   Microbiology,0003-LEC Twelve Wk,Staff,40,28,12,0,0
16315,North Campus,MCB 2010 - 0004   Microbiology,0004-LEC Main Sess,Staff,40,35,5,0,0
16316,North Campus,MCB 2010 - 0005   Microbiology,0005-LEC Main Sess,Staff,40,38,2,0,0
16317,North Campus,MCB 2010 - 0006   Microbiology,0006-LEC Main Sess,Staff,40,39,1,0,0
16341,North Campus,MCB 2010 - 0007   Microbiology,0007-LEC Weekend,Staff,40,36,4,0,0
16319,North Campus,MCB 2010 - 0009   Microbiology,0009-LEC Main Sess,Staff,40,25,15,0,0
16322,Kendall Campus,MCB 2010 - 0012   Microbiology,0012-LEC Main Sess,Staff,49,43,6,0,0
16323,Kendall Campus,MCB 2010 - 0013   Microbiology,0013-LEC Main Sess,Staff,40,31,9,0,0
16324,Kendall Campus,MCB 2010 - 0014   Microbiology,0014-LEC Main Sess,Staff,49,46,3,0,0
16325,Kendall Campus,MCB 2010 - 0015   Microbiology,0015-LEC Main Sess,Staff,36,34,2,0,0
16326,Kendall Campus,MCB 2010 - 0016   Microbiology,0016-LEC Main Sess,Staff,38,36,2,0,0
16328,Kendall Campus,MCB 2010 - 0018   Microbiology,0018-LEC Main Sess,Staff,45,0,45,0,0
16335,Kendall Campus,MCB 2010 - 0019   Microbiology,0019-LEC Conversion,Staff,25,23,2,0,0
16329,Kendall Campus,MCB 2010 - 0020   Microbiology,0020-LEC Main Sess,Staff,25,21,4,0,0
16330,Wolfson Campus,MCB 2010 - 0021   Microbiology,0021-LEC Main Sess,Staff,45,25,20,0,0
16331,Wolfson Campus,MCB 2010 - 0022   Microbiology,0022-LEC Main Sess,Staff,45,42,3,0,0
16332,Wolfson Campus,MCB 2010 - 0023   Microbiology,0023-LEC Main Sess,Staff,30,26,4,0,0
16314,Wolfson Campus,MCB 2010 - 0024   Microbiology,0024-LEC Main Sess,Staff,45,25,20,0,0
16313,Wolfson Campus,MCB 2010 - 0025   Microbiology,0025-LEC Main Sess,Staff,30,25,5,0,0
16312,Wolfson Campus,MCB 2010 - 0026   Microbiology,0026-LEC Main Sess,Staff,30,27,3,0,0
16311,Wolfson Campus,MCB 2010 - 0027   Microbiology,0027-LEC Main Sess,Staff,30,25,5,0,0
16310,Wolfson Campus,MCB 2010 - 0028   Microbiology,0028-LEC Main Sess,Staff,30,27,3,0,0
16309,Wolfson Campus,MCB 2010 - 0029   Microbiology,0029-LEC Main Sess,Staff,30,27,3,0,0
16337,Homestead Campus,MCB 2010 - 0030   Microbiology,0030-LEC Conversion,Staff,39,22,17,0,0
16336,Homestead Campus,MCB 2010 - 0031   Microbiology,0031-LEC Conversion,Staff,39,17,22,0,0
16308,Homestead Campus,MCB 2010 - 0032   Microbiology,0032-LEC Main Sess,Staff,39,0,39,0,0
16307,InterAmerican Campus,MCB 2010 - 0033   Microbiology,0033-LEC Main Sess,Staff,40,21,19,0,0
16338,InterAmerican Campus,MCB 2010 - 0034   Microbiology,0034-LEC 1st Mon Sp,Staff,34,31,3,0,0
16340,InterAmerican Campus,MCB 2010 - 0035   Microbiology,0035-LEC Weekend,Staff,20,0,20,0,0
16333,InterAmerican Campus,MCB 2010 - 0036   Microbiology,0036-LEC Twelve Wk,Staff,20,17,3,0,0
16339,InterAmerican Campus,MCB 2010 - 0037   Microbiology,0037-LEC 1st Mon Sp,Staff,20,0,20,0,0
15338,North Campus,PHI 2010 - 0001   Introduction To Philosophy,0001-LEC Main Sess,Staff,40,37,3,0,0
15339,North Campus,PHI 2010 - 0002   Introduction To Philosophy,0002-LEC Main Sess,Staff,20,19,1,0,0
15340,North Campus,PHI 2010 - 0003   Introduction To Philosophy,0003-LEC Main Sess,Staff,40,39,1,0,0
15341,North Campus,PHI 2010 - 0004   Introduction To Philosophy,0004-LEC Main Sess,Staff,35,10,25,0,0
15439,North Campus,PHI 2010 - 0005   Introduction To Philosophy,0005-LEC 1st Mon Sp,Staff,40,39,1,0,0
15343,North Campus,PHI 2010 - 0007   Introduction To Philosophy,0007-LEC Main Sess,Staff,40,37,3,0,0
15347,North Campus,PHI 2010 - 0011   Introduction To Philosophy,0011-LEC Main Sess,Staff,40,37,3,0,0
15425,North Campus,PHI 2010 - 0012   Introduction To Philosophy,0012-LEC Twelve Wk,Staff,30,0,30,0,0
15424,North Campus,PHI 2010 - 0013   Introduction To Philosophy,0013-LEC Twelve Wk,Staff,40,35,5,0,0
15440,North Campus,PHI 2010 - 0014   Introduction To Philosophy,0014-LEC 1st Mon Sp,Staff,40,0,40,0,0
15419,North Campus,PHI 2010 - 0015   Introduction To Philosophy,0015-LEC Main Sess,Staff,40,38,2,0,0
15348,North Campus,PHI 2010 - 0016   Introduction To Philosophy,0016-LEC Main Sess,Staff,40,38,2,0,0
15349,North Campus,PHI 2010 - 0018   Introduction To Philosophy,0018-LEC Main Sess,Staff,40,0,40,0,0
15423,North Campus,PHI 2010 - 0019   Introduction To Philosophy,0019-LEC Twelve Wk,Staff,40,38,2,0,0
15351,Kendall Campus,PHI 2010 - 0021   Introduction To Philosophy,0021-LEC Main Sess,Staff,40,36,4,0,0
15352,Kendall Campus,PHI 2010 - 0022   Introduction To Philosophy,0022-LEC Main Sess,Staff,30,27,3,0,0
15442,Kendall Campus,PHI 2010 - 0023   Introduction To Philosophy,0023-LEC Weekend,Staff,37,30,7,0,0
15353,Kendall Campus,PHI 2010 - 0024   Introduction To Philosophy,0024-LEC Main Sess,Staff,35,0,35,0,0
15354,Kendall Campus,PHI 2010 - 0025   Introduction To Philosophy,0025-LEC Main Sess,Staff,40,34,6,0,0
15355,Kendall Campus,PHI 2010 - 0026   Introduction To Philosophy,0026-LEC Main Sess,Staff,38,33,5,0,0
15356,Kendall Campus,PHI 2010 - 0027   Introduction To Philosophy,0027-LEC Main Sess,Staff,40,38,2,0,0
15357,Kendall Campus,PHI 2010 - 0028   Introduction To Philosophy,0028-LEC Main Sess,Staff,40,34,6,0,0
15358,Kendall Campus,PHI 2010 - 0029   Introduction To Philosophy,0029-LEC Main Sess,Staff,37,34,3,0,0
15359,Kendall Campus,PHI 2010 - 0030   Introduction To Philosophy,0030-LEC Main Sess,Staff,38,24,14,0,0
15361,Kendall Campus,PHI 2010 - 0032   Introduction To Philosophy,0032-LEC Main Sess,Staff,40,0,40,0,0
15363,Kendall Campus,PHI 2010 - 0034   Introduction To Philosophy,0034-LEC Main Sess,Staff,25,0,25,0,0
15364,Kendall Campus,PHI 2010 - 0035   Introduction To Philosophy,0035-LEC Main Sess,Staff,40,36,4,0,0
15366,Kendall Campus,PHI 2010 - 0037   Introduction To Philosophy,0037-LEC Main Sess,Staff,37,36,1,0,0
15367,Kendall Campus,PHI 2010 - 0038   Introduction To Philosophy,0038-LEC Main Sess,Staff,37,34,3,0,0
15422,Kendall Campus,PHI 2010 - 0039   Introduction To Philosophy,0039-LEC Twelve Wk,Staff,30,25,5,0,0
15369,Kendall Campus,PHI 2010 - 0041   Introduction To Philosophy,0041-LEC Main Sess,Staff,40,36,4,0,0
15370,Kendall Campus,PHI 2010 - 0042   Introduction To Philosophy,0042-LEC Main Sess,Staff,40,38,2,0,0
15371,Kendall Campus,PHI 2010 - 0043   Introduction To Philosophy,0043-LEC Main Sess,Staff,40,37,3,0,0
15375,Kendall Campus,PHI 2010 - 0047   Introduction To Philosophy,0047-LEC Main Sess,Staff,40,38,2,0,0
15421,Kendall Campus,PHI 2010 - 0048   Introduction To Philosophy,0048-LEC Twelve Wk,Staff,30,27,3,0,0
15376,Wolfson Campus,PHI 2010 - 0049   Introduction To Philosophy,0049-LEC Main Sess,Staff,45,44,1,0,0
15377,Wolfson Campus,PHI 2010 - 0050   Introduction To Philosophy,0050-LEC Main Sess,Staff,50,43,7,0,0
15378,Wolfson Campus,PHI 2010 - 0051   Introduction To Philosophy,0051-LEC Main Sess,Staff,50,40,10,0,0
15434,Wolfson Campus,PHI 2010 - 0055   Introduction To Philosophy,0055-LEC Conversion,Staff,35,30,5,0,0
15433,Wolfson Campus,PHI 2010 - 0056   Introduction To Philosophy,0056-LEC Conversion,Staff,50,31,19,0,0
15420,Wolfson Campus,PHI 2010 - 0057   Introduction To Philosophy,0057-LEC Twelve Wk,Staff,1,0,1,0,0
15437,Wolfson Campus,PHI 2010 - 0058   Introduction To Philosophy,0058-LEC Conversion,Staff,30,0,30,0,0
15383,Wolfson Campus,PHI 2010 - 0060   Introduction To Philosophy,0060-LEC Main Sess,Staff,50,49,1,0,0
15384,Wolfson Campus,PHI 2010 - 0061   Introduction To Philosophy,0061-LEC Main Sess,Staff,50,48,2,0,0
15426,Wolfson Campus,PHI 2010 - 0062   Introduction To Philosophy,0062-LEC Eight Wk 2,Staff,1,0,1,0,0
15427,Wolfson Campus,PHI 2010 - 0063   Introduction To Philosophy,0063-LEC Eight Wk 2,Staff,50,48,2,0,0
15385,Wolfson Campus,PHI 2010 - 0064   Introduction To Philosophy,0064-LEC Main Sess,Staff,34,28,6,0,0
15386,Wolfson Campus,PHI 2010 - 0065   Introduction To Philosophy,0065-LEC Main Sess,Staff,34,29,5,0,0
15387,Wolfson Campus,PHI 2010 - 0066   Introduction To Philosophy,0066-LEC Main Sess,Staff,34,30,4,0,0
15388,Wolfson Campus,PHI 2010 - 0067   Introduction To Philosophy,0067-LEC Main Sess,Staff,34,33,1,0,0
15389,Wolfson Campus,PHI 2010 - 0068   Introduction To Philosophy,0068-LEC Main Sess,Staff,34,28,6,0,0
15390,Wolfson Campus,PHI 2010 - 0069   Introduction To Philosophy,0069-LEC Main Sess,Staff,34,31,3,0,0
15431,Wolfson Campus,PHI 2010 - 0071   Introduction To Philosophy,0071-LEC Conversion,Staff,34,33,1,0,0
15430,Wolfson Campus,PHI 2010 - 0072   Introduction To Philosophy,0072-LEC Conversion,Staff,34,33,1,0,0
15391,Wolfson Campus,PHI 2010 - 0073   Introduction To Philosophy,0073-LEC Main Sess,Staff,30,27,3,0,0
15392,Wolfson Campus,PHI 2010 - 0074   Introduction To Philosophy,0074-LEC Main Sess,Staff,30,28,2,0,0
15393,Wolfson Campus,PHI 2010 - 0075   Introduction To Philosophy,0075-LEC Main Sess,Staff,34,29,5,0,0
15394,Wolfson Campus,PHI 2010 - 0076   Introduction To Philosophy,0076-LEC Main Sess,Staff,34,28,6,0,0
15429,Wolfson Campus,PHI 2010 - 0077   Introduction To Philosophy,0077-LEC Conversion,Staff,34,31,3,0,0
15395,Wolfson Campus,PHI 2010 - 0078   Introduction To Philosophy,0078-LEC Main Sess,Staff,34,31,3,0,0
15396,Wolfson Campus,PHI 2010 - 0079   Introduction To Philosophy,0079-LEC Main Sess,Staff,30,28,2,0,0
15397,Wolfson Campus,PHI 2010 - 0080   Introduction To Philosophy,0080-LEC Main Sess,Staff,30,29,1,0,0
15398,Wolfson Campus,PHI 2010 - 0081   Introduction To Philosophy,0081-LEC Main Sess,Staff,34,30,4,0,0
15399,Homestead Campus,PHI 2010 - 0082   Introduction To Philosophy,0082-LEC Main Sess,Staff,39,37,2,0,0
15403,InterAmerican Campus,PHI 2010 - 0086   Introduction To Philosophy,0086-LEC Main Sess,Staff,29,0,29,0,0
15404,InterAmerican Campus,PHI 2010 - 0087   Introduction To Philosophy,0087-LEC Main Sess,Staff,36,35,1,0,0
15405,InterAmerican Campus,PHI 2010 - 0088   Introduction To Philosophy,0088-LEC Main Sess,Staff,36,19,17,0,0
15406,InterAmerican Campus,PHI 2010 - 0089   Introduction To Philosophy,0089-LEC Main Sess,Staff,38,33,5,0,0
15407,InterAmerican Campus,PHI 2010 - 0090   Introduction To Philosophy,0090-LEC Main Sess,Staff,20,11,9,0,0
15408,InterAmerican Campus,PHI 2010 - 0091   Introduction To Philosophy,0091-LEC Main Sess,Staff,25,16,9,0,0
15410,InterAmerican Campus,PHI 2010 - 0093   Introduction To Philosophy,0093-LEC Main Sess,Staff,35,31,4,0,0
15438,Hialeah Campus,PHI 2010 - 0095   Introduction To Philosophy,0095-LEC 1st Mon Sp,Staff,45,44,1,0,0
15412,Hialeah Campus,PHI 2010 - 0096   Introduction To Philosophy,0096-LEC Main Sess,Staff,36,30,6,0,0
15413,Hialeah Campus,PHI 2010 - 0097   Introduction To Philosophy,0097-LEC Main Sess,Staff,36,33,3,0,0
15415,Hialeah Campus,PHI 2010 - 0099   Introduction To Philosophy,0099-LEC Main Sess,Staff,36,34,2,0,0
15436,West Campus,PHI 2010 - 0100   Introduction To Philosophy,0100-LEC Conversion,Staff,35,19,16,0,0
15416,West Campus,PHI 2010 - 0101   Introduction To Philosophy,0101-LEC Main Sess,Staff,35,31,4,0,0
15428,West Campus,PHI 2010 - 0102   Introduction To Philosophy,0102-LEC Conversion,Staff,35,24,11,0,0
15417,West Campus,PHI 2010 - 0103   Introduction To Philosophy,0103-LEC Main Sess,Staff,35,0,35,0,0
15418,West Campus,PHI 2010 - 0104   Introduction To Philosophy,0104-LEC Main Sess,Staff,35,27,8,0,0
12012,Medical Campus,RTE 2010 - 0001   New Imaging Modalities In Radiology,0001-LEC Eight Wk 2,Staff,45,0,45,0,0
13230,North Campus,SYG 2010 - 0001   Social Problems,0001-LEC Main Sess,Staff,40,28,12,0,0
13229,Kendall Campus,SYG 2010 - 0002   Social Problems,0002-LEC Main Sess,Staff,40,0,40,0,0
11109,North Campus,TAX 2010 - 0001   Business Taxes & Returns,0001-LEC Twelve Wk,Staff,24,15,9,0,0
11107,Kendall Campus,TAX 2010 - 0002   Business Taxes & Returns,0002-LEC Main Sess,Staff,25,12,13,0,0
11110,Wolfson Campus,TAX 2010 - 0003   Business Taxes & Returns,0003-LEC Twelve Wk,Staff,30,13,17,0,0
11112,Hialeah Campus,TAX 2010 - 0004   Business Taxes & Returns,0004-LEC Eight Wk 2,Staff,30,24,6,0,0
11108,West Campus,TAX 2010 - 0005   Business Taxes & Returns,0005-LEC Main Sess,Staff,30,0,30,0,0
11111,West Campus,TAX 2010 - 0006   Business Taxes & Returns,0006-LEC Twelve Wk,Staff,30,0,30,0,0
17250,Homestead Campus,TRA 2010 - 0001   Introduction To Transportation And Logistics,0001-LEC Eight Wk 1,Staff,30,27,3,0,0
7201,North Campus,BSC 2010L - 0001   Principles Of Biology 1 Laboratory,0001-LAB Main Sess,Staff,24,23,1,0,0
7202,North Campus,BSC 2010L - 0002   Principles Of Biology 1 Laboratory,0002-LAB Main Sess,Staff,24,18,6,0,0
7230,North Campus,BSC 2010L - 0004   Principles Of Biology 1 Laboratory,0004-LAB 1st Mon Sp,Staff,24,0,24,0,0
7211,North Campus,BSC 2010L - 0006   Principles Of Biology 1 Laboratory,0006-LAB Main Sess,Staff,24,20,4,0,0
7212,North Campus,BSC 2010L - 0007   Principles Of Biology 1 Laboratory,0007-LAB Main Sess,Staff,24,9,15,0,0
7213,North Campus,BSC 2010L - 0008   Principles Of Biology 1 Laboratory,0008-LAB Main Sess,Staff,10,0,10,0,0
7214,Kendall Campus,BSC 2010L - 0009   Principles Of Biology 1 Laboratory,0009-LAB Main Sess,Staff,24,19,5,0,0
7215,Kendall Campus,BSC 2010L - 0010   Principles Of Biology 1 Laboratory,0010-LAB Main Sess,Staff,24,9,15,0,0
7223,Kendall Campus,BSC 2010L - 0011   Principles Of Biology 1 Laboratory,0011-LAB Twelve Wk,Staff,24,22,2,0,0
7216,Kendall Campus,BSC 2010L - 0012   Principles Of Biology 1 Laboratory,0012-LAB Main Sess,Staff,24,18,6,0,0
7217,Kendall Campus,BSC 2010L - 0013   Principles Of Biology 1 Laboratory,0013-LAB Main Sess,Staff,24,13,11,0,0
7218,Kendall Campus,BSC 2010L - 0014   Principles Of Biology 1 Laboratory,0014-LAB Main Sess,Staff,24,15,9,0,0
7219,Kendall Campus,BSC 2010L - 0016   Principles Of Biology 1 Laboratory,0016-LAB Main Sess,Staff,24,10,14,0,0
7220,Kendall Campus,BSC 2010L - 0017   Principles Of Biology 1 Laboratory,0017-LAB Main Sess,Staff,24,12,12,0,0
7221,Kendall Campus,BSC 2010L - 0018   Principles Of Biology 1 Laboratory,0018-LAB Main Sess,Staff,24,15,9,0,0
7224,Kendall Campus,BSC 2010L - 0019   Principles Of Biology 1 Laboratory,0019-LAB Twelve Wk,Staff,24,11,13,0,0
7226,Kendall Campus,BSC 2010L - 0020   Principles Of Biology 1 Laboratory,0020-LAB 1st Mon Sp,Staff,24,17,7,0,0
7222,Kendall Campus,BSC 2010L - 0021   Principles Of Biology 1 Laboratory,0021-LAB Main Sess,Staff,24,10,14,0,0
7210,Kendall Campus,BSC 2010L - 0022   Principles Of Biology 1 Laboratory,0022-LAB Main Sess,Staff,24,0,24,0,0
7203,Wolfson Campus,BSC 2010L - 0024   Principles Of Biology 1 Laboratory,0024-LAB Main Sess,Staff,22,20,2,0,0
7231,Wolfson Campus,BSC 2010L - 0025   Principles Of Biology 1 Laboratory,0025-LAB 1st Mon Sp,Staff,22,12,10,0,0
7207,Homestead Campus,BSC 2010L - 0027   Principles Of Biology 1 Laboratory,0027-LAB Main Sess,Staff,24,23,1,0,0
7206,InterAmerican Campus,BSC 2010L - 0028   Principles Of Biology 1 Laboratory,0028-LAB Main Sess,Staff,20,10,10,0,0
7205,InterAmerican Campus,BSC 2010L - 0029   Principles Of Biology 1 Laboratory,0029-LAB Main Sess,Staff,20,14,6,0,0
7204,InterAmerican Campus,BSC 2010L - 0030   Principles Of Biology 1 Laboratory,0030-LAB Main Sess,Staff,20,15,5,0,0
8944,North Campus,MCB 2010L - 0001   Microbiology Laboratory,0001-LAB Main Sess,Staff,24,20,4,0,0
8945,North Campus,MCB 2010L - 0002   Microbiology Laboratory,0002-LAB Main Sess,Staff,24,20,4,0,0
8949,North Campus,MCB 2010L - 0003   Microbiology Laboratory,0003-LAB Main Sess,Staff,24,22,2,0,0
8986,North Campus,MCB 2010L - 0004   Microbiology Laboratory,0004-LAB 1st Mon Sp,Staff,24,22,2,0,0
8987,North Campus,MCB 2010L - 0005   Microbiology Laboratory,0005-LAB 1st Mon Sp,Staff,24,22,2,0,0
8956,North Campus,MCB 2010L - 0006   Microbiology Laboratory,0006-LAB Main Sess,Staff,24,17,7,0,0
8957,North Campus,MCB 2010L - 0007   Microbiology Laboratory,0007-LAB Main Sess,Staff,24,19,5,0,0
8958,North Campus,MCB 2010L - 0008   Microbiology Laboratory,0008-LAB Main Sess,Staff,24,23,1,0,0
8959,North Campus,MCB 2010L - 0009   Microbiology Laboratory,0009-LAB Main Sess,Staff,24,23,1,0,0
8948,North Campus,MCB 2010L - 0010   Microbiology Laboratory,0010-LAB Main Sess,Staff,24,23,1,0,0
8992,North Campus,MCB 2010L - 0012   Microbiology Laboratory,0012-LAB Weekend,Staff,24,13,11,0,0
8990,North Campus,MCB 2010L - 0013   Microbiology Laboratory,0013-LAB Weekend,Staff,24,20,4,0,0
8960,North Campus,MCB 2010L - 0014   Microbiology Laboratory,0014-LAB Main Sess,Staff,24,18,6,0,0
8962,North Campus,MCB 2010L - 0016   Microbiology Laboratory,0016-LAB Main Sess,Staff,24,22,2,0,0
8963,North Campus,MCB 2010L - 0017   Microbiology Laboratory,0017-LAB Main Sess,Staff,24,20,4,0,0
8985,North Campus,MCB 2010L - 0018   Microbiology Laboratory,0018-LAB 1st Mon Sp,Staff,24,23,1,0,0
8964,North Campus,MCB 2010L - 0019   Microbiology Laboratory,0019-LAB Main Sess,Staff,24,8,16,0,0
8965,Kendall Campus,MCB 2010L - 0020   Microbiology Laboratory,0020-LAB Main Sess,Staff,24,23,1,0,0
8966,Kendall Campus,MCB 2010L - 0021   Microbiology Laboratory,0021-LAB Main Sess,Staff,24,23,1,0,0
8967,Kendall Campus,MCB 2010L - 0022   Microbiology Laboratory,0022-LAB Main Sess,Staff,24,11,13,0,0
8968,Kendall Campus,MCB 2010L - 0023   Microbiology Laboratory,0023-LAB Main Sess,Staff,24,19,5,0,0
8970,Kendall Campus,MCB 2010L - 0025   Microbiology Laboratory,0025-LAB Main Sess,Staff,24,23,1,0,0
8971,Kendall Campus,MCB 2010L - 0026   Microbiology Laboratory,0026-LAB Main Sess,Staff,24,0,24,0,0
8972,Kendall Campus,MCB 2010L - 0027   Microbiology Laboratory,0027-LAB Main Sess,Staff,24,21,3,0,0
8973,Kendall Campus,MCB 2010L - 0028   Microbiology Laboratory,0028-LAB Main Sess,Staff,24,19,5,0,0
8974,Kendall Campus,MCB 2010L - 0029   Microbiology Laboratory,0029-LAB Main Sess,Staff,24,15,9,0,0
8975,Kendall Campus,MCB 2010L - 0030   Microbiology Laboratory,0030-LAB Main Sess,Staff,24,22,2,0,0
8976,Kendall Campus,MCB 2010L - 0031   Microbiology Laboratory,0031-LAB Main Sess,Staff,24,22,2,0,0
8977,Kendall Campus,MCB 2010L - 0032   Microbiology Laboratory,0032-LAB Main Sess,Staff,24,22,2,0,0
8978,Kendall Campus,MCB 2010L - 0033   Microbiology Laboratory,0033-LAB Main Sess,Staff,24,22,2,0,0
8979,Kendall Campus,MCB 2010L - 0034   Microbiology Laboratory,0034-LAB Main Sess,Staff,5,0,5,0,0
8980,Wolfson Campus,MCB 2010L - 0035   Microbiology Laboratory,0035-LAB Main Sess,Staff,22,18,4,0,0
8981,Wolfson Campus,MCB 2010L - 0036   Microbiology Laboratory,0036-LAB Main Sess,Staff,22,18,4,0,0
8955,Wolfson Campus,MCB 2010L - 0037   Microbiology Laboratory,0037-LAB Main Sess,Staff,22,11,11,0,0
8946,Wolfson Campus,MCB 2010L - 0038   Microbiology Laboratory,0038-LAB Main Sess,Staff,22,17,5,0,0
8991,Wolfson Campus,MCB 2010L - 0039   Microbiology Laboratory,0039-LAB Weekend,Staff,22,19,3,0,0
8988,Wolfson Campus,MCB 2010L - 0040   Microbiology Laboratory,0040-LAB 1st Mon Sp,Staff,22,0,22,0,0
8954,Wolfson Campus,MCB 2010L - 0041   Microbiology Laboratory,0041-LAB Main Sess,Staff,22,20,2,0,0
8953,Wolfson Campus,MCB 2010L - 0042   Microbiology Laboratory,0042-LAB Main Sess,Staff,22,18,4,0,0
8984,Homestead Campus,MCB 2010L - 0045   Microbiology Laboratory,0045-LAB Conversion,Staff,24,23,1,0,0
8952,Homestead Campus,MCB 2010L - 0046   Microbiology Laboratory,0046-LAB Main Sess,Staff,24,0,24,0,0
8951,Homestead Campus,MCB 2010L - 0047   Microbiology Laboratory,0047-LAB Main Sess,Staff,24,0,24,0,0
8950,Homestead Campus,MCB 2010L - 0048   Microbiology Laboratory,0048-LAB Main Sess,Staff,24,0,24,0,0
8983,Homestead Campus,MCB 2010L - 0049   Microbiology Laboratory,0049-LAB Conversion,Staff,24,17,7,0,0
14642,North Campus,IDH 2004 - 0001   Honors Leadership Seminar 4,0001-LEC Main Sess,Staff,20,16,4,0,0
14643,North Campus,IDH 2004 - 0002   Honors Leadership Seminar 4,0002-LEC Main Sess,Staff,20,18,2,0,0
14644,North Campus,IDH 2004 - 0003   Honors Leadership Seminar 4,0003-LEC Main Sess,Staff,20,14,6,0,0
14652,Kendall Campus,IDH 2004 - 0005   Honors Leadership Seminar 4,0005-LEC Conversion,Staff,25,22,3,0,0
14645,Kendall Campus,IDH 2004 - 0006   Honors Leadership Seminar 4,0006-LEC Main Sess,Staff,25,0,25,0,0
14650,InterAmerican Campus,IDH 2004 - 0010   Honors Leadership Seminar 4,0010-LEC Main Sess,Staff,23,16,7,0,0
14649,InterAmerican Campus,IDH 2004 - 0011   Honors Leadership Seminar 4,0011-LEC Main Sess,Staff,25,20,5,0,0
14648,InterAmerican Campus,IDH 2004 - 0012   Honors Leadership Seminar 4,0012-LEC Main Sess,Staff,25,0,25,0,0
14665,North Campus,LIS 2004 - 0001   Introduction to Internet Research,0001-LEC Twelve Wk,Staff,25,0,25,0,0
14666,North Campus,LIS 2004 - 0002   Introduction to Internet Research,0002-LEC Twelve Wk,Staff,25,0,25,0,0
14673,Kendall Campus,LIS 2004 - 0003   Introduction to Internet Research,0003-LEC Eight Wk 2,Staff,20,16,4,0,0
14658,Kendall Campus,LIS 2004 - 0004   Introduction to Internet Research,0004-LEC Main Sess,Staff,20,0,20,0,0
14672,Kendall Campus,LIS 2004 - 0005   Introduction to Internet Research,0005-LEC Eight Wk 1,Staff,20,12,8,0,0
14671,Kendall Campus,LIS 2004 - 0006   Introduction to Internet Research,0006-LEC Eight Wk 1,Staff,20,0,20,0,0
14659,Wolfson Campus,LIS 2004 - 0007   Introduction to Internet Research,0007-LEC Main Sess,Staff,25,0,25,0,0
14660,Wolfson Campus,LIS 2004 - 0008   Introduction to Internet Research,0008-LEC Main Sess,Staff,15,0,15,0,0
14661,Wolfson Campus,LIS 2004 - 0009   Introduction to Internet Research,0009-LEC Main Sess,Staff,30,26,4,0,0
14662,Wolfson Campus,LIS 2004 - 0010   Introduction to Internet Research,0010-LEC Main Sess,Staff,30,27,3,0,0
14663,InterAmerican Campus,LIS 2004 - 0011   Introduction to Internet Research,0011-LEC Main Sess,Staff,21,0,21,0,0
14664,InterAmerican Campus,LIS 2004 - 0012   Introduction to Internet Research,0012-LEC Main Sess,Staff,21,0,21,0,0
14674,InterAmerican Campus,LIS 2004 - 0013   Introduction to Internet Research,0013-LEC 1st Mon Sp,Staff,25,0,25,0,0
14670,InterAmerican Campus,LIS 2004 - 0014   Introduction to Internet Research,0014-LEC Twelve Wk,Staff,21,0,21,0,0
14669,InterAmerican Campus,LIS 2004 - 0015   Introduction to Internet Research,0015-LEC Twelve Wk,Staff,21,7,14,0,0
14675,InterAmerican Campus,LIS 2004 - 0016   Introduction to Internet Research,0016-LEC 1st Mon Sp,Staff,25,18,7,0,0
14668,Hialeah Campus,LIS 2004 - 0017   Introduction to Internet Research,0017-LEC Twelve Wk,Staff,25,0,25,0,0
14667,Hialeah Campus,LIS 2004 - 0018   Introduction to Internet Research,0018-LEC Twelve Wk,Staff,25,8,17,0,0
13091,North Campus,PLA 2003 - 0001   Fundamentals Of Law,0001-LEC Main Sess,Staff,25,0,25,0,0
13092,North Campus,PLA 2003 - 0002   Fundamentals Of Law,0002-LEC Main Sess,Staff,25,0,25,0,0
13097,Kendall Campus,PLA 2003 - 0003   Fundamentals Of Law,0003-LEC 1st Mon Sp,Staff,25,18,7,0,0
13093,Kendall Campus,PLA 2003 - 0004   Fundamentals Of Law,0004-LEC Main Sess,Staff,25,20,5,0,0
13094,Wolfson Campus,PLA 2003 - 0005   Fundamentals Of Law,0005-LEC Main Sess,Staff,25,11,14,0,0
13095,Wolfson Campus,PLA 2003 - 0006   Fundamentals Of Law,0006-LEC Main Sess,Staff,30,11,19,0,0
13096,Wolfson Campus,PLA 2003 - 0007   Fundamentals Of Law,0007-LEC Main Sess,Staff,25,19,6,0,0
15699,North Campus,PUR 2003 - 0001   Public Relations,0001-LEC Main Sess,Staff,30,14,16,0,0
15704,North Campus,PUR 2003 - 0002   Public Relations,0002-LEC Twelve Wk,Staff,30,0,30,0,0
15700,Kendall Campus,PUR 2003 - 0003   Public Relations,0003-LEC Main Sess,Staff,36,32,4,0,0
15705,Wolfson Campus,PUR 2003 - 0004   Public Relations,0004-LEC Twelve Wk,Staff,30,0,30,0,0
15701,Wolfson Campus,PUR 2003 - 0005   Public Relations,0005-LEC Main Sess,Staff,45,0,45,0,0
15702,Wolfson Campus,PUR 2003 - 0006   Public Relations,0006-LEC Main Sess,Staff,30,29,1,0,0
15703,Wolfson Campus,PUR 2003 - 0007   Public Relations,0007-LEC Main Sess,Staff,30,28,2,0,0
8486,North Campus,CJJ 2002 - 0001   Juvenile Delinquency,0001-LEC Main Sess,Staff,30,28,2,0,0
8494,North Campus,CJJ 2002 - 0002   Juvenile Delinquency,0002-LEC Twelve Wk,Staff,30,13,17,0,0
8487,North Campus,CJJ 2002 - 0003   Juvenile Delinquency,0003-LEC Main Sess,Staff,30,0,30,0,0
8488,North Campus,CJJ 2002 - 0004   Juvenile Delinquency,0004-LEC Main Sess,Staff,30,17,13,0,0
8490,Wolfson Campus,CJJ 2002 - 0006   Juvenile Delinquency,0006-LEC Main Sess,Staff,34,30,4,0,0
8496,Wolfson Campus,CJJ 2002 - 0007   Juvenile Delinquency,0007-LEC Conversion,Staff,34,0,34,0,0
8491,InterAmerican Campus,CJJ 2002 - 0008   Juvenile Delinquency,0008-LEC Main Sess,Staff,30,0,30,0,0
8493,Hialeah Campus,CJJ 2002 - 0009   Juvenile Delinquency,0009-LEC Main Sess,Staff,25,0,25,0,0
8495,West Campus,CJJ 2002 - 0010   Juvenile Delinquency,0010-LEC Twelve Wk,Staff,30,9,21,0,0
8492,West Campus,CJJ 2002 - 0011   Juvenile Delinquency,0011-LEC Main Sess,Staff,35,0,35,0,0
6708,North Campus,CRW 2002 - 0001   Creative Writing 2,0001-LEC Main Sess,Staff,25,0,25,0,0
6709,North Campus,CRW 2002 - 0002   Creative Writing 2,0002-LEC Main Sess,Staff,25,16,9,0,0
6710,North Campus,CRW 2002 - 0003   Creative Writing 2,0003-LEC Main Sess,Staff,10,0,10,0,0
6717,Kendall Campus,CRW 2002 - 0005   Creative Writing 2,0005-LEC Main Sess,Staff,25,6,19,0,0
6713,Wolfson Campus,CRW 2002 - 0006   Creative Writing 2,0006-LEC Main Sess,Staff,5,0,5,0,0
6714,Wolfson Campus,CRW 2002 - 0007   Creative Writing 2,0007-LEC Main Sess,Staff,10,5,5,0,0
6715,Wolfson Campus,CRW 2002 - 0008   Creative Writing 2,0008-LEC Main Sess,Staff,13,6,7,0,0
6716,InterAmerican Campus,CRW 2002 - 0009   Creative Writing 2,0009-LEC Main Sess,Staff,21,2,19,0,0
6712,Hialeah Campus,CRW 2002 - 0010   Creative Writing 2,0010-LEC Main Sess,Staff,25,20,5,0,0
14493,North Campus,EEC 2002 - 0001   Operation Of An Early Childhood Facility,0001-LEC Main Sess,Staff,25,15,10,0,0
14494,Kendall Campus,EEC 2002 - 0002   Operation Of An Early Childhood Facility,0002-LEC Weekend,Staff,25,22,3,0,0
11287,North Campus,INR 2002 - 0001   International Relations,0001-LEC Main Sess,Staff,40,0,40,0,0
11288,North Campus,INR 2002 - 0002   International Relations,0002-LEC Main Sess,Staff,40,33,7,0,0
11289,Kendall Campus,INR 2002 - 0003   International Relations,0003-LEC Main Sess,Staff,37,33,4,0,0
11290,Kendall Campus,INR 2002 - 0004   International Relations,0004-LEC Main Sess,Staff,30,27,3,0,0
11291,Kendall Campus,INR 2002 - 0005   International Relations,0005-LEC Main Sess,Staff,5,0,5,0,0
11292,Kendall Campus,INR 2002 - 0006   International Relations,0006-LEC Main Sess,Staff,40,27,13,0,0
11293,Wolfson Campus,INR 2002 - 0007   International Relations,0007-LEC Main Sess,Staff,47,0,47,0,0
11297,Wolfson Campus,INR 2002 - 0008   International Relations,0008-LEC 1st Mon Sp,Staff,45,32,13,0,0
11294,Wolfson Campus,INR 2002 - 0009   International Relations,0009-LEC Main Sess,Staff,45,39,6,0,0
11295,Wolfson Campus,INR 2002 - 0010   International Relations,0010-LEC Main Sess,Staff,30,0,30,0,0
11296,InterAmerican Campus,INR 2002 - 0011   International Relations,0011-LEC Main Sess,Staff,25,0,25,0,0
16916,North Campus,SOP 2002 - 0001   Social Psychology,0001-LEC Main Sess,Staff,35,31,4,0,0
16922,Kendall Campus,SOP 2002 - 0002   Social Psychology,0002-LEC Eight Wk 1,Staff,36,15,21,0,0
16917,Kendall Campus,SOP 2002 - 0003   Social Psychology,0003-LEC Main Sess,Staff,40,30,10,0,0
16918,Kendall Campus,SOP 2002 - 0004   Social Psychology,0004-LEC Main Sess,Staff,35,22,13,0,0
16919,Kendall Campus,SOP 2002 - 0005   Social Psychology,0005-LEC Main Sess,Staff,30,0,30,0,0
16921,Kendall Campus,SOP 2002 - 0006   Social Psychology,0006-LEC Twelve Wk,Staff,30,28,2,0,0
16920,Wolfson Campus,SOP 2002 - 0007   Social Psychology,0007-LEC Main Sess,Staff,47,24,23,0,0
16923,Wolfson Campus,SOP 2002 - 0008   Social Psychology,0008-LEC Conversion,Staff,15,0,15,0,0
8627,North Campus,ACG 2001 - 0001   Principles Of Accounting 1,0001-LEC Main Sess,Staff,35,20,15,0,0
8628,Kendall Campus,ACG 2001 - 0002   Principles Of Accounting 1,0002-LEC Main Sess,Staff,25,8,17,0,0
8629,Wolfson Campus,ACG 2001 - 0003   Principles Of Accounting 1,0003-LEC Main Sess,Staff,35,0,35,0,0
8631,Wolfson Campus,ACG 2001 - 0004   Principles Of Accounting 1,0004-LEC Eight Wk 1,Staff,35,7,28,0,0
8630,Wolfson Campus,ACG 2001 - 0005   Principles Of Accounting 1,0005-LEC Main Sess,Staff,30,27,3,0,0
5973,North Campus,CRW 2001 - 0001   Creative Writing 1,0001-LEC Main Sess,Staff,20,18,2,0,0
5975,Kendall Campus,CRW 2001 - 0003   Creative Writing 1,0003-LEC Main Sess,Staff,25,16,9,0,0
5976,Kendall Campus,CRW 2001 - 0004   Creative Writing 1,0004-LEC Main Sess,Staff,25,19,6,0,0
5981,Wolfson Campus,CRW 2001 - 0005   Creative Writing 1,0005-LEC Main Sess,Staff,16,12,4,0,0
5979,Wolfson Campus,CRW 2001 - 0007   Creative Writing 1,0007-LEC Main Sess,Staff,20,18,2,0,0
5980,Homestead Campus,CRW 2001 - 0008   Creative Writing 1,0008-LEC Main Sess,Staff,30,0,30,0,0
5977,InterAmerican Campus,CRW 2001 - 0009   Creative Writing 1,0009-LEC Main Sess,Staff,21,4,17,0,0
10404,North Campus,MUC 2001 - 0001   Experimental Composition,0001-LEC Main Sess,Staff,20,9,11,0,0
16954,Kendall Campus,SPA 2001 - 0001   Introduction To Communication Disorders,0001-LEC Main Sess,Staff,20,17,3,0,0
8655,North Campus,ACG 2001L - 0001   Principles Of Accounting 1 Lab,0001-LAB Main Sess,Staff,999,20,979,0,0
8656,Kendall Campus,ACG 2001L - 0002   Principles Of Accounting 1 Lab,0002-LAB Main Sess,Staff,25,8,17,0,0
8659,Wolfson Campus,ACG 2001L - 0003   Principles Of Accounting 1 Lab,0003-LAB Eight Wk 1,Staff,30,7,23,0,0
8657,Wolfson Campus,ACG 2001L - 0004   Principles Of Accounting 1 Lab,0004-LAB Main Sess,Staff,150,0,150,0,0
8658,Wolfson Campus,ACG 2001L - 0005   Principles Of Accounting 1 Lab,0005-LAB Main Sess,Staff,30,27,3,0,0
5273,Wolfson Campus,ANT 2000 - 0001,0001-LEC Main Sess,Staff,45,42,3,0,0
5274,InterAmerican Campus,ANT 2000 - 0002,0002-LEC Eight Wk 2,Staff,30,0,30,0,0
7403,Kendall Campus,CLP 2000 - 0001   Dynamics Of Behavior,0001-LEC 1st Mon Sp,Staff,30,20,10,0,0
14088,North Campus,DEP 2000 - 0001   Human Growth And Development,0001-LEC Main Sess,Staff,40,39,1,0,0
14089,North Campus,DEP 2000 - 0002   Human Growth And Development,0002-LEC Main Sess,Staff,40,28,12,0,0
14090,North Campus,DEP 2000 - 0003   Human Growth And Development,0003-LEC Main Sess,Staff,40,39,1,0,0
14173,North Campus,DEP 2000 - 0004   Human Growth And Development,0004-LEC Twelve Wk,Staff,40,31,9,0,0
14184,North Campus,DEP 2000 - 0005   Human Growth And Development,0005-LEC 1st Mon Sp,Staff,40,35,5,0,0
14091,North Campus,DEP 2000 - 0006   Human Growth And Development,0006-LEC Main Sess,Staff,35,33,2,0,0
14092,North Campus,DEP 2000 - 0007   Human Growth And Development,0007-LEC Main Sess,Staff,40,28,12,0,0
14093,North Campus,DEP 2000 - 0008   Human Growth And Development,0008-LEC Main Sess,Staff,40,35,5,0,0
14094,North Campus,DEP 2000 - 0009   Human Growth And Development,0009-LEC Main Sess,Staff,40,22,18,0,0
14095,North Campus,DEP 2000 - 0010   Human Growth And Development,0010-LEC Main Sess,Staff,40,21,19,0,0
14096,North Campus,DEP 2000 - 0011   Human Growth And Development,0011-LEC Main Sess,Staff,40,36,4,0,0
14097,North Campus,DEP 2000 - 0012   Human Growth And Development,0012-LEC Main Sess,Staff,40,35,5,0,0
14098,North Campus,DEP 2000 - 0013   Human Growth And Development,0013-LEC Main Sess,Staff,40,0,40,0,0
14099,North Campus,DEP 2000 - 0014   Human Growth And Development,0014-LEC Main Sess,Staff,40,0,40,0,0
14100,North Campus,DEP 2000 - 0015   Human Growth And Development,0015-LEC Main Sess,Staff,20,14,6,0,0
14169,North Campus,DEP 2000 - 0016   Human Growth And Development,0016-LEC Twelve Wk,Staff,40,0,40,0,0
14101,North Campus,DEP 2000 - 0018   Human Growth And Development,0018-LEC Main Sess,Staff,30,0,30,0,0
14102,North Campus,DEP 2000 - 0019   Human Growth And Development,0019-LEC Main Sess,Staff,40,0,40,0,0
14174,North Campus,DEP 2000 - 0020   Human Growth And Development,0020-LEC Twelve Wk,Staff,40,20,20,0,0
14171,North Campus,DEP 2000 - 0021   Human Growth And Development,0021-LEC Twelve Wk,Staff,40,16,24,0,0
14103,Kendall Campus,DEP 2000 - 0022   Human Growth And Development,0022-LEC Main Sess,Staff,45,44,1,0,0
14104,Kendall Campus,DEP 2000 - 0023   Human Growth And Development,0023-LEC Main Sess,Staff,32,30,2,0,0
14185,Kendall Campus,DEP 2000 - 0024   Human Growth And Development,0024-LEC 1st Mon Sp,Staff,49,23,26,0,0
14105,Kendall Campus,DEP 2000 - 0025   Human Growth And Development,0025-LEC Main Sess,Staff,45,32,13,0,0
14106,Kendall Campus,DEP 2000 - 0026   Human Growth And Development,0026-LEC Main Sess,Staff,35,34,1,0,0
14107,Kendall Campus,DEP 2000 - 0027   Human Growth And Development,0027-LEC Main Sess,Staff,30,22,8,0,0
14187,Kendall Campus,DEP 2000 - 0028   Human Growth And Development,0028-LEC Weekend,Staff,35,26,9,0,0
14168,Kendall Campus,DEP 2000 - 0029   Human Growth And Development,0029-LEC Twelve Wk,Staff,49,44,5,0,0
14108,Kendall Campus,DEP 2000 - 0030   Human Growth And Development,0030-LEC Main Sess,Staff,30,20,10,0,0
14111,Kendall Campus,DEP 2000 - 0033   Human Growth And Development,0033-LEC Main Sess,Staff,48,35,13,0,0
14112,Kendall Campus,DEP 2000 - 0034   Human Growth And Development,0034-LEC Main Sess,Staff,37,34,3,0,0
14113,Kendall Campus,DEP 2000 - 0035   Human Growth And Development,0035-LEC Main Sess,Staff,49,23,26,0,0
14114,Kendall Campus,DEP 2000 - 0036   Human Growth And Development,0036-LEC Main Sess,Staff,49,41,8,0,0
14115,Kendall Campus,DEP 2000 - 0037   Human Growth And Development,0037-LEC Main Sess,Staff,49,48,1,0,0
14116,Kendall Campus,DEP 2000 - 0038   Human Growth And Development,0038-LEC Main Sess,Staff,49,47,2,0,0
14175,Kendall Campus,DEP 2000 - 0039   Human Growth And Development,0039-LEC Eight Wk 1,Staff,30,13,17,0,0
14117,Kendall Campus,DEP 2000 - 0040   Human Growth And Development,0040-LEC Main Sess,Staff,45,40,5,0,0
14118,Kendall Campus,DEP 2000 - 0041   Human Growth And Development,0041-LEC Main Sess,Staff,45,22,23,0,0
14119,Kendall Campus,DEP 2000 - 0042   Human Growth And Development,0042-LEC Main Sess,Staff,37,0,37,0,0
14120,Kendall Campus,DEP 2000 - 0043   Human Growth And Development,0043-LEC Main Sess,Staff,49,48,1,0,0
14121,Kendall Campus,DEP 2000 - 0044   Human Growth And Development,0044-LEC Main Sess,Staff,30,21,9,0,0
14186,Kendall Campus,DEP 2000 - 0045   Human Growth And Development,0045-LEC Weekend,Staff,30,0,30,0,0
14177,Kendall Campus,DEP 2000 - 0046   Human Growth And Development,0046-LEC Eight Wk 2,Staff,36,33,3,0,0
14122,Kendall Campus,DEP 2000 - 0047   Human Growth And Development,0047-LEC Main Sess,Staff,30,20,10,0,0
14123,Kendall Campus,DEP 2000 - 0048   Human Growth And Development,0048-LEC Main Sess,Staff,40,13,27,0,0
14124,Kendall Campus,DEP 2000 - 0049   Human Growth And Development,0049-LEC Main Sess,Staff,30,27,3,0,0
14125,Kendall Campus,DEP 2000 - 0050   Human Growth And Development,0050-LEC Main Sess,Staff,30,29,1,0,0
14126,Kendall Campus,DEP 2000 - 0051   Human Growth And Development,0051-LEC Main Sess,Staff,25,15,10,0,0
14164,Kendall Campus,DEP 2000 - 0052   Human Growth And Development,0052-LEC Main Sess,Staff,48,9,39,0,0
14178,Kendall Campus,DEP 2000 - 0053   Human Growth And Development,0053-LEC Conversion,Staff,49,15,34,0,0
14167,Wolfson Campus,DEP 2000 - 0054   Human Growth And Development,0054-LEC Twelve Wk,Staff,40,25,15,0,0
14181,Wolfson Campus,DEP 2000 - 0055   Human Growth And Development,0055-LEC Conversion,Staff,15,0,15,0,0
14127,Wolfson Campus,DEP 2000 - 0056   Human Growth And Development,0056-LEC Main Sess,Staff,47,34,13,0,0
14128,Wolfson Campus,DEP 2000 - 0057   Human Growth And Development,0057-LEC Main Sess,Staff,47,46,1,0,0
14129,Wolfson Campus,DEP 2000 - 0058   Human Growth And Development,0058-LEC Main Sess,Staff,47,43,4,0,0
14130,Wolfson Campus,DEP 2000 - 0059   Human Growth And Development,0059-LEC Main Sess,Staff,47,44,3,0,0
14131,Wolfson Campus,DEP 2000 - 0060   Human Growth And Development,0060-LEC Main Sess,Staff,15,14,1,0,0
14132,Wolfson Campus,DEP 2000 - 0061   Human Growth And Development,0061-LEC Main Sess,Staff,47,39,8,0,0
14133,Wolfson Campus,DEP 2000 - 0062   Human Growth And Development,0062-LEC Main Sess,Staff,47,42,5,0,0
14134,Wolfson Campus,DEP 2000 - 0063   Human Growth And Development,0063-LEC Main Sess,Staff,47,34,13,0,0
14135,Wolfson Campus,DEP 2000 - 0064   Human Growth And Development,0064-LEC Main Sess,Staff,47,42,5,0,0
14136,Wolfson Campus,DEP 2000 - 0065   Human Growth And Development,0065-LEC Main Sess,Staff,30,28,2,0,0
14182,Wolfson Campus,DEP 2000 - 0066   Human Growth And Development,0066-LEC Conversion,Staff,34,30,4,0,0
14137,Wolfson Campus,DEP 2000 - 0067   Human Growth And Development,0067-LEC Main Sess,Staff,30,25,5,0,0
14180,Wolfson Campus,DEP 2000 - 0068   Human Growth And Development,0068-LEC Conversion,Staff,34,31,3,0,0
14138,Wolfson Campus,DEP 2000 - 0069   Human Growth And Development,0069-LEC Main Sess,Staff,30,26,4,0,0
14139,Wolfson Campus,DEP 2000 - 0070   Human Growth And Development,0070-LEC Main Sess,Staff,30,25,5,0,0
14140,Wolfson Campus,DEP 2000 - 0071   Human Growth And Development,0071-LEC Main Sess,Staff,30,27,3,0,0
14141,Wolfson Campus,DEP 2000 - 0072   Human Growth And Development,0072-LEC Main Sess,Staff,30,25,5,0,0
14179,Wolfson Campus,DEP 2000 - 0073   Human Growth And Development,0073-LEC Conversion,Staff,34,31,3,0,0
14142,Wolfson Campus,DEP 2000 - 0074   Human Growth And Development,0074-LEC Main Sess,Staff,30,29,1,0,0
14143,Wolfson Campus,DEP 2000 - 0075   Human Growth And Development,0075-LEC Main Sess,Staff,30,23,7,0,0
14144,Wolfson Campus,DEP 2000 - 0076   Human Growth And Development,0076-LEC Main Sess,Staff,30,27,3,0,0
14145,Wolfson Campus,DEP 2000 - 0077   Human Growth And Development,0077-LEC Main Sess,Staff,30,26,4,0,0
14146,Homestead Campus,DEP 2000 - 0078   Human Growth And Development,0078-LEC Main Sess,Staff,39,36,3,0,0
14147,Homestead Campus,DEP 2000 - 0079   Human Growth And Development,0079-LEC Main Sess,Staff,39,37,2,0,0
14148,Homestead Campus,DEP 2000 - 0080   Human Growth And Development,0080-LEC Main Sess,Staff,39,32,7,0,0
14149,Homestead Campus,DEP 2000 - 0081   Human Growth And Development,0081-LEC Main Sess,Staff,39,36,3,0,0
14176,InterAmerican Campus,DEP 2000 - 0082   Human Growth And Development,0082-LEC Eight Wk 2,Staff,30,0,30,0,0
14150,InterAmerican Campus,DEP 2000 - 0083   Human Growth And Development,0083-LEC Main Sess,Staff,40,17,23,0,0
14151,InterAmerican Campus,DEP 2000 - 0084   Human Growth And Development,0084-LEC Main Sess,Staff,40,37,3,0,0
14152,InterAmerican Campus,DEP 2000 - 0085   Human Growth And Development,0085-LEC Main Sess,Staff,25,16,9,0,0
14153,InterAmerican Campus,DEP 2000 - 0086   Human Growth And Development,0086-LEC Main Sess,Staff,40,23,17,0,0
14166,InterAmerican Campus,DEP 2000 - 0087   Human Growth And Development,0087-LEC Twelve Wk,Staff,35,30,5,0,0
14183,InterAmerican Campus,DEP 2000 - 0088   Human Growth And Development,0088-LEC 1st Mon Sp,Staff,37,0,37,0,0
14154,Hialeah Campus,DEP 2000 - 0089   Human Growth And Development,0089-LEC Main Sess,Staff,35,34,1,0,0
14188,Hialeah Campus,DEP 2000 - 0090   Human Growth And Development,0090-LEC Weekend,Staff,31,22,9,0,0
14155,Hialeah Campus,DEP 2000 - 0091   Human Growth And Development,0091-LEC Main Sess,Staff,31,29,2,0,0
14156,Hialeah Campus,DEP 2000 - 0092   Human Growth And Development,0092-LEC Main Sess,Staff,35,20,15,0,0
14157,Hialeah Campus,DEP 2000 - 0093   Human Growth And Development,0093-LEC Main Sess,Staff,35,32,3,0,0
14158,Hialeah Campus,DEP 2000 - 0094   Human Growth And Development,0094-LEC Main Sess,Staff,33,0,33,0,0
14159,Hialeah Campus,DEP 2000 - 0095   Human Growth And Development,0095-LEC Main Sess,Staff,32,19,13,0,0
14160,Hialeah Campus,DEP 2000 - 0096   Human Growth And Development,0096-LEC Main Sess,Staff,33,29,4,0,0
14161,Hialeah Campus,DEP 2000 - 0097   Human Growth And Development,0097-LEC Main Sess,Staff,35,27,8,0,0
14165,Hialeah Campus,DEP 2000 - 0098   Human Growth And Development,0098-LEC Twelve Wk,Staff,30,29,1,0,0
14162,West Campus,DEP 2000 - 0099   Human Growth And Development,0099-LEC Main Sess,Staff,35,25,10,0,0
14172,West Campus,DEP 2000 - 0100   Human Growth And Development,0100-LEC Twelve Wk,Staff,35,22,13,0,0
14163,West Campus,DEP 2000 - 0101   Human Growth And Development,0101-LEC Main Sess,Staff,35,21,14,0,0
6667,North Campus,EEX 2000 - 0001   Introduction To Special Education,0001-LEC Eight Wk 2,Staff,30,0,30,0,0
6663,North Campus,EEX 2000 - 0002   Introduction To Special Education,0002-LEC Main Sess,Staff,30,15,15,0,0
6668,Kendall Campus,EEX 2000 - 0003   Introduction To Special Education,0003-LEC Eight Wk 2,Staff,30,0,30,0,0
6664,Homestead Campus,EEX 2000 - 0004   Introduction To Special Education,0004-LEC Main Sess,Staff,25,24,1,0,0
6665,InterAmerican Campus,EEX 2000 - 0005   Introduction To Special Education,0005-LEC Main Sess,Staff,30,19,11,0,0
6669,InterAmerican Campus,EEX 2000 - 0006   Introduction To Special Education,0006-LEC Weekend,Staff,30,17,13,0,0
6666,InterAmerican Campus,EEX 2000 - 0007   Introduction To Special Education,0007-LEC Main Sess,Staff,25,8,17,0,0
16236,North Campus,FIN 2000 - 0001   Principles Of Finance,0001-LEC Twelve Wk,Staff,30,0,30,0,0
16237,North Campus,FIN 2000 - 0002   Principles Of Finance,0002-LEC Weekend,Staff,30,20,10,0,0
16228,Kendall Campus,FIN 2000 - 0003   Principles Of Finance,0003-LEC Main Sess,Staff,21,0,21,0,0
16229,Kendall Campus,FIN 2000 - 0004   Principles Of Finance,0004-LEC Main Sess,Staff,5,0,5,0,0
16230,Kendall Campus,FIN 2000 - 0005   Principles Of Finance,0005-LEC Main Sess,Staff,25,22,3,0,0
16231,Kendall Campus,FIN 2000 - 0006   Principles Of Finance,0006-LEC Main Sess,Staff,40,27,13,0,0
16232,Wolfson Campus,FIN 2000 - 0007   Principles Of Finance,0007-LEC Main Sess,Staff,35,28,7,0,0
16234,Wolfson Campus,FIN 2000 - 0008   Principles Of Finance,0008-LEC Main Sess,Staff,30,11,19,0,0
16235,Wolfson Campus,FIN 2000 - 0009   Principles Of Finance,0009-LEC Main Sess,Staff,30,18,12,0,0
16233,InterAmerican Campus,FIN 2000 - 0010   Principles Of Finance,0010-LEC Main Sess,Staff,21,9,12,0,0
11651,North Campus,LIT 2000 - 0001   Introduction To Literature,0001-LEC Main Sess,Staff,28,0,28,0,0
11652,North Campus,LIT 2000 - 0002   Introduction To Literature,0002-LEC Main Sess,Staff,28,0,28,0,0
11653,North Campus,LIT 2000 - 0003   Introduction To Literature,0003-LEC Main Sess,Staff,28,8,20,0,0
11658,Kendall Campus,LIT 2000 - 0004   Introduction To Literature,0004-LEC Main Sess,Staff,28,22,6,0,0
11655,Kendall Campus,LIT 2000 - 0005   Introduction To Literature,0005-LEC Main Sess,Staff,28,0,28,0,0
11656,Kendall Campus,LIT 2000 - 0006   Introduction To Literature,0006-LEC Main Sess,Staff,21,17,4,0,0
11657,InterAmerican Campus,LIT 2000 - 0007   Introduction To Literature,0007-LEC Main Sess,Staff,30,18,12,0,0
11654,InterAmerican Campus,LIT 2000 - 0008   Introduction To Literature,0008-LEC Main Sess,Staff,30,12,18,0,0
9026,North Campus,MMC 2000 - 0001   Introduction To Mass Communications,0001-LEC 1st Mon Sp,Staff,50,35,15,0,0
9027,North Campus,MMC 2000 - 0002   Introduction To Mass Communications,0002-LEC 1st Mon Sp,Staff,30,0,30,0,0
9017,Kendall Campus,MMC 2000 - 0003   Introduction To Mass Communications,0003-LEC Main Sess,Staff,25,12,13,0,0
9019,Kendall Campus,MMC 2000 - 0005   Introduction To Mass Communications,0005-LEC Main Sess,Staff,28,26,2,0,0
9020,Kendall Campus,MMC 2000 - 0006   Introduction To Mass Communications,0006-LEC Main Sess,Staff,28,26,2,0,0
9021,Wolfson Campus,MMC 2000 - 0007   Introduction To Mass Communications,0007-LEC Main Sess,Staff,30,28,2,0,0
9028,Homestead Campus,MMC 2000 - 0009   Introduction To Mass Communications,0009-LEC 1st Mon Sp,Staff,25,0,25,0,0
9025,West Campus,MMC 2000 - 0010   Introduction To Mass Communications,0010-LEC Main Sess,Staff,35,9,26,0,0
9023,West Campus,MMC 2000 - 0011   Introduction To Mass Communications,0011-LEC Main Sess,Staff,30,0,30,0,0
9024,West Campus,MMC 2000 - 0012   Introduction To Mass Communications,0012-LEC Main Sess,Staff,30,0,30,0,0
14073,North Campus,SYG 2000 - 0001   Introduction To Sociology,0001-LEC Conversion,Staff,40,0,40,0,0
14019,North Campus,SYG 2000 - 0002   Introduction To Sociology,0002-LEC Main Sess,Staff,40,26,14,0,0
14020,North Campus,SYG 2000 - 0003   Introduction To Sociology,0003-LEC Main Sess,Staff,40,33,7,0,0
14033,North Campus,SYG 2000 - 0007   Introduction To Sociology,0007-LEC Main Sess,Staff,40,21,19,0,0
14034,North Campus,SYG 2000 - 0008   Introduction To Sociology,0008-LEC Main Sess,Staff,40,35,5,0,0
14070,North Campus,SYG 2000 - 0009   Introduction To Sociology,0009-LEC Conversion,Staff,40,0,40,0,0
14035,North Campus,SYG 2000 - 0010   Introduction To Sociology,0010-LEC Main Sess,Staff,40,36,4,0,0
14036,North Campus,SYG 2000 - 0011   Introduction To Sociology,0011-LEC Main Sess,Staff,40,37,3,0,0
14067,North Campus,SYG 2000 - 0012   Introduction To Sociology,0012-LEC Twelve Wk,Staff,40,24,16,0,0
14037,North Campus,SYG 2000 - 0013   Introduction To Sociology,0013-LEC Main Sess,Staff,40,24,16,0,0
14038,Kendall Campus,SYG 2000 - 0014   Introduction To Sociology,0014-LEC Main Sess,Staff,48,21,27,0,0
14039,Kendall Campus,SYG 2000 - 0015   Introduction To Sociology,0015-LEC Main Sess,Staff,48,38,10,0,0
14040,Kendall Campus,SYG 2000 - 0016   Introduction To Sociology,0016-LEC Main Sess,Staff,45,36,9,0,0
14041,Kendall Campus,SYG 2000 - 0017   Introduction To Sociology,0017-LEC Main Sess,Staff,25,24,1,0,0
14042,Kendall Campus,SYG 2000 - 0018   Introduction To Sociology,0018-LEC Main Sess,Staff,49,41,8,0,0
14043,Kendall Campus,SYG 2000 - 0019   Introduction To Sociology,0019-LEC Main Sess,Staff,48,36,12,0,0
14044,Kendall Campus,SYG 2000 - 0020   Introduction To Sociology,0020-LEC Main Sess,Staff,45,35,10,0,0
14045,Kendall Campus,SYG 2000 - 0021   Introduction To Sociology,0021-LEC Main Sess,Staff,48,26,22,0,0
14046,Kendall Campus,SYG 2000 - 0022   Introduction To Sociology,0022-LEC Main Sess,Staff,28,19,9,0,0
14069,Kendall Campus,SYG 2000 - 0023   Introduction To Sociology,0023-LEC Eight Wk 2,Staff,30,28,2,0,0
14047,Kendall Campus,SYG 2000 - 0024   Introduction To Sociology,0024-LEC Main Sess,Staff,45,38,7,0,0
14048,Kendall Campus,SYG 2000 - 0025   Introduction To Sociology,0025-LEC Main Sess,Staff,48,14,34,0,0
14076,Kendall Campus,SYG 2000 - 0026   Introduction To Sociology,0026-LEC Weekend,Staff,30,25,5,0,0
14049,Wolfson Campus,SYG 2000 - 0027   Introduction To Sociology,0027-LEC Main Sess,Staff,47,44,3,0,0
14050,Wolfson Campus,SYG 2000 - 0028   Introduction To Sociology,0028-LEC Main Sess,Staff,47,46,1,0,0
14051,Wolfson Campus,SYG 2000 - 0029   Introduction To Sociology,0029-LEC Main Sess,Staff,47,19,28,0,0
14052,Wolfson Campus,SYG 2000 - 0030   Introduction To Sociology,0030-LEC Main Sess,Staff,47,45,2,0,0
14066,Wolfson Campus,SYG 2000 - 0031   Introduction To Sociology,0031-LEC Twelve Wk,Staff,47,44,3,0,0
14053,Wolfson Campus,SYG 2000 - 0032   Introduction To Sociology,0032-LEC Main Sess,Staff,45,43,2,0,0
14056,Wolfson Campus,SYG 2000 - 0035   Introduction To Sociology,0035-LEC Main Sess,Staff,30,29,1,0,0
14072,Wolfson Campus,SYG 2000 - 0036   Introduction To Sociology,0036-LEC Conversion,Staff,34,31,3,0,0
14057,Wolfson Campus,SYG 2000 - 0037   Introduction To Sociology,0037-LEC Main Sess,Staff,34,27,7,0,0
14058,Wolfson Campus,SYG 2000 - 0038   Introduction To Sociology,0038-LEC Main Sess,Staff,34,0,34,0,0
14059,Wolfson Campus,SYG 2000 - 0039   Introduction To Sociology,0039-LEC Main Sess,Staff,30,28,2,0,0
14060,Wolfson Campus,SYG 2000 - 0040   Introduction To Sociology,0040-LEC Main Sess,Staff,30,27,3,0,0
14061,Wolfson Campus,SYG 2000 - 0041   Introduction To Sociology,0041-LEC Main Sess,Staff,30,26,4,0,0
14062,Wolfson Campus,SYG 2000 - 0042   Introduction To Sociology,0042-LEC Main Sess,Staff,30,27,3,0,0
14063,Wolfson Campus,SYG 2000 - 0043   Introduction To Sociology,0043-LEC Main Sess,Staff,30,24,6,0,0
14064,Wolfson Campus,SYG 2000 - 0044   Introduction To Sociology,0044-LEC Main Sess,Staff,30,29,1,0,0
14071,Wolfson Campus,SYG 2000 - 0045   Introduction To Sociology,0045-LEC Conversion,Staff,34,32,2,0,0
14065,InterAmerican Campus,SYG 2000 - 0046   Introduction To Sociology,0046-LEC Main Sess,Staff,35,19,16,0,0
14074,InterAmerican Campus,SYG 2000 - 0047   Introduction To Sociology,0047-LEC 1st Mon Sp,Staff,34,25,9,0,0
14068,InterAmerican Campus,SYG 2000 - 0048   Introduction To Sociology,0048-LEC Twelve Wk,Staff,29,22,7,0,0
14030,InterAmerican Campus,SYG 2000 - 0049   Introduction To Sociology,0049-LEC Main Sess,Staff,25,24,1,0,0
14029,Hialeah Campus,SYG 2000 - 0050   Introduction To Sociology,0050-LEC Main Sess,Staff,30,0,30,0,0
14028,Hialeah Campus,SYG 2000 - 0051   Introduction To Sociology,0051-LEC Main Sess,Staff,35,31,4,0,0
14027,Hialeah Campus,SYG 2000 - 0052   Introduction To Sociology,0052-LEC Main Sess,Staff,35,13,22,0,0
14026,Hialeah Campus,SYG 2000 - 0053   Introduction To Sociology,0053-LEC Main Sess,Staff,30,28,2,0,0
14025,Hialeah Campus,SYG 2000 - 0054   Introduction To Sociology,0054-LEC Main Sess,Staff,33,31,2,0,0
14024,Hialeah Campus,SYG 2000 - 0055   Introduction To Sociology,0055-LEC Main Sess,Staff,33,27,6,0,0
14023,Hialeah Campus,SYG 2000 - 0056   Introduction To Sociology,0056-LEC Main Sess,Staff,33,31,2,0,0
14022,Hialeah Campus,SYG 2000 - 0057   Introduction To Sociology,0057-LEC Main Sess,Staff,33,0,33,0,0
14021,Hialeah Campus,SYG 2000 - 0058   Introduction To Sociology,0058-LEC Main Sess,Staff,30,0,30,0,0
17243,North Campus,TAX 2000 - 0001   Income Tax,0001-LEC 1st Mon Sp,Staff,30,18,12,0,0
17233,North Campus,TAX 2000 - 0002   Income Tax,0002-LEC Main Sess,Staff,30,14,16,0,0
17235,Kendall Campus,TAX 2000 - 0004   Income Tax,0004-LEC Main Sess,Staff,25,16,9,0,0
17236,Wolfson Campus,TAX 2000 - 0005   Income Tax,0005-LEC Main Sess,Staff,30,13,17,0,0
17237,Wolfson Campus,TAX 2000 - 0006   Income Tax,0006-LEC Main Sess,Staff,35,13,22,0,0
17238,Wolfson Campus,TAX 2000 - 0007   Income Tax,0007-LEC Main Sess,Staff,30,25,5,0,0
17240,Homestead Campus,TAX 2000 - 0008   Income Tax,0008-LEC Main Sess,Staff,30,15,15,0,0
17244,InterAmerican Campus,TAX 2000 - 0009   Income Tax,0009-LEC 1st Mon Sp,Staff,30,15,15,0,0
17242,Hialeah Campus,TAX 2000 - 0010   Income Tax,0010-LEC Eight Wk 1,Staff,30,15,15,0,0
17239,West Campus,TAX 2000 - 0011   Income Tax,0011-LEC Main Sess,Staff,30,0,30,0,0
17241,West Campus,TAX 2000 - 0012   Income Tax,0012-LEC Twelve Wk,Staff,30,9,21,0,0
12616,North Campus,THE 2000 - 0001   Theatre Appreciation,0001-LEC Main Sess,Staff,35,20,15,0,0
12617,North Campus,THE 2000 - 0002   Theatre Appreciation,0002-LEC Main Sess,Staff,35,20,15,0,0
12626,North Campus,THE 2000 - 0003   Theatre Appreciation,0003-LEC Main Sess,Staff,35,26,9,0,0
12632,North Campus,THE 2000 - 0004   Theatre Appreciation,0004-LEC Twelve Wk,Staff,35,0,35,0,0
12634,North Campus,THE 2000 - 0005   Theatre Appreciation,0005-LEC Twelve Wk,Staff,30,11,19,0,0
12635,North Campus,THE 2000 - 0006   Theatre Appreciation,0006-LEC Twelve Wk,Staff,30,14,16,0,0
12627,North Campus,THE 2000 - 0007   Theatre Appreciation,0007-LEC Main Sess,Staff,30,0,30,0,0
12628,Kendall Campus,THE 2000 - 0008   Theatre Appreciation,0008-LEC Main Sess,Staff,37,29,8,0,0
12629,Kendall Campus,THE 2000 - 0009   Theatre Appreciation,0009-LEC Main Sess,Staff,37,30,7,0,0
12630,Kendall Campus,THE 2000 - 0010   Theatre Appreciation,0010-LEC Main Sess,Staff,38,0,38,0,0
12631,Kendall Campus,THE 2000 - 0012   Theatre Appreciation,0012-LEC Main Sess,Staff,37,16,21,0,0
12625,Kendall Campus,THE 2000 - 0013   Theatre Appreciation,0013-LEC Main Sess,Staff,37,34,3,0,0
12624,Kendall Campus,THE 2000 - 0014   Theatre Appreciation,0014-LEC Main Sess,Staff,25,19,6,0,0
12623,Kendall Campus,THE 2000 - 0015   Theatre Appreciation,0015-LEC Main Sess,Staff,37,19,18,0,0
12633,Kendall Campus,THE 2000 - 0016   Theatre Appreciation,0016-LEC Twelve Wk,Staff,36,33,3,0,0
12622,Kendall Campus,THE 2000 - 0017   Theatre Appreciation,0017-LEC Main Sess,Staff,40,17,23,0,0
12621,Kendall Campus,THE 2000 - 0018   Theatre Appreciation,0018-LEC Main Sess,Staff,38,31,7,0,0
12620,Kendall Campus,THE 2000 - 0019   Theatre Appreciation,0019-LEC Main Sess,Staff,40,0,40,0,0
12640,Wolfson Campus,THE 2000 - 0020   Theatre Appreciation,0020-LEC 1st Mon Sp,Staff,50,8,42,0,0
12618,Wolfson Campus,THE 2000 - 0022   Theatre Appreciation,0022-LEC Main Sess,Staff,50,44,6,0,0
12639,West Campus,THE 2000 - 0024   Theatre Appreciation,0024-LEC Conversion,Staff,30,0,30,0,0
12636,West Campus,THE 2000 - 0025   Theatre Appreciation,0025-LEC Twelve Wk,Staff,35,9,26,0,0
6908,Homestead Campus,AVM 1993 - 0001   Policies And Procedures For Commercial Airlines Maintenance Programs,0001-LEC Eight Wk 2,Staff,30,0,30,0,0
8778,Homestead Campus,AVM 1991 - 0001   Aircraft Performance Measures And Mainatenance Requirements,0001-LEC Conversion,Staff,30,0,30,0,0
8777,Homestead Campus,AVM 1991 - 0002   Aircraft Performance Measures And Mainatenance Requirements,0002-LEC Conversion,Staff,20,15,5,0,0
6405,Kendall Campus,IDS 1951 - 0001   Study Abroad Exchange Program Course,0001-LEC Main Sess,Staff,2,0,2,0,0
6404,Kendall Campus,IDS 1951 - 0002   Study Abroad Exchange Program Course,0002-LEC Main Sess,Staff,2,1,1,0,0
7077,Kendall Campus,IDS 1950 - 0001   Study Abroad Program Course,0001-LEC Main Sess,Staff,30,0,30,0,0
6225,North Campus,ACG 1949 - 0001   Co-Op Work Experience 1: Acg,0001-LEC Main Sess,Staff,40,0,40,0,0
8762,Kendall Campus,ARC 1949 - 0001   Co-Op Work Experience 1: Arc,0001-LEC Main Sess,Staff,5,0,5,0,0
6891,Homestead Campus,AVM 1949 - 0001   Co-Op Wrk Exp 1,0001-LEC Main Sess,Staff,24,0,24,0,0
5862,Homestead Campus,BSC 1949 - 0001   Co-Op Wrk Exp 1: Bio,0001-LEC Conversion,Staff,10,1,9,0,0
8215,North Campus,CCJ 1949 - 0001   Co-Op Wrk Exp 1,0001-LEC 1st Mon Sp,Staff,20,5,15,0,0
5964,Homestead Campus,CHM 1949 - 0001,0001-LEC Main Sess,Staff,10,4,6,0,0
7250,North Campus,CIS 1949 - 0001   Co-Op Work Experience 1: Cis,0001-LEC Conversion,Staff,20,0,20,0,0
7248,North Campus,CIS 1949 - 0002   Co-Op Work Experience 1: Cis,0002-LEC Eight Wk 1,Staff,30,14,16,0,0
7249,Kendall Campus,CIS 1949 - 0003   Co-Op Work Experience 1: Cis,0003-LEC Eight Wk 2,Staff,5,0,5,0,0
7247,Kendall Campus,CIS 1949 - 0004   Co-Op Work Experience 1: Cis,0004-LEC Twelve Wk,Staff,2,0,2,0,0
14625,North Campus,GEB 1949 - 0001   Co-Op Wrk Exp 1,0001-LEC Twelve Wk,Staff,15,0,15,0,0
14626,Wolfson Campus,GEB 1949 - 0002   Co-Op Wrk Exp 1,0002-LEC Conversion,Staff,30,9,21,0,0
12224,Wolfson Campus,HFT 1949 - 0001   Co-Op Work Experience 1: Hft,0001-LEC Main Sess,Staff,22,10,12,0,0
12223,Wolfson Campus,HFT 1949 - 0002   Co-Op Work Experience 1: Hft,0002-LEC Main Sess,Staff,30,0,30,0,0
12241,North Campus,MUM 1949 - 0001   Co-Op Work Experience 1: Mum,0001-LEC Main Sess,Staff,25,3,22,0,0
12240,Kendall Campus,MUM 1949 - 0002   Co-Op Work Experience 1: Mum,0002-LEC Main Sess,Staff,24,13,11,0,0
14915,Kendall Campus,PET 1949 - 0001   Co-Op Wrk Exp 1,0001-LEC Main Sess,Staff,24,2,22,0,0
14914,Wolfson Campus,PET 1949 - 0002   Co-Op Wrk Exp 1,0002-LEC Main Sess,Staff,9,5,4,0,0
8705,Kendall Campus,PHT 1949 - 0001,0001-LEC Main Sess,Staff,24,14,10,0,0
11986,Wolfson Campus,PLA 1949 - 0001,0001-LEC Weekend,Staff,20,16,4,0,0
7122,North Campus,JOU 1946 - 0001   Journalism Internship,0001-LAB Main Sess,Staff,25,7,18,0,0
6885,Medical Campus,ATE 1941 - 0002   Veterinary Clinical Experience 2,0002-CLN Main Sess,Staff,6,4,2,0,0
5961,Homestead Campus,CHM 1941 - 0001   Principles & Techniques Of Peer Tutoring In Chemistry,0001-LEC Main Sess,Staff,10,2,8,0,0
5963,Homestead Campus,CHM 1941 - 0002   Principles & Techniques Of Peer Tutoring In Chemistry,0002-LEC Main Sess,Staff,10,0,10,0,0
5962,Homestead Campus,CHM 1941 - 0003   Principles & Techniques Of Peer Tutoring In Chemistry,0003-LEC Main Sess,Staff,10,0,10,0,0
15307,North Campus,INT 1941 - 0001   Interpreting Internship,0001-OTH Main Sess,Staff,10,1,9,0,0
5525,Medical Campus,DEH 1940L - 0001   Dental Hygiene 1 Optional Learning Support,0001-LAB Conversion,Staff,6,3,3,0,0
5523,Medical Campus,DEH 1940L - 0002   Dental Hygiene 1 Optional Learning Support,0002-LAB Conversion,Staff,5,4,1,0,0
5524,Medical Campus,DEH 1940L - 0003   Dental Hygiene 1 Optional Learning Support,0003-LAB Conversion,Staff,6,5,1,0,0
12254,Kendall Campus,MUS 1935 - 0001   Piano Seminar,0001-LEC Main Sess,Staff,20,4,16,0,0
12253,Kendall Campus,MUS 1935 - 0002   Piano Seminar,0002-LEC Main Sess,Staff,15,0,15,0,0
5387,North Campus,ASL 1906 - 0001   Directed Independent Studies,0001-LEC Main Sess,Staff,20,0,20,0,0
16255,Wolfson Campus,HFT 1852 - 0001   Menu And Facilities Planning,0001-LEC Main Sess,Staff,30,19,11,0,0
16912,Medical Campus,PAS 1830 - 0001   Pharmacotherapeutics,0001-LEC Main Sess,Staff,20,16,4,0,0
16914,Medical Campus,PAS 1830 - 0002   Pharmacotherapeutics,0002-LEC Main Sess,Staff,20,16,4,0,0
16913,Medical Campus,PAS 1830 - 0003   Pharmacotherapeutics,0003-LEC Main Sess,Staff,20,17,3,0,0
13975,Medical Campus,PAS 1824 - 0001   Pathophysiological,0001-LEC Main Sess,Staff,15,12,3,0,0
13978,Medical Campus,PAS 1824 - 0002   Pathophysiological,0002-LEC Main Sess,Staff,15,12,3,0,0
13977,Medical Campus,PAS 1824 - 0003   Pathophysiological,0003-LEC Main Sess,Staff,15,12,3,0,0
13976,Medical Campus,PAS 1824 - 0004   Pathophysiological,0004-LEC Main Sess,Staff,15,13,2,0,0
16447,Medical Campus,PAS 1821 - 0001   Behavioral & Community Education Medicine 2 For Pas,0001-LEC Main Sess,Staff,20,13,7,0,0
16449,Medical Campus,PAS 1821 - 0002   Behavioral & Community Education Medicine 2 For Pas,0002-LEC Main Sess,Staff,20,19,1,0,0
16448,Medical Campus,PAS 1821 - 0003   Behavioral & Community Education Medicine 2 For Pas,0003-LEC Main Sess,Staff,20,17,3,0,0
8660,Medical Campus,PAS 1820 - 0001   Introduction To Medicine 2 For Pas,0001-LEC Main Sess,Staff,20,19,1,0,0
8662,Medical Campus,PAS 1820 - 0002   Introduction To Medicine 2 For Pas,0002-LEC Main Sess,Staff,20,13,7,0,0
8661,Medical Campus,PAS 1820 - 0003   Introduction To Medicine 2 For Pas,0003-LEC Main Sess,Staff,20,17,3,0,0
9488,Medical Campus,RTE 1814 - 0004   Radiographic Clinic 2,0004-CLN Main Sess,Staff,10,9,1,0,0
9487,Medical Campus,RTE 1814 - 0005   Radiographic Clinic 2,0005-CLN Main Sess,Staff,10,1,9,0,0
7462,Medical Campus,DEH 1811 - 0001   Professional Issues,0001-LEC Conversion,Staff,1,0,1,0,0
7461,Medical Campus,DEH 1811 - 0002   Professional Issues,0002-LEC Main Sess,Staff,50,43,7,0,0
7191,InterAmerican Campus,BAN 1800 - 0001   Law And Banking,0001-LEC Conversion,Staff,30,16,14,0,0
7449,North Campus,CTS 1800 - 0001   Introduction To Web Page Development,0001-LEC Main Sess,Staff,30,23,7,0,0
7450,Wolfson Campus,CTS 1800 - 0003   Introduction To Web Page Development,0003-LEC Main Sess,Staff,33,18,15,0,0
6044,Medical Campus,DEH 1800 - 0001   Dental Hygiene 1,0001-LEC Main Sess,Staff,50,44,6,0,0
6045,Medical Campus,DEH 1800 - 0002   Dental Hygiene 1,0002-LEC Conversion,Staff,1,0,1,0,0
6390,Medical Campus,HIM 1800 - 0001   Professional Practice Experience 1,0001-CLN Conversion,Staff,10,5,5,0,0
6389,Medical Campus,HIM 1800 - 0002   Professional Practice Experience 1,0002-CLN Main Sess,Staff,10,0,10,0,0
6071,Medical Campus,DEH 1800L - 0006   Dental Hygiene 1 Clinic,0006-CLN Main Sess,Staff,5,4,1,0,0
6073,Medical Campus,DEH 1800L - 0008   Dental Hygiene 1 Clinic,0008-CLN Main Sess,Staff,5,4,1,0,0
6074,Medical Campus,DEH 1800L - 0009   Dental Hygiene 1 Clinic,0009-CLN Conversion,Staff,1,0,1,0,0
5496,North Campus,CJE 1772 - 0001   Crime Scene Photography 2,0001-LEC Main Sess,Staff,40,31,9,0,0
7238,Kendall Campus,BCT 1771 - 0001   Building Construction Advanced Estimating,0001-LEC Conversion,Staff,22,11,11,0,0
8929,Kendall Campus,BCT 1770 - 0001   Building Construction Estimating Fundamentals,0001-LEC Conversion,Staff,22,16,6,0,0
15273,North Campus,GRA 1754 - 0001   Graphic Interface Design 2,0001-LEC Main Sess,Staff,20,0,20,0,0
11497,Medical Campus,MLT 1752 - 0001   Quality Control Laboratory Mathematics,0001-LEC Main Sess,Staff,35,19,16,0,0
12139,North Campus,GRA 1751 - 0001   Graphic Interface Design 1,0001-LEC Main Sess,Staff,23,21,2,0,0
5336,North Campus,BCT 1750 - 0001   Building Construction Financing,0001-LEC Main Sess,Staff,25,0,25,0,0
7445,North Campus,BCT 1743 - 0001   Building Construction Law,0001-LEC Main Sess,Staff,25,0,25,0,0
12837,Wolfson Campus,MAR 1720 - 0001   Marketing In A Digital World,0001-LEC Twelve Wk,Staff,40,0,40,0,0
12836,Wolfson Campus,MAR 1720 - 0002   Marketing In A Digital World,0002-LEC Main Sess,Staff,34,27,7,0,0
12249,Kendall Campus,MUN 1720 - 0002   Vocal Jazz/Pop Ensemble,0002-LEC Main Sess,Staff,30,12,18,0,0
12252,Kendall Campus,MUN 1720 - 0003   Vocal Jazz/Pop Ensemble,0003-LEC Main Sess,Staff,30,15,15,0,0
12251,Kendall Campus,MUN 1720 - 0004   Vocal Jazz/Pop Ensemble,0004-LEC Main Sess,Staff,30,0,30,0,0
12250,Kendall Campus,MUN 1720 - 0005   Vocal Jazz/Pop Ensemble,0005-LEC Main Sess,Staff,40,0,40,0,0
9063,Medical Campus,NMT 1713 - 0001   Nuclear Medicine Procedures 1,0001-LEC Conversion,Staff,20,11,9,0,0
7795,Wolfson Campus,DIG 1710 - 0001   Introduction To Game Development,0001-LEC Main Sess,Staff,24,14,10,0,0
7794,Wolfson Campus,DIG 1710 - 0002   Introduction To Game Development,0002-LEC Main Sess,Staff,30,17,13,0,0
6821,North Campus,FFP 1710 - 0001   Supervision-Leadership For Fire Officers,0001-LEC Conversion,Staff,24,8,16,0,0
13902,North Campus,MUN 1710 - 0001   Jazz Workshop,0001-LAB 1st Mon Sp,Staff,15,13,2,0,0
13897,Kendall Campus,MUN 1710 - 0002   Jazz Workshop,0002-LAB Main Sess,Staff,15,0,15,0,0
13898,Kendall Campus,MUN 1710 - 0003   Jazz Workshop,0003-LAB Main Sess,Staff,15,6,9,0,0
13899,Kendall Campus,MUN 1710 - 0004   Jazz Workshop,0004-LAB Main Sess,Staff,15,8,7,0,0
13900,Kendall Campus,MUN 1710 - 0005   Jazz Workshop,0005-LAB Main Sess,Staff,15,7,8,0,0
13901,Wolfson Campus,MUN 1710 - 0006   Jazz Workshop,0006-LAB Main Sess,Staff,15,11,4,0,0
6738,North Campus,ETM 1700 - 0001   Air Conditioning Fundamentals,0001-LEC Main Sess,Staff,20,10,10,0,0
13235,North Campus,TPP 1700 - 0001   Voice For The Stage,0001-LEC Main Sess,Staff,12,6,6,0,0
13236,Wolfson Campus,TPP 1700 - 0003   Voice For The Stage,0003-LEC Main Sess,Staff,15,10,5,0,0
14293,InterAmerican Campus,EAP 1689 - 0002   Combined Accelerated Advanced Speech· Listening And Grammar Level 6,0002-LEC Main Sess,Staff,30,22,8,0,0
14292,InterAmerican Campus,EAP 1689 - 0003   Combined Accelerated Advanced Speech· Listening And Grammar Level 6,0003-LEC Main Sess,Staff,25,10,15,0,0
14277,North Campus,EAP 1686 - 0001   Advanced 2 - Integrated Reading· Speech & Listening,0001-LEC Main Sess,Staff,30,27,3,0,0
14278,North Campus,EAP 1686 - 0002   Advanced 2 - Integrated Reading· Speech & Listening,0002-LEC Main Sess,Staff,30,15,15,0,0
14279,North Campus,EAP 1686 - 0003   Advanced 2 - Integrated Reading· Speech & Listening,0003-LEC Main Sess,Staff,24,21,3,0,0
14280,Kendall Campus,EAP 1686 - 0004   Advanced 2 - Integrated Reading· Speech & Listening,0004-LEC Main Sess,Staff,25,24,1,0,0
14281,Kendall Campus,EAP 1686 - 0005   Advanced 2 - Integrated Reading· Speech & Listening,0005-LEC Main Sess,Staff,25,24,1,0,0
14282,Kendall Campus,EAP 1686 - 0006   Advanced 2 - Integrated Reading· Speech & Listening,0006-LEC Main Sess,Staff,25,23,2,0,0
14290,Wolfson Campus,EAP 1686 - 0007   Advanced 2 - Integrated Reading· Speech & Listening,0007-LEC Main Sess,Staff,25,22,3,0,0
14284,InterAmerican Campus,EAP 1686 - 0008   Advanced 2 - Integrated Reading· Speech & Listening,0008-LEC Main Sess,Staff,30,15,15,0,0
14285,InterAmerican Campus,EAP 1686 - 0009   Advanced 2 - Integrated Reading· Speech & Listening,0009-LEC Main Sess,Staff,30,22,8,0,0
14286,Hialeah Campus,EAP 1686 - 0010   Advanced 2 - Integrated Reading· Speech & Listening,0010-LEC Main Sess,Staff,30,27,3,0,0
14288,Hialeah Campus,EAP 1686 - 0012   Advanced 2 - Integrated Reading· Speech & Listening,0012-LEC Main Sess,Staff,30,23,7,0,0
14289,Hialeah Campus,EAP 1686 - 0013   Advanced 2 - Integrated Reading· Speech & Listening,0013-LEC Main Sess,Staff,30,0,30,0,0
14283,West Campus,EAP 1686 - 0014   Advanced 2 - Integrated Reading· Speech & Listening,0014-LEC Main Sess,Staff,35,34,1,0,0
8333,North Campus,EAP 1685 - 0002   Advanced 2 - Integrated Writing & Grammar,0002-LEC Main Sess,Staff,22,20,2,0,0
8334,North Campus,EAP 1685 - 0003   Advanced 2 - Integrated Writing & Grammar,0003-LEC Main Sess,Staff,30,24,6,0,0
8335,Kendall Campus,EAP 1685 - 0004   Advanced 2 - Integrated Writing & Grammar,0004-LEC Main Sess,Staff,25,23,2,0,0
8337,Kendall Campus,EAP 1685 - 0006   Advanced 2 - Integrated Writing & Grammar,0006-LEC Main Sess,Staff,25,24,1,0,0
8345,Wolfson Campus,EAP 1685 - 0007   Advanced 2 - Integrated Writing & Grammar,0007-LEC Main Sess,Staff,25,24,1,0,0
8339,InterAmerican Campus,EAP 1685 - 0008   Advanced 2 - Integrated Writing & Grammar,0008-LEC Main Sess,Staff,30,24,6,0,0
8340,InterAmerican Campus,EAP 1685 - 0009   Advanced 2 - Integrated Writing & Grammar,0009-LEC Main Sess,Staff,30,26,4,0,0
8341,Hialeah Campus,EAP 1685 - 0010   Advanced 2 - Integrated Writing & Grammar,0010-LEC Main Sess,Staff,30,26,4,0,0
8342,Hialeah Campus,EAP 1685 - 0011   Advanced 2 - Integrated Writing & Grammar,0011-LEC Main Sess,Staff,30,0,30,0,0
8338,West Campus,EAP 1685 - 0014   Advanced 2 - Integrated Writing & Grammar,0014-LEC Main Sess,Staff,35,34,1,0,0
7448,InterAmerican Campus,EAP 1683 - 0002   Combined Accelerated Advanced Reading/Writing Level 6,0002-LEC Main Sess,Staff,30,22,8,0,0
7447,InterAmerican Campus,EAP 1683 - 0003   Combined Accelerated Advanced Reading/Writing Level 6,0003-LEC Main Sess,Staff,21,10,11,0,0
6194,North Campus,EAP 1660 - 0001   Grammar Level 6,0001-LEC Main Sess,Staff,30,25,5,0,0
6220,North Campus,EAP 1660 - 0002   Grammar Level 6,0002-LEC Eight Wk 2,Staff,28,24,4,0,0
6195,North Campus,EAP 1660 - 0003   Grammar Level 6,0003-LEC Main Sess,Staff,30,0,30,0,0
6201,North Campus,EAP 1660 - 0004   Grammar Level 6,0004-LEC Main Sess,Staff,30,0,30,0,0
6202,North Campus,EAP 1660 - 0005   Grammar Level 6,0005-LEC Main Sess,Staff,30,0,30,0,0
6224,North Campus,EAP 1660 - 0006   Grammar Level 6,0006-LEC Weekend,Staff,30,17,13,0,0
6203,North Campus,EAP 1660 - 0007   Grammar Level 6,0007-LEC Main Sess,Staff,30,27,3,0,0
6204,Kendall Campus,EAP 1660 - 0008   Grammar Level 6,0008-LEC Main Sess,Staff,28,25,3,0,0
6196,Kendall Campus,EAP 1660 - 0009   Grammar Level 6,0009-LEC Main Sess,Staff,1,0,1,0,0
6205,Kendall Campus,EAP 1660 - 0010   Grammar Level 6,0010-LEC Main Sess,Staff,28,18,10,0,0
6206,Kendall Campus,EAP 1660 - 0011   Grammar Level 6,0011-LEC Main Sess,Staff,28,13,15,0,0
6207,Kendall Campus,EAP 1660 - 0012   Grammar Level 6,0012-LEC Main Sess,Staff,28,0,28,0,0
6208,Wolfson Campus,EAP 1660 - 0013   Grammar Level 6,0013-LEC Main Sess,Staff,30,29,1,0,0
6223,Wolfson Campus,EAP 1660 - 0014   Grammar Level 6,0014-LEC Conversion,Staff,30,0,30,0,0
6209,Wolfson Campus,EAP 1660 - 0015   Grammar Level 6,0015-LEC Main Sess,Staff,30,27,3,0,0
6210,Wolfson Campus,EAP 1660 - 0016   Grammar Level 6,0016-LEC Main Sess,Staff,30,28,2,0,0
6211,Wolfson Campus,EAP 1660 - 0017   Grammar Level 6,0017-LEC Main Sess,Staff,30,27,3,0,0
6212,Wolfson Campus,EAP 1660 - 0018   Grammar Level 6,0018-LEC Main Sess,Staff,30,25,5,0,0
6213,Wolfson Campus,EAP 1660 - 0019   Grammar Level 6,0019-LEC Main Sess,Staff,30,20,10,0,0
6214,Wolfson Campus,EAP 1660 - 0020   Grammar Level 6,0020-LEC Main Sess,Staff,30,24,6,0,0
6222,Wolfson Campus,EAP 1660 - 0021   Grammar Level 6,0021-LEC Conversion,Staff,30,8,22,0,0
6215,Homestead Campus,EAP 1660 - 0022   Grammar Level 6,0022-LEC Main Sess,Staff,20,17,3,0,0
6216,InterAmerican Campus,EAP 1660 - 0023   Grammar Level 6,0023-LEC Main Sess,Staff,30,21,9,0,0
6217,InterAmerican Campus,EAP 1660 - 0024   Grammar Level 6,0024-LEC Main Sess,Staff,30,14,16,0,0
6218,InterAmerican Campus,EAP 1660 - 0025   Grammar Level 6,0025-LEC Main Sess,Staff,30,27,3,0,0
6200,InterAmerican Campus,EAP 1660 - 0026   Grammar Level 6,0026-LEC Main Sess,Staff,30,20,10,0,0
6199,Hialeah Campus,EAP 1660 - 0027   Grammar Level 6,0027-LEC Main Sess,Staff,30,20,10,0,0
6198,West Campus,EAP 1660 - 0028   Grammar Level 6,0028-LEC Main Sess,Staff,35,25,10,0,0
6221,West Campus,EAP 1660 - 0029   Grammar Level 6,0029-LEC Eight Wk 2,Staff,30,21,9,0,0
6197,West Campus,EAP 1660 - 0030   Grammar Level 6,0030-LEC Main Sess,Staff,35,29,6,0,0
6219,West Campus,EAP 1660 - 0031   Grammar Level 6,0031-LEC Twelve Wk,Staff,35,0,35,0,0
13879,North Campus,CTS 1651 - 0001   Ccna 2: Routing And Switching,0001-LEC Eight Wk 2,Staff,24,14,10,0,0
13881,Kendall Campus,CTS 1651 - 0002   Ccna 2: Routing And Switching,0002-LEC Eight Wk 2,Staff,28,23,5,0,0
13882,Wolfson Campus,CTS 1651 - 0003   Ccna 2: Routing And Switching,0003-LEC Conversion,Staff,22,13,9,0,0
13880,Wolfson Campus,CTS 1651 - 0004   Ccna 2: Routing And Switching,0004-LEC Eight Wk 2,Staff,22,8,14,0,0
6718,North Campus,CTS 1650 - 0001   Ccna 1: Cisco Fundamentals,0001-LEC Eight Wk 1,Staff,24,23,1,0,0
6720,Wolfson Campus,CTS 1650 - 0003   Ccna 1: Cisco Fundamentals,0003-LEC Eight Wk 1,Staff,22,18,4,0,0
6719,Wolfson Campus,CTS 1650 - 0004   Ccna 1: Cisco Fundamentals,0004-LEC Eight Wk 1,Staff,22,11,11,0,0
15255,North Campus,ETI 1644 - 0001   Advanced Manufacturing Supply Chain,0001-LEC 1st Mon Sp,Staff,24,0,24,0,0
7614,North Campus,CJE 1642 - 0001   Crime Scene Technology 2,0001-LEC Main Sess,Staff,30,25,5,0,0
8298,North Campus,EAP 1640 - 0001   Writing Level 6,0001-LEC Main Sess,Staff,28,0,28,0,0
8299,North Campus,EAP 1640 - 0002   Writing Level 6,0002-LEC Main Sess,Staff,28,23,5,0,0
8305,North Campus,EAP 1640 - 0003   Writing Level 6,0003-LEC Main Sess,Staff,29,28,1,0,0
8300,North Campus,EAP 1640 - 0004   Writing Level 6,0004-LEC Main Sess,Staff,28,0,28,0,0
8328,North Campus,EAP 1640 - 0005   Writing Level 6,0005-LEC Weekend,Staff,28,19,9,0,0
8324,North Campus,EAP 1640 - 0006   Writing Level 6,0006-LEC Eight Wk 2,Staff,28,24,4,0,0
8306,Kendall Campus,EAP 1640 - 0007   Writing Level 6,0007-LEC Main Sess,Staff,28,0,28,0,0
8327,Kendall Campus,EAP 1640 - 0008   Writing Level 6,0008-LEC Weekend,Staff,28,16,12,0,0
8307,Kendall Campus,EAP 1640 - 0009   Writing Level 6,0009-LEC Main Sess,Staff,28,26,2,0,0
8309,Kendall Campus,EAP 1640 - 0011   Writing Level 6,0011-LEC Main Sess,Staff,28,26,2,0,0
8310,Kendall Campus,EAP 1640 - 0012   Writing Level 6,0012-LEC Main Sess,Staff,28,0,28,0,0
8312,Wolfson Campus,EAP 1640 - 0014   Writing Level 6,0014-LEC Main Sess,Staff,25,20,5,0,0
8313,Wolfson Campus,EAP 1640 - 0015   Writing Level 6,0015-LEC Main Sess,Staff,27,24,3,0,0
8314,Wolfson Campus,EAP 1640 - 0016   Writing Level 6,0016-LEC Main Sess,Staff,27,16,11,0,0
8315,Wolfson Campus,EAP 1640 - 0017   Writing Level 6,0017-LEC Main Sess,Staff,27,25,2,0,0
8326,Wolfson Campus,EAP 1640 - 0019   Writing Level 6,0019-LEC Conversion,Staff,25,0,25,0,0
8317,Wolfson Campus,EAP 1640 - 0020   Writing Level 6,0020-LEC Main Sess,Staff,30,14,16,0,0
8318,Wolfson Campus,EAP 1640 - 0021   Writing Level 6,0021-LEC Main Sess,Staff,30,12,18,0,0
8319,Homestead Campus,EAP 1640 - 0022   Writing Level 6,0022-LEC Main Sess,Staff,20,15,5,0,0
8320,InterAmerican Campus,EAP 1640 - 0023   Writing Level 6,0023-LEC Main Sess,Staff,30,16,14,0,0
8321,InterAmerican Campus,EAP 1640 - 0024   Writing Level 6,0024-LEC Main Sess,Staff,30,0,30,0,0
8322,InterAmerican Campus,EAP 1640 - 0025   Writing Level 6,0025-LEC Main Sess,Staff,30,27,3,0,0
8304,InterAmerican Campus,EAP 1640 - 0026   Writing Level 6,0026-LEC Main Sess,Staff,30,12,18,0,0
8302,West Campus,EAP 1640 - 0028   Writing Level 6,0028-LEC Main Sess,Staff,35,27,8,0,0
8325,West Campus,EAP 1640 - 0029   Writing Level 6,0029-LEC Eight Wk 2,Staff,30,20,10,0,0
8301,West Campus,EAP 1640 - 0030   Writing Level 6,0030-LEC Main Sess,Staff,35,22,13,0,0
8323,West Campus,EAP 1640 - 0031   Writing Level 6,0031-LEC Twelve Wk,Staff,35,0,35,0,0
8544,North Campus,EAP 1640L - 0001   Writing Level 6 Laboratory,0001-LAB Main Sess,Staff,200,54,146,0,0
8569,North Campus,EAP 1640L - 0002   Writing Level 6 Laboratory,0002-LAB Weekend,Staff,200,15,185,0,0
8566,North Campus,EAP 1640L - 0003   Writing Level 6 Laboratory,0003-LAB Eight Wk 2,Staff,200,25,175,0,0
8545,Kendall Campus,EAP 1640L - 0004   Writing Level 6 Laboratory,0004-LAB Main Sess,Staff,28,26,2,0,0
8568,Kendall Campus,EAP 1640L - 0005   Writing Level 6 Laboratory,0005-LAB Weekend,Staff,28,18,10,0,0
8551,Kendall Campus,EAP 1640L - 0006   Writing Level 6 Laboratory,0006-LAB Main Sess,Staff,28,0,28,0,0
8552,Kendall Campus,EAP 1640L - 0007   Writing Level 6 Laboratory,0007-LAB Main Sess,Staff,28,0,28,0,0
8553,Kendall Campus,EAP 1640L - 0008   Writing Level 6 Laboratory,0008-LAB Main Sess,Staff,28,26,2,0,0
8554,Kendall Campus,EAP 1640L - 0009   Writing Level 6 Laboratory,0009-LAB Main Sess,Staff,28,23,5,0,0
8555,Wolfson Campus,EAP 1640L - 0010   Writing Level 6 Laboratory,0010-LAB Main Sess,Staff,30,19,11,0,0
8556,Wolfson Campus,EAP 1640L - 0011   Writing Level 6 Laboratory,0011-LAB Main Sess,Staff,28,25,3,0,0
8557,Wolfson Campus,EAP 1640L - 0012   Writing Level 6 Laboratory,0012-LAB Main Sess,Staff,28,17,11,0,0
8558,Wolfson Campus,EAP 1640L - 0013   Writing Level 6 Laboratory,0013-LAB Main Sess,Staff,28,25,3,0,0
8559,Wolfson Campus,EAP 1640L - 0014   Writing Level 6 Laboratory,0014-LAB Main Sess,Staff,28,23,5,0,0
8561,Wolfson Campus,EAP 1640L - 0016   Writing Level 6 Laboratory,0016-LAB Main Sess,Staff,30,14,16,0,0
8562,Wolfson Campus,EAP 1640L - 0017   Writing Level 6 Laboratory,0017-LAB Main Sess,Staff,30,12,18,0,0
8563,Homestead Campus,EAP 1640L - 0018   Writing Level 6 Laboratory,0018-LAB Main Sess,Staff,20,15,5,0,0
8550,InterAmerican Campus,EAP 1640L - 0019   Writing Level 6 Laboratory,0019-LAB Main Sess,Staff,21,11,10,0,0
8549,InterAmerican Campus,EAP 1640L - 0020   Writing Level 6 Laboratory,0020-LAB Main Sess,Staff,30,27,3,0,0
8567,InterAmerican Campus,EAP 1640L - 0021   Writing Level 6 Laboratory,0021-LAB 1st Mon Sp,Staff,30,0,30,0,0
8548,InterAmerican Campus,EAP 1640L - 0022   Writing Level 6 Laboratory,0022-LAB Main Sess,Staff,30,14,16,0,0
8547,Hialeah Campus,EAP 1640L - 0023   Writing Level 6 Laboratory,0023-LAB Main Sess,Staff,200,36,164,0,0
8546,West Campus,EAP 1640L - 0024   Writing Level 6 Laboratory,0024-LAB Main Sess,Staff,100,48,52,0,0
8564,West Campus,EAP 1640L - 0025   Writing Level 6 Laboratory,0025-LAB Twelve Wk,Staff,100,0,100,0,0
8565,West Campus,EAP 1640L - 0026   Writing Level 6 Laboratory,0026-LAB Eight Wk 2,Staff,35,22,13,0,0
11138,North Campus,ETI 1622 - 0001   Concepts Of Lean And Six Sigma,0001-LEC Twelve Wk,Staff,30,0,30,0,0
8190,North Campus,EAP 1620 - 0001   Reading Level 6,0001-LEC Main Sess,Staff,30,16,14,0,0
8193,North Campus,EAP 1620 - 0004   Reading Level 6,0004-LEC Main Sess,Staff,30,0,30,0,0
8194,North Campus,EAP 1620 - 0005   Reading Level 6,0005-LEC Main Sess,Staff,30,0,30,0,0
8210,North Campus,EAP 1620 - 0006   Reading Level 6,0006-LEC Eight Wk 2,Staff,30,26,4,0,0
8195,Kendall Campus,EAP 1620 - 0007   Reading Level 6,0007-LEC Main Sess,Staff,28,26,2,0,0
8196,Kendall Campus,EAP 1620 - 0008   Reading Level 6,0008-LEC Main Sess,Staff,28,0,28,0,0
8197,Kendall Campus,EAP 1620 - 0009   Reading Level 6,0009-LEC Main Sess,Staff,28,16,12,0,0
8189,Kendall Campus,EAP 1620 - 0010   Reading Level 6,0010-LEC Main Sess,Staff,28,24,4,0,0
8212,Wolfson Campus,EAP 1620 - 0014   Reading Level 6,0014-LEC Conversion,Staff,30,0,30,0,0
8202,Wolfson Campus,EAP 1620 - 0016   Reading Level 6,0016-LEC Main Sess,Staff,30,19,11,0,0
8203,Wolfson Campus,EAP 1620 - 0017   Reading Level 6,0017-LEC Main Sess,Staff,30,26,4,0,0
8204,Wolfson Campus,EAP 1620 - 0018   Reading Level 6,0018-LEC Main Sess,Staff,30,27,3,0,0
8213,Wolfson Campus,EAP 1620 - 0019   Reading Level 6,0019-LEC Conversion,Staff,30,20,10,0,0
8205,Homestead Campus,EAP 1620 - 0020   Reading Level 6,0020-LEC Main Sess,Staff,20,14,6,0,0
8206,InterAmerican Campus,EAP 1620 - 0021   Reading Level 6,0021-LEC Main Sess,Staff,30,12,18,0,0
8214,InterAmerican Campus,EAP 1620 - 0022   Reading Level 6,0022-LEC 1st Mon Sp,Staff,30,17,13,0,0
8207,InterAmerican Campus,EAP 1620 - 0023   Reading Level 6,0023-LEC Main Sess,Staff,30,10,20,0,0
8208,InterAmerican Campus,EAP 1620 - 0024   Reading Level 6,0024-LEC Main Sess,Staff,30,25,5,0,0
8209,Hialeah Campus,EAP 1620 - 0025   Reading Level 6,0025-LEC Main Sess,Staff,30,26,4,0,0
8192,West Campus,EAP 1620 - 0026   Reading Level 6,0026-LEC Main Sess,Staff,35,30,5,0,0
8211,West Campus,EAP 1620 - 0027   Reading Level 6,0027-LEC Eight Wk 2,Staff,30,20,10,0,0
8191,West Campus,EAP 1620 - 0028   Reading Level 6,0028-LEC Main Sess,Staff,35,27,8,0,0
5386,Homestead Campus,ASC 1610 - 0002   Aircraft Engines And Structure Theory,0002-LEC Main Sess,Staff,20,0,20,0,0
5385,Homestead Campus,ASC 1610 - 0003   Aircraft Engines And Structure Theory,0003-LEC Main Sess,Staff,30,0,30,0,0
12227,Medical Campus,MLT 1610 - 0001   Clinical Chemistry 1,0001-LEC Main Sess,Staff,35,28,7,0,0
11499,Medical Campus,MLT 1610L - 0001   Clinical Chemistry 1 Laboratory,0001-LAB Main Sess,Staff,20,14,6,0,0
11498,Medical Campus,MLT 1610L - 0002   Clinical Chemistry 1 Laboratory,0002-LAB Main Sess,Staff,18,15,3,0,0
13232,North Campus,TPP 1606 - 0001   Playwriting 1/2,0001-LEC Main Sess,Staff,12,5,7,0,0
13234,Kendall Campus,TPP 1606 - 0002   Playwriting 1/2,0002-LEC Main Sess,Staff,30,0,30,0,0
13233,Wolfson Campus,TPP 1606 - 0003   Playwriting 1/2,0003-LEC Main Sess,Staff,15,8,7,0,0
7662,Homestead Campus,ATF 1601L - 0001   Flight Orientation/Simulator Lab,0001-LAB Main Sess,Staff,30,0,30,0,0
7660,Homestead Campus,ATF 1601L - 0002   Flight Orientation/Simulator Lab,0002-LAB Main Sess,Staff,30,0,30,0,0
7661,Homestead Campus,ATF 1601L - 0003   Flight Orientation/Simulator Lab,0003-LAB Main Sess,Staff,12,0,12,0,0
7657,Homestead Campus,ATF 1601L - 0004   Flight Orientation/Simulator Lab,0004-LAB Main Sess,Staff,12,0,12,0,0
7658,Homestead Campus,ATF 1601L - 0005   Flight Orientation/Simulator Lab,0005-LAB Main Sess,Staff,30,0,30,0,0
7659,Homestead Campus,ATF 1601L - 0006   Flight Orientation/Simulator Lab,0006-LAB Main Sess,Staff,30,16,14,0,0
6846,Medical Campus,DES 1600 - 0001   Dental Office Emergency,0001-LEC Main Sess,Staff,50,43,7,0,0
9453,North Campus,EAP 1600 - 0003   Speech/Listening Level 6,0003-LEC Main Sess,Staff,28,0,28,0,0
9454,North Campus,EAP 1600 - 0004   Speech/Listening Level 6,0004-LEC Main Sess,Staff,28,0,28,0,0
9451,North Campus,EAP 1600 - 0005   Speech/Listening Level 6,0005-LEC Main Sess,Staff,28,15,13,0,0
9472,North Campus,EAP 1600 - 0006   Speech/Listening Level 6,0006-LEC Eight Wk 2,Staff,28,14,14,0,0
9455,Kendall Campus,EAP 1600 - 0007   Speech/Listening Level 6,0007-LEC Main Sess,Staff,28,16,12,0,0
9456,Kendall Campus,EAP 1600 - 0008   Speech/Listening Level 6,0008-LEC Main Sess,Staff,28,0,28,0,0
9457,Kendall Campus,EAP 1600 - 0009   Speech/Listening Level 6,0009-LEC Main Sess,Staff,28,21,7,0,0
9458,Kendall Campus,EAP 1600 - 0010   Speech/Listening Level 6,0010-LEC Main Sess,Staff,28,17,11,0,0
9460,Wolfson Campus,EAP 1600 - 0012   Speech/Listening Level 6,0012-LEC Main Sess,Staff,28,26,2,0,0
9461,Wolfson Campus,EAP 1600 - 0013   Speech/Listening Level 6,0013-LEC Main Sess,Staff,8,0,8,0,0
9462,Wolfson Campus,EAP 1600 - 0014   Speech/Listening Level 6,0014-LEC Main Sess,Staff,28,17,11,0,0
9463,Wolfson Campus,EAP 1600 - 0015   Speech/Listening Level 6,0015-LEC Main Sess,Staff,28,25,3,0,0
9464,Wolfson Campus,EAP 1600 - 0016   Speech/Listening Level 6,0016-LEC Main Sess,Staff,30,23,7,0,0
9465,Wolfson Campus,EAP 1600 - 0017   Speech/Listening Level 6,0017-LEC Main Sess,Staff,30,16,14,0,0
9466,Homestead Campus,EAP 1600 - 0018   Speech/Listening Level 6,0018-LEC Main Sess,Staff,20,19,1,0,0
9467,InterAmerican Campus,EAP 1600 - 0019   Speech/Listening Level 6,0019-LEC Main Sess,Staff,30,0,30,0,0
9468,InterAmerican Campus,EAP 1600 - 0020   Speech/Listening Level 6,0020-LEC Main Sess,Staff,29,12,17,0,0
9469,InterAmerican Campus,EAP 1600 - 0021   Speech/Listening Level 6,0021-LEC Main Sess,Staff,29,21,8,0,0
9474,InterAmerican Campus,EAP 1600 - 0022   Speech/Listening Level 6,0022-LEC 1st Mon Sp,Staff,30,19,11,0,0
9470,Hialeah Campus,EAP 1600 - 0023   Speech/Listening Level 6,0023-LEC Main Sess,Staff,30,26,4,0,0
9473,West Campus,EAP 1600 - 0024   Speech/Listening Level 6,0024-LEC Eight Wk 2,Staff,30,23,7,0,0
9471,West Campus,EAP 1600 - 0025   Speech/Listening Level 6,0025-LEC Main Sess,Staff,35,23,12,0,0
9452,West Campus,EAP 1600 - 0026   Speech/Listening Level 6,0026-LEC Main Sess,Staff,35,20,15,0,0
9847,North Campus,EAP 1600L - 0001   Speech/Listening Level 6 Laboratory,0001-LAB Main Sess,Staff,200,15,185,0,0
9863,North Campus,EAP 1600L - 0002   Speech/Listening Level 6 Laboratory,0002-LAB Eight Wk 2,Staff,200,17,183,0,0
9844,North Campus,EAP 1600L - 0003   Speech/Listening Level 6 Laboratory,0003-LAB Main Sess,Staff,200,59,141,0,0
9846,Kendall Campus,EAP 1600L - 0004   Speech/Listening Level 6 Laboratory,0004-LAB Main Sess,Staff,28,18,10,0,0
9845,Kendall Campus,EAP 1600L - 0005   Speech/Listening Level 6 Laboratory,0005-LAB Main Sess,Staff,28,16,12,0,0
9864,Kendall Campus,EAP 1600L - 0006   Speech/Listening Level 6 Laboratory,0006-LAB 1st Mon Sp,Staff,28,20,8,0,0
9849,Kendall Campus,EAP 1600L - 0007   Speech/Listening Level 6 Laboratory,0007-LAB Main Sess,Staff,28,0,28,0,0
9850,Wolfson Campus,EAP 1600L - 0008   Speech/Listening Level 6 Laboratory,0008-LAB Main Sess,Staff,28,24,4,0,0
9851,Wolfson Campus,EAP 1600L - 0009   Speech/Listening Level 6 Laboratory,0009-LAB Main Sess,Staff,28,23,5,0,0
9852,Wolfson Campus,EAP 1600L - 0010   Speech/Listening Level 6 Laboratory,0010-LAB Main Sess,Staff,28,23,5,0,0
9853,Wolfson Campus,EAP 1600L - 0011   Speech/Listening Level 6 Laboratory,0011-LAB Main Sess,Staff,28,0,28,0,0
9855,Wolfson Campus,EAP 1600L - 0013   Speech/Listening Level 6 Laboratory,0013-LAB Main Sess,Staff,30,17,13,0,0
9856,Wolfson Campus,EAP 1600L - 0014   Speech/Listening Level 6 Laboratory,0014-LAB Main Sess,Staff,30,23,7,0,0
9857,Homestead Campus,EAP 1600L - 0015   Speech/Listening Level 6 Laboratory,0015-LAB Main Sess,Staff,20,19,1,0,0
9858,InterAmerican Campus,EAP 1600L - 0016   Speech/Listening Level 6 Laboratory,0016-LAB Main Sess,Staff,30,8,22,0,0
9865,InterAmerican Campus,EAP 1600L - 0017   Speech/Listening Level 6 Laboratory,0017-LAB 1st Mon Sp,Staff,30,19,11,0,0
9859,InterAmerican Campus,EAP 1600L - 0018   Speech/Listening Level 6 Laboratory,0018-LAB Main Sess,Staff,30,0,30,0,0
9860,InterAmerican Campus,EAP 1600L - 0019   Speech/Listening Level 6 Laboratory,0019-LAB Main Sess,Staff,25,20,5,0,0
9861,Hialeah Campus,EAP 1600L - 0020   Speech/Listening Level 6 Laboratory,0020-LAB Main Sess,Staff,200,28,172,0,0
9862,West Campus,EAP 1600L - 0021   Speech/Listening Level 6 Laboratory,0021-LAB Eight Wk 2,Staff,35,21,14,0,0
9848,West Campus,EAP 1600L - 0022   Speech/Listening Level 6 Laboratory,0022-LAB Main Sess,Staff,100,44,56,0,0
7418,North Campus,EAP 1586 - 0001   Advanced 1 - Integrated Reading· Speech & Listening,0001-LEC Main Sess,Staff,30,25,5,0,0
7419,North Campus,EAP 1586 - 0002   Advanced 1 - Integrated Reading· Speech & Listening,0002-LEC Main Sess,Staff,30,0,30,0,0
7421,Kendall Campus,EAP 1586 - 0004   Advanced 1 - Integrated Reading· Speech & Listening,0004-LEC Main Sess,Staff,25,23,2,0,0
7422,Kendall Campus,EAP 1586 - 0005   Advanced 1 - Integrated Reading· Speech & Listening,0005-LEC Main Sess,Staff,25,22,3,0,0
7423,Wolfson Campus,EAP 1586 - 0006   Advanced 1 - Integrated Reading· Speech & Listening,0006-LEC Main Sess,Staff,26,23,3,0,0
7424,InterAmerican Campus,EAP 1586 - 0007   Advanced 1 - Integrated Reading· Speech & Listening,0007-LEC Main Sess,Staff,30,11,19,0,0
7425,InterAmerican Campus,EAP 1586 - 0008   Advanced 1 - Integrated Reading· Speech & Listening,0008-LEC Main Sess,Staff,30,22,8,0,0
7426,Hialeah Campus,EAP 1586 - 0009   Advanced 1 - Integrated Reading· Speech & Listening,0009-LEC Main Sess,Staff,30,22,8,0,0
7428,Hialeah Campus,EAP 1586 - 0011   Advanced 1 - Integrated Reading· Speech & Listening,0011-LEC Main Sess,Staff,30,22,8,0,0
7429,Hialeah Campus,EAP 1586 - 0012   Advanced 1 - Integrated Reading· Speech & Listening,0012-LEC Main Sess,Staff,30,18,12,0,0
7431,West Campus,EAP 1586 - 0013   Advanced 1 - Integrated Reading· Speech & Listening,0013-LEC Conversion,Staff,30,0,30,0,0
9148,North Campus,EAP 1585 - 0001   Advanced 1 - Integrated Writing & Grammar,0001-LEC Main Sess,Staff,30,24,6,0,0
9149,North Campus,EAP 1585 - 0002   Advanced 1 - Integrated Writing & Grammar,0002-LEC Main Sess,Staff,22,0,22,0,0
9150,Kendall Campus,EAP 1585 - 0003   Advanced 1 - Integrated Writing & Grammar,0003-LEC Main Sess,Staff,25,23,2,0,0
9151,Kendall Campus,EAP 1585 - 0004   Advanced 1 - Integrated Writing & Grammar,0004-LEC Main Sess,Staff,25,22,3,0,0
9153,Wolfson Campus,EAP 1585 - 0006   Advanced 1 - Integrated Writing & Grammar,0006-LEC Main Sess,Staff,26,23,3,0,0
9154,InterAmerican Campus,EAP 1585 - 0007   Advanced 1 - Integrated Writing & Grammar,0007-LEC Main Sess,Staff,28,13,15,0,0
9156,Hialeah Campus,EAP 1585 - 0009   Advanced 1 - Integrated Writing & Grammar,0009-LEC Main Sess,Staff,30,25,5,0,0
9157,Hialeah Campus,EAP 1585 - 0010   Advanced 1 - Integrated Writing & Grammar,0010-LEC Main Sess,Staff,30,21,9,0,0
9159,Hialeah Campus,EAP 1585 - 0012   Advanced 1 - Integrated Writing & Grammar,0012-LEC Main Sess,Staff,30,25,5,0,0
9161,West Campus,EAP 1585 - 0013   Advanced 1 - Integrated Writing & Grammar,0013-LEC Conversion,Staff,30,0,30,0,0
13817,North Campus,CGS 1560 - 0001   A+ Computer Operating Systems,0001-LEC Conversion,Staff,25,21,4,0,0
13815,North Campus,CGS 1560 - 0002   A+ Computer Operating Systems,0002-LEC Main Sess,Staff,25,11,14,0,0
14276,North Campus,EAP 1560 - 0001   Grammar Level 5,0001-LEC Weekend,Staff,30,25,5,0,0
14245,North Campus,EAP 1560 - 0002   Grammar Level 5,0002-LEC Main Sess,Staff,30,27,3,0,0
14246,North Campus,EAP 1560 - 0003   Grammar Level 5,0003-LEC Main Sess,Staff,30,22,8,0,0
14274,North Campus,EAP 1560 - 0004   Grammar Level 5,0004-LEC Eight Wk 1,Staff,30,17,13,0,0
14252,North Campus,EAP 1560 - 0005   Grammar Level 5,0005-LEC Main Sess,Staff,30,0,30,0,0
14253,North Campus,EAP 1560 - 0006   Grammar Level 5,0006-LEC Main Sess,Staff,30,27,3,0,0
14254,North Campus,EAP 1560 - 0007   Grammar Level 5,0007-LEC Main Sess,Staff,30,0,30,0,0
14255,North Campus,EAP 1560 - 0008   Grammar Level 5,0008-LEC Main Sess,Staff,30,20,10,0,0
14256,Kendall Campus,EAP 1560 - 0009   Grammar Level 5,0009-LEC Main Sess,Staff,28,12,16,0,0
14258,Kendall Campus,EAP 1560 - 0011   Grammar Level 5,0011-LEC Main Sess,Staff,28,10,18,0,0
14259,Kendall Campus,EAP 1560 - 0012   Grammar Level 5,0012-LEC Main Sess,Staff,28,25,3,0,0
14247,Kendall Campus,EAP 1560 - 0013   Grammar Level 5,0013-LEC Main Sess,Staff,28,26,2,0,0
14260,Kendall Campus,EAP 1560 - 0014   Grammar Level 5,0014-LEC Main Sess,Staff,28,26,2,0,0
14261,Wolfson Campus,EAP 1560 - 0015   Grammar Level 5,0015-LEC Main Sess,Staff,30,25,5,0,0
14262,Wolfson Campus,EAP 1560 - 0016   Grammar Level 5,0016-LEC Main Sess,Staff,30,29,1,0,0
14263,Wolfson Campus,EAP 1560 - 0017   Grammar Level 5,0017-LEC Main Sess,Staff,30,28,2,0,0
14272,Wolfson Campus,EAP 1560 - 0018   Grammar Level 5,0018-LEC Twelve Wk,Staff,30,0,30,0,0
14271,Wolfson Campus,EAP 1560 - 0019   Grammar Level 5,0019-LEC Twelve Wk,Staff,11,0,11,0,0
14264,Wolfson Campus,EAP 1560 - 0020   Grammar Level 5,0020-LEC Main Sess,Staff,30,23,7,0,0
14265,Wolfson Campus,EAP 1560 - 0021   Grammar Level 5,0021-LEC Main Sess,Staff,30,24,6,0,0
14266,Wolfson Campus,EAP 1560 - 0022   Grammar Level 5,0022-LEC Main Sess,Staff,30,20,10,0,0
14267,Homestead Campus,EAP 1560 - 0023   Grammar Level 5,0023-LEC Main Sess,Staff,20,12,8,0,0
14268,InterAmerican Campus,EAP 1560 - 0025   Grammar Level 5,0025-LEC Main Sess,Staff,30,20,10,0,0
14269,InterAmerican Campus,EAP 1560 - 0026   Grammar Level 5,0026-LEC Main Sess,Staff,30,20,10,0,0
14270,InterAmerican Campus,EAP 1560 - 0027   Grammar Level 5,0027-LEC Main Sess,Staff,30,25,5,0,0
14251,InterAmerican Campus,EAP 1560 - 0028   Grammar Level 5,0028-LEC Main Sess,Staff,30,20,10,0,0
14250,Hialeah Campus,EAP 1560 - 0029   Grammar Level 5,0029-LEC Main Sess,Staff,30,11,19,0,0
14249,West Campus,EAP 1560 - 0030   Grammar Level 5,0030-LEC Main Sess,Staff,35,29,6,0,0
14248,West Campus,EAP 1560 - 0031   Grammar Level 5,0031-LEC Main Sess,Staff,35,32,3,0,0
7170,Homestead Campus,ASC 1550 - 0001   Aerodynamics,0001-LEC Main Sess,Staff,30,20,10,0,0
7980,North Campus,CGS 1540 - 0001   Database Concepts Design,0001-LEC 1st Mon Sp,Staff,30,24,6,0,0
7969,North Campus,CGS 1540 - 0002   Database Concepts Design,0002-LEC Main Sess,Staff,30,13,17,0,0
7970,Kendall Campus,CGS 1540 - 0003   Database Concepts Design,0003-LEC Main Sess,Staff,20,19,1,0,0
7975,Kendall Campus,CGS 1540 - 0006   Database Concepts Design,0006-LEC Main Sess,Staff,38,13,25,0,0
7973,Wolfson Campus,CGS 1540 - 0007   Database Concepts Design,0007-LEC Main Sess,Staff,16,13,3,0,0
7974,Wolfson Campus,CGS 1540 - 0008   Database Concepts Design,0008-LEC Main Sess,Staff,22,16,6,0,0
7977,Wolfson Campus,CGS 1540 - 0009   Database Concepts Design,0009-LEC Main Sess,Staff,30,27,3,0,0
7979,Homestead Campus,CGS 1540 - 0010   Database Concepts Design,0010-LEC Eight Wk 2,Staff,20,12,8,0,0
7976,InterAmerican Campus,CGS 1540 - 0011   Database Concepts Design,0011-LEC Main Sess,Staff,30,9,21,0,0
7978,InterAmerican Campus,CGS 1540 - 0012   Database Concepts Design,0012-LEC Twelve Wk,Staff,30,0,30,0,0
7323,North Campus,EAP 1540 - 0001   Writing Level 5,0001-LEC Main Sess,Staff,28,26,2,0,0
7349,North Campus,EAP 1540 - 0002   Writing Level 5,0002-LEC Eight Wk 1,Staff,28,19,9,0,0
7324,North Campus,EAP 1540 - 0003   Writing Level 5,0003-LEC Main Sess,Staff,30,24,6,0,0
7352,North Campus,EAP 1540 - 0004   Writing Level 5,0004-LEC Weekend,Staff,29,18,11,0,0
7332,North Campus,EAP 1540 - 0006   Writing Level 5,0006-LEC Main Sess,Staff,28,17,11,0,0
7333,North Campus,EAP 1540 - 0007   Writing Level 5,0007-LEC Main Sess,Staff,24,0,24,0,0
7353,Kendall Campus,EAP 1540 - 0008   Writing Level 5,0008-LEC Weekend,Staff,28,14,14,0,0
7334,Kendall Campus,EAP 1540 - 0009   Writing Level 5,0009-LEC Main Sess,Staff,28,22,6,0,0
7335,Kendall Campus,EAP 1540 - 0010   Writing Level 5,0010-LEC Main Sess,Staff,28,16,12,0,0
7336,Kendall Campus,EAP 1540 - 0011   Writing Level 5,0011-LEC Main Sess,Staff,28,27,1,0,0
7337,Kendall Campus,EAP 1540 - 0012   Writing Level 5,0012-LEC Main Sess,Staff,28,25,3,0,0
7347,Wolfson Campus,EAP 1540 - 0013   Writing Level 5,0013-LEC Twelve Wk,Staff,9,0,9,0,0
7338,Wolfson Campus,EAP 1540 - 0014   Writing Level 5,0014-LEC Main Sess,Staff,25,15,10,0,0
7339,Wolfson Campus,EAP 1540 - 0015   Writing Level 5,0015-LEC Main Sess,Staff,7,0,7,0,0
7340,Wolfson Campus,EAP 1540 - 0016   Writing Level 5,0016-LEC Main Sess,Staff,25,18,7,0,0
7350,Wolfson Campus,EAP 1540 - 0017   Writing Level 5,0017-LEC Conversion,Staff,28,0,28,0,0
7343,Wolfson Campus,EAP 1540 - 0020   Writing Level 5,0020-LEC Main Sess,Staff,28,23,5,0,0
7344,Wolfson Campus,EAP 1540 - 0021   Writing Level 5,0021-LEC Main Sess,Staff,28,26,2,0,0
7345,Homestead Campus,EAP 1540 - 0022   Writing Level 5,0022-LEC Main Sess,Staff,20,13,7,0,0
7346,InterAmerican Campus,EAP 1540 - 0023   Writing Level 5,0023-LEC Main Sess,Staff,30,23,7,0,0
7330,InterAmerican Campus,EAP 1540 - 0024   Writing Level 5,0024-LEC Main Sess,Staff,29,25,4,0,0
7329,InterAmerican Campus,EAP 1540 - 0025   Writing Level 5,0025-LEC Main Sess,Staff,30,24,6,0,0
7351,InterAmerican Campus,EAP 1540 - 0026   Writing Level 5,0026-LEC 1st Mon Sp,Staff,30,22,8,0,0
7328,InterAmerican Campus,EAP 1540 - 0027   Writing Level 5,0027-LEC Main Sess,Staff,30,15,15,0,0
7327,Hialeah Campus,EAP 1540 - 0028   Writing Level 5,0028-LEC Main Sess,Staff,30,10,20,0,0
7326,West Campus,EAP 1540 - 0030   Writing Level 5,0030-LEC Main Sess,Staff,35,22,13,0,0
7325,West Campus,EAP 1540 - 0031   Writing Level 5,0031-LEC Main Sess,Staff,35,30,5,0,0
9730,North Campus,EAP 1540L - 0001   Writing Level 5 Laboratory,0001-LAB Eight Wk 1,Staff,200,19,181,0,0
9709,North Campus,EAP 1540L - 0002   Writing Level 5 Laboratory,0002-LAB Main Sess,Staff,200,98,102,0,0
9733,North Campus,EAP 1540L - 0003   Writing Level 5 Laboratory,0003-LAB Weekend,Staff,200,16,184,0,0
9710,Kendall Campus,EAP 1540L - 0004   Writing Level 5 Laboratory,0004-LAB Main Sess,Staff,28,27,1,0,0
9715,Kendall Campus,EAP 1540L - 0005   Writing Level 5 Laboratory,0005-LAB Main Sess,Staff,28,11,17,0,0
9716,Kendall Campus,EAP 1540L - 0006   Writing Level 5 Laboratory,0006-LAB Main Sess,Staff,28,24,4,0,0
9717,Kendall Campus,EAP 1540L - 0007   Writing Level 5 Laboratory,0007-LAB Main Sess,Staff,28,26,2,0,0
9732,Kendall Campus,EAP 1540L - 0008   Writing Level 5 Laboratory,0008-LAB Weekend,Staff,28,17,11,0,0
9718,Wolfson Campus,EAP 1540L - 0009   Writing Level 5 Laboratory,0009-LAB Main Sess,Staff,30,19,11,0,0
9719,Wolfson Campus,EAP 1540L - 0010   Writing Level 5 Laboratory,0010-LAB Main Sess,Staff,30,24,6,0,0
9720,Wolfson Campus,EAP 1540L - 0011   Writing Level 5 Laboratory,0011-LAB Main Sess,Staff,30,25,5,0,0
9721,Wolfson Campus,EAP 1540L - 0012   Writing Level 5 Laboratory,0012-LAB Main Sess,Staff,30,26,4,0,0
9722,Wolfson Campus,EAP 1540L - 0013   Writing Level 5 Laboratory,0013-LAB Main Sess,Staff,30,27,3,0,0
9723,Wolfson Campus,EAP 1540L - 0014   Writing Level 5 Laboratory,0014-LAB Main Sess,Staff,30,15,15,0,0
9724,Wolfson Campus,EAP 1540L - 0015   Writing Level 5 Laboratory,0015-LAB Main Sess,Staff,30,0,30,0,0
9729,Wolfson Campus,EAP 1540L - 0016   Writing Level 5 Laboratory,0016-LAB Twelve Wk,Staff,30,0,30,0,0
9725,Homestead Campus,EAP 1540L - 0017   Writing Level 5 Laboratory,0017-LAB Main Sess,Staff,20,9,11,0,0
9726,InterAmerican Campus,EAP 1540L - 0018   Writing Level 5 Laboratory,0018-LAB Main Sess,Staff,30,23,7,0,0
9727,InterAmerican Campus,EAP 1540L - 0019   Writing Level 5 Laboratory,0019-LAB Main Sess,Staff,30,23,7,0,0
9728,InterAmerican Campus,EAP 1540L - 0020   Writing Level 5 Laboratory,0020-LAB Main Sess,Staff,21,20,1,0,0
9711,InterAmerican Campus,EAP 1540L - 0021   Writing Level 5 Laboratory,0021-LAB Main Sess,Staff,30,19,11,0,0
9714,InterAmerican Campus,EAP 1540L - 0022   Writing Level 5 Laboratory,0022-LAB Main Sess,Staff,30,22,8,0,0
9713,Hialeah Campus,EAP 1540L - 0023   Writing Level 5 Laboratory,0023-LAB Main Sess,Staff,200,10,190,0,0
9712,West Campus,EAP 1540L - 0024   Writing Level 5 Laboratory,0024-LAB Main Sess,Staff,70,53,17,0,0
9731,West Campus,EAP 1540L - 0025   Writing Level 5 Laboratory,0025-LAB Eight Wk 1,Staff,80,19,61,0,0
11258,North Campus,EEC 1522 - 0001   Infant And Toddler Environments,0001-LEC Twelve Wk,Staff,30,8,22,0,0
10764,North Campus,DAA 1520 - 0001   Tap Dance,0001-LEC Main Sess,Staff,12,2,10,0,0
9491,North Campus,EAP 1520 - 0001   Reading Level 5,0001-LEC Main Sess,Staff,30,24,6,0,0
9492,North Campus,EAP 1520 - 0002   Reading Level 5,0002-LEC Main Sess,Staff,30,0,30,0,0
9497,North Campus,EAP 1520 - 0003   Reading Level 5,0003-LEC Main Sess,Staff,30,18,12,0,0
9498,North Campus,EAP 1520 - 0004   Reading Level 5,0004-LEC Main Sess,Staff,30,11,19,0,0
9499,North Campus,EAP 1520 - 0005   Reading Level 5,0005-LEC Main Sess,Staff,30,17,13,0,0
9493,North Campus,EAP 1520 - 0006   Reading Level 5,0006-LEC Main Sess,Staff,30,14,16,0,0
9518,North Campus,EAP 1520 - 0007   Reading Level 5,0007-LEC Eight Wk 1,Staff,30,14,16,0,0
9520,Kendall Campus,EAP 1520 - 0008   Reading Level 5,0008-LEC Weekend,Staff,28,26,2,0,0
9500,Kendall Campus,EAP 1520 - 0009   Reading Level 5,0009-LEC Main Sess,Staff,28,25,3,0,0
9501,Kendall Campus,EAP 1520 - 0010   Reading Level 5,0010-LEC Main Sess,Staff,28,20,8,0,0
9502,Kendall Campus,EAP 1520 - 0011   Reading Level 5,0011-LEC Main Sess,Staff,28,27,1,0,0
9503,Kendall Campus,EAP 1520 - 0012   Reading Level 5,0012-LEC Main Sess,Staff,28,27,1,0,0
9504,Wolfson Campus,EAP 1520 - 0013   Reading Level 5,0013-LEC Main Sess,Staff,30,26,4,0,0
9505,Wolfson Campus,EAP 1520 - 0014   Reading Level 5,0014-LEC Main Sess,Staff,30,22,8,0,0
9506,Wolfson Campus,EAP 1520 - 0015   Reading Level 5,0015-LEC Main Sess,Staff,8,0,8,0,0
9507,Wolfson Campus,EAP 1520 - 0016   Reading Level 5,0016-LEC Main Sess,Staff,30,27,3,0,0
9517,Wolfson Campus,EAP 1520 - 0017   Reading Level 5,0017-LEC Twelve Wk,Staff,30,0,30,0,0
9508,Wolfson Campus,EAP 1520 - 0018   Reading Level 5,0018-LEC Main Sess,Staff,30,26,4,0,0
9509,Wolfson Campus,EAP 1520 - 0019   Reading Level 5,0019-LEC Main Sess,Staff,30,27,3,0,0
9516,Wolfson Campus,EAP 1520 - 0020   Reading Level 5,0020-LEC Twelve Wk,Staff,30,0,30,0,0
9510,Homestead Campus,EAP 1520 - 0021   Reading Level 5,0021-LEC Main Sess,Staff,20,11,9,0,0
9511,InterAmerican Campus,EAP 1520 - 0022   Reading Level 5,0022-LEC Main Sess,Staff,30,27,3,0,0
9512,InterAmerican Campus,EAP 1520 - 0023   Reading Level 5,0023-LEC Main Sess,Staff,30,28,2,0,0
9513,InterAmerican Campus,EAP 1520 - 0024   Reading Level 5,0024-LEC Main Sess,Staff,25,24,1,0,0
9514,InterAmerican Campus,EAP 1520 - 0025   Reading Level 5,0025-LEC Main Sess,Staff,30,25,5,0,0
9515,InterAmerican Campus,EAP 1520 - 0026   Reading Level 5,0026-LEC Main Sess,Staff,30,12,18,0,0
9496,Hialeah Campus,EAP 1520 - 0027   Reading Level 5,0027-LEC Main Sess,Staff,30,9,21,0,0
9495,West Campus,EAP 1520 - 0028   Reading Level 5,0028-LEC Main Sess,Staff,35,31,4,0,0
9494,West Campus,EAP 1520 - 0030   Reading Level 5,0030-LEC Main Sess,Staff,35,15,20,0,0
13194,North Campus,PSC 1515 - 0001   Energy In The Natural Environment,0001-LEC Twelve Wk,Staff,45,37,8,0,0
13145,North Campus,PSC 1515 - 0002   Energy In The Natural Environment,0002-LEC Main Sess,Staff,40,37,3,0,0
13193,North Campus,PSC 1515 - 0003   Energy In The Natural Environment,0003-LEC Twelve Wk,Staff,45,43,2,0,0
13146,North Campus,PSC 1515 - 0004   Energy In The Natural Environment,0004-LEC Main Sess,Staff,45,40,5,0,0
13192,North Campus,PSC 1515 - 0005   Energy In The Natural Environment,0005-LEC Twelve Wk,Staff,45,43,2,0,0
13158,North Campus,PSC 1515 - 0007   Energy In The Natural Environment,0007-LEC Main Sess,Staff,40,37,3,0,0
13159,North Campus,PSC 1515 - 0008   Energy In The Natural Environment,0008-LEC Main Sess,Staff,42,41,1,0,0
13160,North Campus,PSC 1515 - 0010   Energy In The Natural Environment,0010-LEC Main Sess,Staff,35,17,18,0,0
13161,Kendall Campus,PSC 1515 - 0011   Energy In The Natural Environment,0011-LEC Main Sess,Staff,55,43,12,0,0
13163,Kendall Campus,PSC 1515 - 0013   Energy In The Natural Environment,0013-LEC Main Sess,Staff,50,39,11,0,0
13164,Kendall Campus,PSC 1515 - 0014   Energy In The Natural Environment,0014-LEC Main Sess,Staff,50,49,1,0,0
13166,Kendall Campus,PSC 1515 - 0017   Energy In The Natural Environment,0017-LEC Main Sess,Staff,110,0,110,0,0
13169,Kendall Campus,PSC 1515 - 0020   Energy In The Natural Environment,0020-LEC Main Sess,Staff,42,41,1,0,0
13170,Wolfson Campus,PSC 1515 - 0021   Energy In The Natural Environment,0021-LEC Main Sess,Staff,47,44,3,0,0
13171,Wolfson Campus,PSC 1515 - 0022   Energy In The Natural Environment,0022-LEC Main Sess,Staff,47,23,24,0,0
13172,Wolfson Campus,PSC 1515 - 0023   Energy In The Natural Environment,0023-LEC Main Sess,Staff,40,39,1,0,0
13173,Wolfson Campus,PSC 1515 - 0024   Energy In The Natural Environment,0024-LEC Main Sess,Staff,47,45,2,0,0
13175,Wolfson Campus,PSC 1515 - 0026   Energy In The Natural Environment,0026-LEC Main Sess,Staff,40,37,3,0,0
13176,Wolfson Campus,PSC 1515 - 0027   Energy In The Natural Environment,0027-LEC Main Sess,Staff,30,28,2,0,0
13200,Wolfson Campus,PSC 1515 - 0028   Energy In The Natural Environment,0028-LEC Conversion,Staff,30,29,1,0,0
13177,Wolfson Campus,PSC 1515 - 0029   Energy In The Natural Environment,0029-LEC Main Sess,Staff,30,29,1,0,0
13178,Wolfson Campus,PSC 1515 - 0030   Energy In The Natural Environment,0030-LEC Main Sess,Staff,30,28,2,0,0
13179,Wolfson Campus,PSC 1515 - 0031   Energy In The Natural Environment,0031-LEC Main Sess,Staff,30,26,4,0,0
13180,Wolfson Campus,PSC 1515 - 0032   Energy In The Natural Environment,0032-LEC Main Sess,Staff,30,26,4,0,0
13181,Wolfson Campus,PSC 1515 - 0033   Energy In The Natural Environment,0033-LEC Main Sess,Staff,30,26,4,0,0
13182,Wolfson Campus,PSC 1515 - 0034   Energy In The Natural Environment,0034-LEC Main Sess,Staff,30,29,1,0,0
13183,Wolfson Campus,PSC 1515 - 0035   Energy In The Natural Environment,0035-LEC Main Sess,Staff,30,26,4,0,0
13184,Homestead Campus,PSC 1515 - 0036   Energy In The Natural Environment,0036-LEC Main Sess,Staff,39,38,1,0,0
13185,Homestead Campus,PSC 1515 - 0037   Energy In The Natural Environment,0037-LEC Main Sess,Staff,39,0,39,0,0
13201,InterAmerican Campus,PSC 1515 - 0038   Energy In The Natural Environment,0038-LEC Weekend,Staff,45,35,10,0,0
13186,InterAmerican Campus,PSC 1515 - 0039   Energy In The Natural Environment,0039-LEC Main Sess,Staff,40,36,4,0,0
13195,InterAmerican Campus,PSC 1515 - 0040   Energy In The Natural Environment,0040-LEC Twelve Wk,Staff,30,22,8,0,0
13188,InterAmerican Campus,PSC 1515 - 0042   Energy In The Natural Environment,0042-LEC Main Sess,Staff,40,37,3,0,0
13189,Hialeah Campus,PSC 1515 - 0043   Energy In The Natural Environment,0043-LEC Main Sess,Staff,38,37,1,0,0
13190,Hialeah Campus,PSC 1515 - 0044   Energy In The Natural Environment,0044-LEC Main Sess,Staff,35,30,5,0,0
13198,Hialeah Campus,PSC 1515 - 0045   Energy In The Natural Environment,0045-LEC Twelve Wk,Staff,36,33,3,0,0
13156,Hialeah Campus,PSC 1515 - 0046   Energy In The Natural Environment,0046-LEC Main Sess,Staff,38,36,2,0,0
13197,Hialeah Campus,PSC 1515 - 0047   Energy In The Natural Environment,0047-LEC Twelve Wk,Staff,30,27,3,0,0
13155,West Campus,PSC 1515 - 0048   Energy In The Natural Environment,0048-LEC Main Sess,Staff,35,10,25,0,0
13154,West Campus,PSC 1515 - 0049   Energy In The Natural Environment,0049-LEC Main Sess,Staff,35,22,13,0,0
13147,West Campus,PSC 1515 - 0050   Energy In The Natural Environment,0050-LEC Main Sess,Staff,35,13,22,0,0
13153,West Campus,PSC 1515 - 0051   Energy In The Natural Environment,0051-LEC Main Sess,Staff,35,8,27,0,0
13152,West Campus,PSC 1515 - 0052   Energy In The Natural Environment,0052-LEC Main Sess,Staff,35,15,20,0,0
13151,West Campus,PSC 1515 - 0053   Energy In The Natural Environment,0053-LEC Main Sess,Staff,35,34,1,0,0
13150,West Campus,PSC 1515 - 0054   Energy In The Natural Environment,0054-LEC Main Sess,Staff,35,18,17,0,0
13196,West Campus,PSC 1515 - 0055   Energy In The Natural Environment,0055-LEC Twelve Wk,Staff,35,25,10,0,0
13149,West Campus,PSC 1515 - 0056   Energy In The Natural Environment,0056-LEC Main Sess,Staff,35,34,1,0,0
13148,West Campus,PSC 1515 - 0057   Energy In The Natural Environment,0057-LEC Main Sess,Staff,35,11,24,0,0
16951,Medical Campus,RTE 1513 - 0001   Radiographic Positioning 2,0001-LEC 1st Mon Sp,Staff,48,40,8,0,0
12021,Medical Campus,RTE 1513L - 0002   Radiographic Positioning Laboratory 2,0002-LAB Conversion,Staff,6,5,1,0,0
16839,North Campus,SLS 1510 - 0001   Preparing For Student Success,0001-LEC Main Sess,Staff,30,24,6,0,0
16840,North Campus,SLS 1510 - 0002   Preparing For Student Success,0002-LEC Main Sess,Staff,30,25,5,0,0
16841,North Campus,SLS 1510 - 0003   Preparing For Student Success,0003-LEC Main Sess,Staff,35,11,24,0,0
16881,North Campus,SLS 1510 - 0004   Preparing For Student Success,0004-LEC Twelve Wk,Staff,33,0,33,0,0
16842,North Campus,SLS 1510 - 0005   Preparing For Student Success,0005-LEC Main Sess,Staff,30,17,13,0,0
16843,North Campus,SLS 1510 - 0006   Preparing For Student Success,0006-LEC Main Sess,Staff,30,11,19,0,0
16844,North Campus,SLS 1510 - 0007   Preparing For Student Success,0007-LEC Main Sess,Staff,40,26,14,0,0
16902,North Campus,SLS 1510 - 0008   Preparing For Student Success,0008-LEC Conversion,Staff,37,21,16,0,0
16845,North Campus,SLS 1510 - 0009   Preparing For Student Success,0009-LEC Main Sess,Staff,40,0,40,0,0
16846,North Campus,SLS 1510 - 0010   Preparing For Student Success,0010-LEC Main Sess,Staff,30,0,30,0,0
16847,North Campus,SLS 1510 - 0011   Preparing For Student Success,0011-LEC Main Sess,Staff,40,16,24,0,0
16882,North Campus,SLS 1510 - 0012   Preparing For Student Success,0012-LEC Twelve Wk,Staff,37,30,7,0,0
16848,North Campus,SLS 1510 - 0013   Preparing For Student Success,0013-LEC Main Sess,Staff,40,0,40,0,0
16883,North Campus,SLS 1510 - 0014   Preparing For Student Success,0014-LEC Twelve Wk,Staff,30,26,4,0,0
16884,North Campus,SLS 1510 - 0015   Preparing For Student Success,0015-LEC Twelve Wk,Staff,40,23,17,0,0
16885,North Campus,SLS 1510 - 0016   Preparing For Student Success,0016-LEC Twelve Wk,Staff,40,25,15,0,0
16886,North Campus,SLS 1510 - 0017   Preparing For Student Success,0017-LEC Twelve Wk,Staff,40,0,40,0,0
16900,North Campus,SLS 1510 - 0018   Preparing For Student Success,0018-LEC Conversion,Staff,40,32,8,0,0
16899,North Campus,SLS 1510 - 0019   Preparing For Student Success,0019-LEC Eight Wk 2,Staff,40,37,3,0,0
16887,North Campus,SLS 1510 - 0020   Preparing For Student Success,0020-LEC Twelve Wk,Staff,40,9,31,0,0
16888,North Campus,SLS 1510 - 0021   Preparing For Student Success,0021-LEC Twelve Wk,Staff,35,0,35,0,0
16889,North Campus,SLS 1510 - 0022   Preparing For Student Success,0022-LEC Twelve Wk,Staff,40,0,40,0,0
16901,North Campus,SLS 1510 - 0023   Preparing For Student Success,0023-LEC Conversion,Staff,40,32,8,0,0
16890,North Campus,SLS 1510 - 0024   Preparing For Student Success,0024-LEC Twelve Wk,Staff,37,11,26,0,0
16849,North Campus,SLS 1510 - 0025   Preparing For Student Success,0025-LEC Main Sess,Staff,37,0,37,0,0
16852,Kendall Campus,SLS 1510 - 0028   Preparing For Student Success,0028-LEC Main Sess,Staff,30,25,5,0,0
16853,Kendall Campus,SLS 1510 - 0029   Preparing For Student Success,0029-LEC Main Sess,Staff,30,14,16,0,0
16854,Kendall Campus,SLS 1510 - 0030   Preparing For Student Success,0030-LEC Main Sess,Staff,30,29,1,0,0
16891,Kendall Campus,SLS 1510 - 0031   Preparing For Student Success,0031-LEC Twelve Wk,Staff,38,13,25,0,0
16855,Kendall Campus,SLS 1510 - 0032   Preparing For Student Success,0032-LEC Main Sess,Staff,30,29,1,0,0
16892,Kendall Campus,SLS 1510 - 0033   Preparing For Student Success,0033-LEC Twelve Wk,Staff,35,26,9,0,0
16893,Kendall Campus,SLS 1510 - 0034   Preparing For Student Success,0034-LEC Twelve Wk,Staff,40,28,12,0,0
16903,Kendall Campus,SLS 1510 - 0036   Preparing For Student Success,0036-LEC Weekend,Staff,30,0,30,0,0
16856,Kendall Campus,SLS 1510 - 0037   Preparing For Student Success,0037-LEC Main Sess,Staff,30,28,2,0,0
16894,Kendall Campus,SLS 1510 - 0038   Preparing For Student Success,0038-LEC Twelve Wk,Staff,30,15,15,0,0
16898,Kendall Campus,SLS 1510 - 0039   Preparing For Student Success,0039-LEC Eight Wk 2,Staff,36,18,18,0,0
16857,Wolfson Campus,SLS 1510 - 0040   Preparing For Student Success,0040-LEC Main Sess,Staff,33,22,11,0,0
16858,Wolfson Campus,SLS 1510 - 0041   Preparing For Student Success,0041-LEC Main Sess,Staff,33,32,1,0,0
16859,Wolfson Campus,SLS 1510 - 0042   Preparing For Student Success,0042-LEC Main Sess,Staff,33,19,14,0,0
16895,Wolfson Campus,SLS 1510 - 0043   Preparing For Student Success,0043-LEC Twelve Wk,Staff,35,26,9,0,0
16860,Wolfson Campus,SLS 1510 - 0044   Preparing For Student Success,0044-LEC Main Sess,Staff,30,11,19,0,0
16861,Wolfson Campus,SLS 1510 - 0045   Preparing For Student Success,0045-LEC Main Sess,Staff,33,21,12,0,0
16862,Wolfson Campus,SLS 1510 - 0046   Preparing For Student Success,0046-LEC Main Sess,Staff,33,21,12,0,0
16863,Wolfson Campus,SLS 1510 - 0047   Preparing For Student Success,0047-LEC Main Sess,Staff,30,0,30,0,0
16879,Wolfson Campus,SLS 1510 - 0048   Preparing For Student Success,0048-LEC Twelve Wk,Staff,30,0,30,0,0
16864,Wolfson Campus,SLS 1510 - 0049   Preparing For Student Success,0049-LEC Main Sess,Staff,30,28,2,0,0
16865,Wolfson Campus,SLS 1510 - 0050   Preparing For Student Success,0050-LEC Main Sess,Staff,30,25,5,0,0
16866,Wolfson Campus,SLS 1510 - 0051   Preparing For Student Success,0051-LEC Main Sess,Staff,30,26,4,0,0
16867,Homestead Campus,SLS 1510 - 0052   Preparing For Student Success,0052-LEC Main Sess,Staff,25,17,8,0,0
16868,Homestead Campus,SLS 1510 - 0053   Preparing For Student Success,0053-LEC Main Sess,Staff,25,24,1,0,0
16869,Homestead Campus,SLS 1510 - 0054   Preparing For Student Success,0054-LEC Main Sess,Staff,25,18,7,0,0
16870,Homestead Campus,SLS 1510 - 0055   Preparing For Student Success,0055-LEC Main Sess,Staff,30,0,30,0,0
16872,InterAmerican Campus,SLS 1510 - 0057   Preparing For Student Success,0057-LEC Main Sess,Staff,36,10,26,0,0
16880,InterAmerican Campus,SLS 1510 - 0058   Preparing For Student Success,0058-LEC Twelve Wk,Staff,24,14,10,0,0
16896,InterAmerican Campus,SLS 1510 - 0059   Preparing For Student Success,0059-LEC Twelve Wk,Staff,25,14,11,0,0
16873,InterAmerican Campus,SLS 1510 - 0060   Preparing For Student Success,0060-LEC Main Sess,Staff,30,0,30,0,0
16874,Hialeah Campus,SLS 1510 - 0061   Preparing For Student Success,0061-LEC Main Sess,Staff,35,0,35,0,0
16875,Hialeah Campus,SLS 1510 - 0062   Preparing For Student Success,0062-LEC Main Sess,Staff,32,11,21,0,0
16876,West Campus,SLS 1510 - 0063   Preparing For Student Success,0063-LEC Main Sess,Staff,35,25,10,0,0
16877,West Campus,SLS 1510 - 0064   Preparing For Student Success,0064-LEC Main Sess,Staff,30,12,18,0,0
16904,West Campus,SLS 1510 - 0065   Preparing For Student Success,0065-LEC Weekend,Staff,35,0,35,0,0
16878,West Campus,SLS 1510 - 0066   Preparing For Student Success,0066-LEC Twelve Wk,Staff,30,20,10,0,0
11139,North Campus,FFP 1505 - 0001   Fire Prevention,0001-LEC Conversion,Staff,24,23,1,0,0
12606,North Campus,SLS 1505 - 0001   College Survival Skills,0001-LEC Eight Wk 2,Staff,33,29,4,0,0
12602,North Campus,SLS 1505 - 0002   College Survival Skills,0002-LEC Eight Wk 1,Staff,33,18,15,0,0
12601,North Campus,SLS 1505 - 0003   College Survival Skills,0003-LEC Eight Wk 1,Staff,33,10,23,0,0
12600,North Campus,SLS 1505 - 0004   College Survival Skills,0004-LEC Eight Wk 1,Staff,33,0,33,0,0
12592,North Campus,SLS 1505 - 0005   College Survival Skills,0005-LEC Eight Wk 1,Staff,41,0,41,0,0
12599,North Campus,SLS 1505 - 0006   College Survival Skills,0006-LEC Eight Wk 1,Staff,33,24,9,0,0
12598,North Campus,SLS 1505 - 0007   College Survival Skills,0007-LEC Eight Wk 1,Staff,37,13,24,0,0
12605,Kendall Campus,SLS 1505 - 0008   College Survival Skills,0008-LEC Eight Wk 2,Staff,35,34,1,0,0
12612,Kendall Campus,SLS 1505 - 0009   College Survival Skills,0009-LEC 1st Mon Sp,Staff,30,29,1,0,0
12610,Kendall Campus,SLS 1505 - 0010   College Survival Skills,0010-LEC Conversion,Staff,30,27,3,0,0
12597,Kendall Campus,SLS 1505 - 0011   College Survival Skills,0011-LEC Eight Wk 1,Staff,35,25,10,0,0
12587,Kendall Campus,SLS 1505 - 0013   College Survival Skills,0013-LEC Main Sess,Staff,30,22,8,0,0
12596,Kendall Campus,SLS 1505 - 0014   College Survival Skills,0014-LEC Eight Wk 1,Staff,30,28,2,0,0
12611,Wolfson Campus,SLS 1505 - 0016   College Survival Skills,0016-LEC Conversion,Staff,30,22,8,0,0
12594,Wolfson Campus,SLS 1505 - 0017   College Survival Skills,0017-LEC Eight Wk 1,Staff,33,31,2,0,0
12609,Wolfson Campus,SLS 1505 - 0018   College Survival Skills,0018-LEC Conversion,Staff,33,30,3,0,0
12604,Wolfson Campus,SLS 1505 - 0019   College Survival Skills,0019-LEC Eight Wk 2,Staff,33,19,14,0,0
12588,Wolfson Campus,SLS 1505 - 0020   College Survival Skills,0020-LEC Main Sess,Staff,30,27,3,0,0
12589,Wolfson Campus,SLS 1505 - 0021   College Survival Skills,0021-LEC Main Sess,Staff,30,28,2,0,0
12590,Wolfson Campus,SLS 1505 - 0022   College Survival Skills,0022-LEC Main Sess,Staff,30,28,2,0,0
12603,Wolfson Campus,SLS 1505 - 0023   College Survival Skills,0023-LEC Eight Wk 2,Staff,30,27,3,0,0
12591,InterAmerican Campus,SLS 1505 - 0025   College Survival Skills,0025-LEC Twelve Wk,Staff,37,33,4,0,0
12608,West Campus,SLS 1505 - 0026   College Survival Skills,0026-LEC Conversion,Staff,35,19,16,0,0
5564,Wolfson Campus,EAP 1502 - 0001   Accent Reduction 2,0001-LEC Main Sess,Staff,25,13,12,0,0
16369,North Campus,MUO 1501 - 0001   Opera Workshop,0001-LAB Main Sess,Staff,12,10,2,0,0
16370,Kendall Campus,MUO 1501 - 0002   Opera Workshop,0002-LAB Main Sess,Staff,30,14,16,0,0
16373,Kendall Campus,MUO 1501 - 0003   Opera Workshop,0003-LAB Main Sess,Staff,30,0,30,0,0
16372,Wolfson Campus,MUO 1501 - 0004   Opera Workshop,0004-LAB Main Sess,Staff,15,10,5,0,0
16371,Wolfson Campus,MUO 1501 - 0005   Opera Workshop,0005-LAB Main Sess,Staff,15,9,6,0,0
8536,Kendall Campus,DAA 1500 - 0001   Jazz Dance Technical 1,0001-LEC Main Sess,Staff,25,8,17,0,0
9939,North Campus,EAP 1500 - 0001   Speech/Listening Level 5,0001-LEC Main Sess,Staff,28,22,6,0,0
9941,North Campus,EAP 1500 - 0002   Speech/Listening Level 5,0002-LEC Main Sess,Staff,28,10,18,0,0
9965,North Campus,EAP 1500 - 0003   Speech/Listening Level 5,0003-LEC Eight Wk 1,Staff,28,12,16,0,0
9940,North Campus,EAP 1500 - 0004   Speech/Listening Level 5,0004-LEC Main Sess,Staff,28,16,12,0,0
9945,North Campus,EAP 1500 - 0005   Speech/Listening Level 5,0005-LEC Main Sess,Staff,30,23,7,0,0
9946,North Campus,EAP 1500 - 0006   Speech/Listening Level 5,0006-LEC Main Sess,Staff,28,0,28,0,0
9947,North Campus,EAP 1500 - 0007   Speech/Listening Level 5,0007-LEC Main Sess,Staff,28,14,14,0,0
9948,Kendall Campus,EAP 1500 - 0008   Speech/Listening Level 5,0008-LEC Main Sess,Staff,28,27,1,0,0
9949,Kendall Campus,EAP 1500 - 0009   Speech/Listening Level 5,0009-LEC Main Sess,Staff,28,25,3,0,0
9967,Kendall Campus,EAP 1500 - 0010   Speech/Listening Level 5,0010-LEC Weekend,Staff,28,17,11,0,0
9950,Kendall Campus,EAP 1500 - 0011   Speech/Listening Level 5,0011-LEC Main Sess,Staff,28,15,13,0,0
9951,Kendall Campus,EAP 1500 - 0012   Speech/Listening Level 5,0012-LEC Main Sess,Staff,28,23,5,0,0
9953,Wolfson Campus,EAP 1500 - 0014   Speech/Listening Level 5,0014-LEC Main Sess,Staff,28,26,2,0,0
9955,Wolfson Campus,EAP 1500 - 0016   Speech/Listening Level 5,0016-LEC Main Sess,Staff,28,16,12,0,0
9963,Wolfson Campus,EAP 1500 - 0017   Speech/Listening Level 5,0017-LEC Twelve Wk,Staff,28,0,28,0,0
9956,Wolfson Campus,EAP 1500 - 0018   Speech/Listening Level 5,0018-LEC Main Sess,Staff,28,24,4,0,0
9964,Wolfson Campus,EAP 1500 - 0019   Speech/Listening Level 5,0019-LEC Twelve Wk,Staff,30,0,30,0,0
9957,Homestead Campus,EAP 1500 - 0020   Speech/Listening Level 5,0020-LEC Main Sess,Staff,20,9,11,0,0
9958,InterAmerican Campus,EAP 1500 - 0021   Speech/Listening Level 5,0021-LEC Main Sess,Staff,30,25,5,0,0
9960,InterAmerican Campus,EAP 1500 - 0023   Speech/Listening Level 5,0023-LEC Main Sess,Staff,29,24,5,0,0
9961,InterAmerican Campus,EAP 1500 - 0024   Speech/Listening Level 5,0024-LEC Main Sess,Staff,30,19,11,0,0
9962,InterAmerican Campus,EAP 1500 - 0025   Speech/Listening Level 5,0025-LEC Main Sess,Staff,29,15,14,0,0
9944,Hialeah Campus,EAP 1500 - 0026   Speech/Listening Level 5,0026-LEC Main Sess,Staff,30,13,17,0,0
9943,West Campus,EAP 1500 - 0027   Speech/Listening Level 5,0027-LEC Main Sess,Staff,35,34,1,0,0
9942,West Campus,EAP 1500 - 0028   Speech/Listening Level 5,0028-LEC Main Sess,Staff,35,16,19,0,0
7810,Medical Campus,MLT 1500 - 0001   Clinical Immunology/Serology,0001-LEC 1st Mon Sp,Staff,30,25,5,0,0
14317,North Campus,EAP 1500L - 0001   Speech/Listening Level 5 Laboratory,0001-LAB Main Sess,Staff,200,87,113,0,0
14320,North Campus,EAP 1500L - 0002   Speech/Listening Level 5 Laboratory,0002-LAB Main Sess,Staff,200,10,190,0,0
14334,North Campus,EAP 1500L - 0003   Speech/Listening Level 5 Laboratory,0003-LAB Eight Wk 1,Staff,200,13,187,0,0
14318,Kendall Campus,EAP 1500L - 0004   Speech/Listening Level 5 Laboratory,0004-LAB Main Sess,Staff,28,15,13,0,0
14323,Kendall Campus,EAP 1500L - 0005   Speech/Listening Level 5 Laboratory,0005-LAB Main Sess,Staff,28,27,1,0,0
14324,Kendall Campus,EAP 1500L - 0006   Speech/Listening Level 5 Laboratory,0006-LAB Main Sess,Staff,28,24,4,0,0
14325,Kendall Campus,EAP 1500L - 0007   Speech/Listening Level 5 Laboratory,0007-LAB Main Sess,Staff,28,24,4,0,0
14336,Kendall Campus,EAP 1500L - 0008   Speech/Listening Level 5 Laboratory,0008-LAB Weekend,Staff,28,18,10,0,0
14326,Wolfson Campus,EAP 1500L - 0009   Speech/Listening Level 5 Laboratory,0009-LAB Main Sess,Staff,210,131,79,0,0
14333,Wolfson Campus,EAP 1500L - 0010   Speech/Listening Level 5 Laboratory,0010-LAB Twelve Wk,Staff,30,0,30,0,0
14332,Wolfson Campus,EAP 1500L - 0011   Speech/Listening Level 5 Laboratory,0011-LAB Twelve Wk,Staff,30,0,30,0,0
14327,Homestead Campus,EAP 1500L - 0012   Speech/Listening Level 5 Laboratory,0012-LAB Main Sess,Staff,20,9,11,0,0
14319,InterAmerican Campus,EAP 1500L - 0014   Speech/Listening Level 5 Laboratory,0014-LAB Main Sess,Staff,30,24,6,0,0
14329,InterAmerican Campus,EAP 1500L - 0015   Speech/Listening Level 5 Laboratory,0015-LAB Main Sess,Staff,30,29,1,0,0
14330,InterAmerican Campus,EAP 1500L - 0016   Speech/Listening Level 5 Laboratory,0016-LAB Main Sess,Staff,25,22,3,0,0
14331,InterAmerican Campus,EAP 1500L - 0017   Speech/Listening Level 5 Laboratory,0017-LAB Main Sess,Staff,30,11,19,0,0
14322,Hialeah Campus,EAP 1500L - 0018   Speech/Listening Level 5 Laboratory,0018-LAB Main Sess,Staff,200,17,183,0,0
14335,West Campus,EAP 1500L - 0019   Speech/Listening Level 5 Laboratory,0019-LAB Eight Wk 1,Staff,80,21,59,0,0
14321,West Campus,EAP 1500L - 0020   Speech/Listening Level 5 Laboratory,0020-LAB Main Sess,Staff,100,51,49,0,0
7813,Medical Campus,MLT 1500L - 0002   Clinical Immunology/Serology Laboratory,0002-LAB Main Sess,Staff,16,0,16,0,0
7812,Medical Campus,MLT 1500L - 0003   Clinical Immunology/Serology Laboratory,0003-LAB Main Sess,Staff,16,9,7,0,0
8925,Wolfson Campus,HUS 1480 - 0001   Hiv/Aids And The Substance Abuser,0001-LEC Weekend,Staff,30,15,15,0,0
14856,Kendall Campus,MUN 1480 - 0001   Guitar Ensemble,0001-LEC Main Sess,Staff,15,0,15,0,0
14855,Kendall Campus,MUN 1480 - 0002   Guitar Ensemble,0002-LEC Main Sess,Staff,15,0,15,0,0
13883,Kendall Campus,MUN 1460 - 0001   Chamber Music· Strings And Mixed Ensemble,0001-OTH Main Sess,Staff,20,4,16,0,0
13888,Kendall Campus,MUN 1460 - 0002   Chamber Music· Strings And Mixed Ensemble,0002-OTH 1st Mon Sp,Staff,25,11,14,0,0
13884,Kendall Campus,MUN 1460 - 0003   Chamber Music· Strings And Mixed Ensemble,0003-OTH Main Sess,Staff,25,12,13,0,0
13889,Kendall Campus,MUN 1460 - 0004   Chamber Music· Strings And Mixed Ensemble,0004-OTH 1st Mon Sp,Staff,30,0,30,0,0
13887,Wolfson Campus,MUN 1460 - 0007   Chamber Music· Strings And Mixed Ensemble,0007-OTH Main Sess,Staff,25,15,10,0,0
15280,Wolfson Campus,HFT 1454 - 0001   Food And Beverage Cost Controls,0001-LEC Main Sess,Staff,30,0,30,0,0
15282,Wolfson Campus,HFT 1454 - 0002   Food And Beverage Cost Controls,0002-LEC Twelve Wk,Staff,30,29,1,0,0
15281,Wolfson Campus,HFT 1454 - 0003   Food And Beverage Cost Controls,0003-LEC Main Sess,Staff,30,20,10,0,0
13072,Medical Campus,OPT 1450 - 0001   Ophthalmic Dispensing Procedures 1,0001-LEC Conversion,Staff,35,29,6,0,0
16906,Medical Campus,OPT 1450L - 0001   Ophthalmic Dispensing Procedures 1 Laboratory,0001-LAB Conversion,Staff,12,9,3,0,0
16908,Medical Campus,OPT 1450L - 0002   Ophthalmic Dispensing Procedures 1 Laboratory,0002-LAB 1st Mon Sp,Staff,12,10,2,0,0
16907,Medical Campus,OPT 1450L - 0003   Ophthalmic Dispensing Procedures 1 Laboratory,0003-LAB 1st Mon Sp,Staff,13,10,3,0,0
5391,Homestead Campus,AVM 1440 - 0001   Aviation/Airport Security,0001-LEC Main Sess,Staff,30,14,16,0,0
5390,Homestead Campus,AVM 1440 - 0002   Aviation/Airport Security,0002-LEC Main Sess,Staff,30,0,30,0,0
12959,Kendall Campus,MUN 1440 - 0001   Percussion Ensemble,0001-LEC Conversion,Staff,15,13,2,0,0
9579,Wolfson Campus,DIG 1437 - 0001   Narrative Storytelling,0001-LEC Conversion,Staff,30,20,10,0,0
9577,Wolfson Campus,DIG 1437 - 0002   Narrative Storytelling,0002-LEC Main Sess,Staff,30,27,3,0,0
8272,North Campus,EMS 1431 - 0001   Emt Hospital/Field Experience,0001-CLN Main Sess,Staff,6,0,6,0,0
8292,North Campus,EMS 1431 - 0002   Emt Hospital/Field Experience,0002-CLN Main Sess,Staff,6,0,6,0,0
8274,North Campus,EMS 1431 - 0003   Emt Hospital/Field Experience,0003-CLN Main Sess,Staff,6,0,6,0,0
8280,Medical Campus,EMS 1431 - 0009   Emt Hospital/Field Experience,0009-CLN Main Sess,Staff,6,5,1,0,0
8287,Medical Campus,EMS 1431 - 0016   Emt Hospital/Field Experience,0016-CLN Main Sess,Staff,6,5,1,0,0
8289,Medical Campus,EMS 1431 - 0018   Emt Hospital/Field Experience,0018-CLN Main Sess,Staff,6,5,1,0,0
7465,Wolfson Campus,DIG 1430 - 0002   Storyboarding,0002-LEC Main Sess,Staff,30,0,30,0,0
7814,North Campus,MUE 1430 - 0001   Voice Techniques,0001-LEC Main Sess,Staff,20,12,8,0,0
10426,North Campus,MUN 1430 - 0001   Chamber Music· Brass Ensemble,0001-LEC Main Sess,Staff,15,6,9,0,0
10427,Kendall Campus,MUN 1430 - 0002   Chamber Music· Brass Ensemble,0002-LEC 1st Mon Sp,Staff,15,0,15,0,0
15291,Wolfson Campus,HUS 1428 - 0001   Addiction Treatment Delivery Systems,0001-LEC Twelve Wk,Staff,30,27,3,0,0
12247,North Campus,MUN 1420 - 0001   Chamber Music· Woodwind Ensemble,0001-LEC Twelve Wk,Staff,12,0,12,0,0
12245,Kendall Campus,MUN 1420 - 0002   Chamber Music· Woodwind Ensemble,0002-LEC Main Sess,Staff,25,0,25,0,0
12246,Kendall Campus,MUN 1420 - 0003   Chamber Music· Woodwind Ensemble,0003-LEC Main Sess,Staff,25,5,20,0,0
16950,Medical Campus,RTE 1418 - 0001   Radiographic Technology 1,0001-LEC Conversion,Staff,48,40,8,0,0
16470,North Campus,SLS 1401 - 0001   Psychology Of Career Adjustment,0001-LEC Eight Wk 2,Staff,30,0,30,0,0
16467,Wolfson Campus,SLS 1401 - 0003   Psychology Of Career Adjustment,0003-LEC Main Sess,Staff,30,25,5,0,0
16469,Wolfson Campus,SLS 1401 - 0004   Psychology Of Career Adjustment,0004-LEC Twelve Wk,Staff,30,11,19,0,0
16472,Wolfson Campus,SLS 1401 - 0005   Psychology Of Career Adjustment,0005-LEC Conversion,Staff,30,29,1,0,0
7460,Medical Campus,DEH 1400 - 0001   General And Oral Pathology,0001-LEC Conversion,Staff,48,43,5,0,0
13832,North Campus,MNA 1345 - 0001   Effective Supervision,0001-LEC Main Sess,Staff,40,22,18,0,0
13833,Kendall Campus,MNA 1345 - 0003   Effective Supervision,0003-LEC Main Sess,Staff,35,16,19,0,0
13835,Kendall Campus,MNA 1345 - 0004   Effective Supervision,0004-LEC Twelve Wk,Staff,35,14,21,0,0
13834,Wolfson Campus,MNA 1345 - 0005   Effective Supervision,0005-LEC Main Sess,Staff,30,19,11,0,0
12123,North Campus,ETD 1340 - 0001   Computer Aided Drawing & Design,0001-LEC Main Sess,Staff,24,14,10,0,0
12124,North Campus,ETD 1340 - 0002   Computer Aided Drawing & Design,0002-LEC Main Sess,Staff,24,0,24,0,0
12125,Kendall Campus,ETD 1340 - 0003   Computer Aided Drawing & Design,0003-LEC Main Sess,Staff,24,19,5,0,0
12126,Kendall Campus,ETD 1340 - 0004   Computer Aided Drawing & Design,0004-LEC Main Sess,Staff,24,18,6,0,0
12127,Wolfson Campus,ETD 1340 - 0005   Computer Aided Drawing & Design,0005-LEC Main Sess,Staff,24,10,14,0,0
12128,Homestead Campus,ETD 1340 - 0006   Computer Aided Drawing & Design,0006-LEC Main Sess,Staff,20,0,20,0,0
12129,Homestead Campus,ETD 1340 - 0007   Computer Aided Drawing & Design,0007-LEC Conversion,Staff,20,0,20,0,0
8633,North Campus,COP 1334 - 0001   Introduction To C++ Programming,0001-LEC Main Sess,Staff,30,27,3,0,0
8634,North Campus,COP 1334 - 0002   Introduction To C++ Programming,0002-LEC Main Sess,Staff,30,25,5,0,0
8636,North Campus,COP 1334 - 0003   Introduction To C++ Programming,0003-LEC Main Sess,Staff,30,20,10,0,0
8653,North Campus,COP 1334 - 0004   Introduction To C++ Programming,0004-LEC 1st Mon Sp,Staff,40,0,40,0,0
8638,Kendall Campus,COP 1334 - 0006   Introduction To C++ Programming,0006-LEC Main Sess,Staff,35,27,8,0,0
8639,Kendall Campus,COP 1334 - 0007   Introduction To C++ Programming,0007-LEC Main Sess,Staff,40,39,1,0,0
8640,Kendall Campus,COP 1334 - 0008   Introduction To C++ Programming,0008-LEC Main Sess,Staff,40,36,4,0,0
8641,Kendall Campus,COP 1334 - 0009   Introduction To C++ Programming,0009-LEC Main Sess,Staff,40,38,2,0,0
8643,Wolfson Campus,COP 1334 - 0011   Introduction To C++ Programming,0011-LEC Main Sess,Staff,33,32,1,0,0
8644,Wolfson Campus,COP 1334 - 0012   Introduction To C++ Programming,0012-LEC Main Sess,Staff,30,27,3,0,0
8648,Wolfson Campus,COP 1334 - 0016   Introduction To C++ Programming,0016-LEC Main Sess,Staff,30,26,4,0,0
8652,Homestead Campus,COP 1334 - 0017   Introduction To C++ Programming,0017-LEC Eight Wk 2,Staff,20,0,20,0,0
8649,InterAmerican Campus,COP 1334 - 0018   Introduction To C++ Programming,0018-LEC Main Sess,Staff,30,24,6,0,0
8650,Hialeah Campus,COP 1334 - 0019   Introduction To C++ Programming,0019-LEC Main Sess,Staff,30,22,8,0,0
8651,Hialeah Campus,COP 1334 - 0020   Introduction To C++ Programming,0020-LEC Main Sess,Staff,30,0,30,0,0
8635,West Campus,COP 1334 - 0021   Introduction To C++ Programming,0021-LEC Main Sess,Staff,35,17,18,0,0
6679,North Campus,COP 1332 - 0001   Introduction To Visual Basic Programming,0001-LEC Main Sess,Staff,24,21,3,0,0
6682,North Campus,COP 1332 - 0002   Introduction To Visual Basic Programming,0002-LEC Main Sess,Staff,24,0,24,0,0
6681,Kendall Campus,COP 1332 - 0003   Introduction To Visual Basic Programming,0003-LEC Main Sess,Staff,21,19,2,0,0
6680,Wolfson Campus,COP 1332 - 0004   Introduction To Visual Basic Programming,0004-LEC Main Sess,Staff,33,31,2,0,0
14907,Medical Campus,OPT 1331 - 0001   Clinical Data Collection 2,0001-LEC Main Sess,Staff,35,31,4,0,0
12369,Medical Campus,OPT 1331L - 0001   Clinical Data Collection 2 Laboratory,0001-LAB 1st Mon Sp,Staff,13,10,3,0,0
12371,Medical Campus,OPT 1331L - 0002   Clinical Data Collection 2 Laboratory,0002-LAB 1st Mon Sp,Staff,13,11,2,0,0
12370,Medical Campus,OPT 1331L - 0003   Clinical Data Collection 2 Laboratory,0003-LAB 1st Mon Sp,Staff,13,9,4,0,0
6037,Wolfson Campus,DAA 1330 - 0001   Afro-Caribbean Dance,0001-LEC Main Sess,Staff,10,0,10,0,0
10758,Kendall Campus,CTS 1328 - 0002   Supporting Microsoft Clients,0002-LEC Main Sess,Staff,22,21,1,0,0
10760,Homestead Campus,CTS 1328 - 0004   Supporting Microsoft Clients,0004-LEC Eight Wk 2,Staff,20,0,20,0,0
16359,Wolfson Campus,MTB 1322 - 0001   Technical Mathematics 2,0001-LEC Main Sess,Staff,30,0,30,0,0
13849,North Campus,CIS 1321 - 0001   Introduction To Systems Analysis And Design,0001-LEC Main Sess,Staff,30,0,30,0,0
14875,Kendall Campus,MVJ 1319 - 0001   Jazz Percussion Drum Set Principal Inst First Year,0001-LEC Main Sess,Staff,15,1,14,0,0
14640,Wolfson Campus,HUS 1318 - 0001   Domestic Abuse And Family Violence,0001-LEC Main Sess,Staff,47,13,34,0,0
10463,Wolfson Campus,MVJ 1318 - 0001   Jazz Trombone Principal Instrument First Year,0001-LEC Main Sess,Staff,1,0,1,0,0
16767,Wolfson Campus,MVJ 1317 - 0001   Jazz Trumpet Principal Instrument First Year,0001-LEC Main Sess,Staff,2,0,2,0,0
11509,North Campus,MVJ 1316 - 0001   Jazz Saxophone Principal Instrument First Year,0001-LEC Main Sess,Staff,1,0,1,0,0
11511,Kendall Campus,MVJ 1316 - 0002   Jazz Saxophone Principal Instrument First Year,0002-LEC Main Sess,Staff,40,3,37,0,0
11510,Wolfson Campus,MVJ 1316 - 0003   Jazz Saxophone Principal Instrument First Year,0003-LEC Main Sess,Staff,1,0,1,0,0
10476,Kendall Campus,MVS 1316 - 0002   Guitar Principal Instrument First Year,0002-LEC Main Sess,Staff,30,0,30,0,0
10475,Wolfson Campus,MVS 1316 - 0003   Guitar Principal Instrument First Year,0003-LEC Main Sess,Staff,5,0,5,0,0
10474,Wolfson Campus,MVS 1316 - 0004   Guitar Principal Instrument First Year,0004-LEC Main Sess,Staff,1,0,1,0,0
16389,Kendall Campus,MVB 1315 - 0001   Tuba Principal Instrument - First Year,0001-LEC Main Sess,Staff,50,0,50,0,0
16390,Wolfson Campus,MVB 1315 - 0002   Tuba Principal Instrument - First Year,0002-LEC Main Sess,Staff,1,0,1,0,0
16391,Wolfson Campus,MVB 1315 - 0003   Tuba Principal Instrument - First Year,0003-LEC Conversion,Staff,20,2,18,0,0
10479,Wolfson Campus,MVW 1315 - 0002   Saxophone Principal Instrument First Year,0002-LEC Conversion,Staff,50,5,45,0,0
10477,Wolfson Campus,MVW 1315 - 0003   Saxophone Principal Instrument First Year,0003-LEC Main Sess,Staff,5,2,3,0,0
12974,Wolfson Campus,MVB 1314 - 0001   Baritone Horn Principal Instrument - First Year,0001-LEC Main Sess,Staff,30,0,30,0,0
7996,Kendall Campus,MVJ 1314 - 0002   Electric Bass Principal Instrument First Year,0002-LEC Main Sess,Staff,50,4,46,0,0
12302,Wolfson Campus,MVS 1314 - 0001   Bass Principal Instrument First Year,0001-LEC Conversion,Staff,10,2,8,0,0
12300,Wolfson Campus,MVS 1314 - 0002   Bass Principal Instrument First Year,0002-LEC Main Sess,Staff,5,0,5,0,0
12301,Wolfson Campus,MVS 1314 - 0003   Bass Principal Instrument First Year,0003-LEC Main Sess,Staff,1,0,1,0,0
11529,Kendall Campus,MVW 1314 - 0001   Bassoon Principal Instrument First Year,0001-LEC Main Sess,Staff,30,0,30,0,0
11531,Wolfson Campus,MVW 1314 - 0002   Bassoon Principal Instrument First Year,0002-LEC Conversion,Staff,50,0,50,0,0
11530,Wolfson Campus,MVW 1314 - 0003   Bassoon Principal Instrument First Year,0003-LEC Main Sess,Staff,5,1,4,0,0
12267,North Campus,MVB 1313 - 0001   Trombone Principal Instrument - First Year,0001-LEC Main Sess,Staff,1,0,1,0,0
12268,North Campus,MVB 1313 - 0002   Trombone Principal Instrument - First Year,0002-LEC Main Sess,Staff,1,0,1,0,0
12269,Kendall Campus,MVB 1313 - 0003   Trombone Principal Instrument - First Year,0003-LEC Main Sess,Staff,15,3,12,0,0
12272,Wolfson Campus,MVB 1313 - 0004   Trombone Principal Instrument - First Year,0004-LEC Conversion,Staff,50,3,47,0,0
12270,Wolfson Campus,MVB 1313 - 0005   Trombone Principal Instrument - First Year,0005-LEC Main Sess,Staff,1,0,1,0,0
12271,Wolfson Campus,MVB 1313 - 0006   Trombone Principal Instrument - First Year,0006-LEC Main Sess,Staff,30,1,29,0,0
14871,Kendall Campus,MVJ 1313 - 0001   Jazz Guitar Principal Instrument First Year,0001-LEC Main Sess,Staff,50,1,49,0,0
14873,Wolfson Campus,MVJ 1313 - 0002   Jazz Guitar Principal Instrument First Year,0002-LEC Conversion,Staff,15,0,15,0,0
16422,Kendall Campus,MVS 1313 - 0001   Cello Principal Instrument First Year,0001-LEC Main Sess,Staff,30,0,30,0,0
16424,Wolfson Campus,MVS 1313 - 0003   Cello Principal Instrument First Year,0003-LEC Main Sess,Staff,5,1,4,0,0
16425,Wolfson Campus,MVS 1313 - 0004   Cello Principal Instrument First Year,0004-LEC Conversion,Staff,50,4,46,0,0
16426,Wolfson Campus,MVS 1313 - 0005   Cello Principal Instrument First Year,0005-LEC Conversion,Staff,5,0,5,0,0
12994,Kendall Campus,MVW 1313 - 0001   Clarinet Principal First Year,0001-LEC Main Sess,Staff,15,1,14,0,0
12996,Wolfson Campus,MVW 1313 - 0003   Clarinet Principal First Year,0003-LEC Main Sess,Staff,5,1,4,0,0
12997,Wolfson Campus,MVW 1313 - 0004   Clarinet Principal First Year,0004-LEC Conversion,Staff,50,4,46,0,0
13920,Kendall Campus,MVB 1312 - 0001   French Horn Principal Instrument - First Year,0001-LEC Main Sess,Staff,15,1,14,0,0
13921,Wolfson Campus,MVB 1312 - 0002   French Horn Principal Instrument - First Year,0002-LEC Conversion,Staff,50,4,46,0,0
12297,Kendall Campus,MVS 1312 - 0001   Viola Principal Instrument First Year,0001-LEC Main Sess,Staff,10,0,10,0,0
12298,Wolfson Campus,MVS 1312 - 0002   Viola Principal Instrument First Year,0002-LEC Main Sess,Staff,5,2,3,0,0
12299,Wolfson Campus,MVS 1312 - 0003   Viola Principal Instrument First Year,0003-LEC Conversion,Staff,50,3,47,0,0
16775,Kendall Campus,MVW 1312 - 0001   Oboe Principal Instrument First Year,0001-LEC Main Sess,Staff,30,0,30,0,0
16776,Kendall Campus,MVW 1312 - 0002   Oboe Principal Instrument First Year,0002-LEC Main Sess,Staff,30,0,30,0,0
16777,Wolfson Campus,MVW 1312 - 0003   Oboe Principal Instrument First Year,0003-LEC Conversion,Staff,5,2,3,0,0
11256,North Campus,EEC 1311 - 0001   Early Childhood Curriculum 2,0001-LEC 1st Mon Sp,Staff,30,12,18,0,0
11257,Kendall Campus,EEC 1311 - 0002   Early Childhood Curriculum 2,0002-LEC 1st Mon Sp,Staff,30,0,30,0,0
11252,Homestead Campus,EEC 1311 - 0003   Early Childhood Curriculum 2,0003-LEC Main Sess,Staff,30,16,14,0,0
11253,Homestead Campus,EEC 1311 - 0004   Early Childhood Curriculum 2,0004-LEC Main Sess,Staff,30,0,30,0,0
11254,Homestead Campus,EEC 1311 - 0005   Early Childhood Curriculum 2,0005-LEC Main Sess,Staff,25,15,10,0,0
11255,InterAmerican Campus,EEC 1311 - 0006   Early Childhood Curriculum 2,0006-LEC Twelve Wk,Staff,25,7,18,0,0
12970,Kendall Campus,MVB 1311 - 0002   Trumpet Principal Instrument - First Year,0002-LEC Main Sess,Staff,50,3,47,0,0
12972,Wolfson Campus,MVB 1311 - 0004   Trumpet Principal Instrument - First Year,0004-LEC Main Sess,Staff,5,1,4,0,0
12973,Wolfson Campus,MVB 1311 - 0005   Trumpet Principal Instrument - First Year,0005-LEC Conversion,Staff,50,2,48,0,0
12277,Kendall Campus,MVJ 1311 - 0001   Jazz Voice Principal Instrument First Year,0001-LEC Main Sess,Staff,20,0,20,0,0
12279,Kendall Campus,MVJ 1311 - 0002   Jazz Voice Principal Instrument First Year,0002-LEC Main Sess,Staff,10,2,8,0,0
12278,Kendall Campus,MVJ 1311 - 0003   Jazz Voice Principal Instrument First Year,0003-LEC Main Sess,Staff,50,11,39,0,0
8043,Kendall Campus,MVK 1311 - 0004   Piano Principal Instrument First Year,0004-LEC Main Sess,Staff,16,0,16,0,0
8044,Kendall Campus,MVK 1311 - 0005   Piano Principal Instrument First Year,0005-LEC Main Sess,Staff,30,2,28,0,0
8045,Kendall Campus,MVK 1311 - 0006   Piano Principal Instrument First Year,0006-LEC Main Sess,Staff,50,2,48,0,0
8046,Wolfson Campus,MVK 1311 - 0007   Piano Principal Instrument First Year,0007-LEC Main Sess,Staff,5,1,4,0,0
8050,Wolfson Campus,MVK 1311 - 0010   Piano Principal Instrument First Year,0010-LEC Main Sess,Staff,2,1,1,0,0
8048,Wolfson Campus,MVK 1311 - 0011   Piano Principal Instrument First Year,0011-LEC Main Sess,Staff,1,0,1,0,0
11515,Kendall Campus,MVP 1311 - 0001   Percussion Principal Instrument First Year,0001-LEC Main Sess,Staff,10,6,4,0,0
11516,Wolfson Campus,MVP 1311 - 0002   Percussion Principal Instrument First Year,0002-LEC Main Sess,Staff,5,2,3,0,0
11517,Wolfson Campus,MVP 1311 - 0003   Percussion Principal Instrument First Year,0003-LEC Conversion,Staff,15,4,11,0,0
13934,Wolfson Campus,MVS 1311 - 0001   Violin Principal Instrument First Year,0001-LEC Main Sess,Staff,5,2,3,0,0
13936,Wolfson Campus,MVS 1311 - 0002   Violin Principal Instrument First Year,0002-LEC Conversion,Staff,50,3,47,0,0
12985,Kendall Campus,MVV 1311 - 0003   Voice Principal Instrument First Year,0003-LEC Main Sess,Staff,16,4,12,0,0
12986,Kendall Campus,MVV 1311 - 0004   Voice Principal Instrument First Year,0004-LEC Main Sess,Staff,50,4,46,0,0
12987,Kendall Campus,MVV 1311 - 0005   Voice Principal Instrument First Year,0005-LEC Main Sess,Staff,16,2,14,0,0
12990,Wolfson Campus,MVV 1311 - 0007   Voice Principal Instrument First Year,0007-LEC Main Sess,Staff,50,4,46,0,0
12991,Wolfson Campus,MVV 1311 - 0008   Voice Principal Instrument First Year,0008-LEC Main Sess,Staff,15,0,15,0,0
12992,Wolfson Campus,MVV 1311 - 0010   Voice Principal Instrument First Year,0010-LEC Conversion,Staff,50,9,41,0,0
12993,Wolfson Campus,MVV 1311 - 0011   Voice Principal Instrument First Year,0011-LEC Conversion,Staff,50,14,36,0,0
11524,North Campus,MVW 1311 - 0001   Flute Principal Instrument First Year,0001-LEC Main Sess,Staff,1,0,1,0,0
11525,Kendall Campus,MVW 1311 - 0002   Flute Principal Instrument First Year,0002-LEC Main Sess,Staff,50,1,49,0,0
11528,Wolfson Campus,MVW 1311 - 0003   Flute Principal Instrument First Year,0003-LEC Conversion,Staff,50,2,48,0,0
11526,Wolfson Campus,MVW 1311 - 0004   Flute Principal Instrument First Year,0004-LEC Main Sess,Staff,5,0,5,0,0
11527,Wolfson Campus,MVW 1311 - 0005   Flute Principal Instrument First Year,0005-LEC Main Sess,Staff,1,0,1,0,0
13871,Kendall Campus,MUN 1310 - 0001   College Choir,0001-LEC Main Sess,Staff,50,13,37,0,0
13874,Kendall Campus,MUN 1310 - 0002   College Choir,0002-LEC Main Sess,Staff,30,15,15,0,0
13873,Kendall Campus,MUN 1310 - 0003   College Choir,0003-LEC Main Sess,Staff,28,0,28,0,0
13928,Kendall Campus,MVJ 1310 - 0001   Jazz Piano Principal Instrument First Year,0001-LEC Main Sess,Staff,30,0,30,0,0
13930,Wolfson Campus,MVJ 1310 - 0003   Jazz Piano Principal Instrument First Year,0003-LEC Conversion,Staff,5,1,4,0,0
8755,Kendall Campus,ARC 1302 - 0002   Architectural Design 2,0002-LEC Main Sess,Staff,15,14,1,0,0
8757,Kendall Campus,ARC 1302 - 0004   Architectural Design 2,0004-LEC Main Sess,Staff,15,14,1,0,0
8761,Wolfson Campus,ARC 1302 - 0008   Architectural Design 2,0008-LEC Conversion,Staff,2,0,2,0,0
8694,Wolfson Campus,DIG 1302 - 0001   3D Modeling,0001-LEC Main Sess,Staff,24,18,6,0,0
8693,Wolfson Campus,DIG 1302 - 0002   3D Modeling,0002-LEC Main Sess,Staff,30,26,4,0,0
11643,North Campus,HUS 1302 - 0001   Basic Counseling Skills,0001-LEC Main Sess,Staff,40,5,35,0,0
11642,North Campus,HUS 1302 - 0002   Basic Counseling Skills,0002-LEC Main Sess,Staff,40,5,35,0,0
8706,North Campus,ARC 1301 - 0001   Architectural Design 1,0001-LEC Main Sess,Staff,15,9,6,0,0
8707,North Campus,ARC 1301 - 0002   Architectural Design 1,0002-LEC Main Sess,Staff,15,14,1,0,0
8708,Kendall Campus,ARC 1301 - 0003   Architectural Design 1,0003-LEC Main Sess,Staff,15,14,1,0,0
8709,Kendall Campus,ARC 1301 - 0004   Architectural Design 1,0004-LEC Main Sess,Staff,15,14,1,0,0
8710,Kendall Campus,ARC 1301 - 0005   Architectural Design 1,0005-LEC Main Sess,Staff,15,12,3,0,0
8712,Wolfson Campus,ARC 1301 - 0007   Architectural Design 1,0007-LEC Main Sess,Staff,15,14,1,0,0
8713,Wolfson Campus,ARC 1301 - 0008   Architectural Design 1,0008-LEC Eight Wk 2,Staff,30,1,29,0,0
14630,Wolfson Campus,HFT 1300 - 0001   Executive Housekeeping,0001-LEC Main Sess,Staff,30,10,20,0,0
14631,Wolfson Campus,HFT 1300 - 0002   Executive Housekeeping,0002-LEC Twelve Wk,Staff,30,0,30,0,0
6388,Wolfson Campus,HIM 1300 - 0001   Health Care Facility And Delivery Systems,0001-LEC Main Sess,Staff,30,9,21,0,0
7078,Kendall Campus,IND 1300 - 0001   Interior Design Presentations 1,0001-LEC Main Sess,Staff,20,11,9,0,0
7079,Kendall Campus,IND 1300 - 0002   Interior Design Presentations 1,0002-LEC Main Sess,Staff,20,9,11,0,0
7081,Wolfson Campus,IND 1300 - 0003   Interior Design Presentations 1,0003-LEC Eight Wk 2,Staff,30,1,29,0,0
7080,Wolfson Campus,IND 1300 - 0004   Interior Design Presentations 1,0004-LEC Main Sess,Staff,15,7,8,0,0
16343,Medical Campus,MLT 1300 - 0001   Clinical Hematology,0001-LEC 1st Mon Sp,Staff,35,25,10,0,0
6722,Wolfson Campus,DAA 1291 - 0001   Ballet For The Theater 1,0001-LAB Main Sess,Staff,20,15,5,0,0
5989,Wolfson Campus,DAA 1290 - 0001   Ballet For The Theater 1,0001-LAB Conversion,Staff,30,11,19,0,0
7069,North Campus,BCN 1275 - 0001   Building Construction Plans Interpretation 2,0001-LEC Eight Wk 2,Staff,24,5,19,0,0
7237,North Campus,BCN 1272 - 0001   Building Construction Plans Interpretation 1,0001-LEC Eight Wk 1,Staff,24,11,13,0,0
8632,Kendall Campus,ORH 1251 - 0001   Nursery Practices 1,0001-LEC Main Sess,Staff,24,15,9,0,0
12584,North Campus,TPP 1250 - 0001   Musical Theatre 1,0001-LEC Main Sess,Staff,15,0,15,0,0
12583,Wolfson Campus,TPP 1250 - 0002   Musical Theatre 1,0002-LEC Main Sess,Staff,15,0,15,0,0
9039,Kendall Campus,MUT 1242 - 0001   Sightsinging & Ear Training 2 Year,0001-LAB Main Sess,Staff,30,0,30,0,0
9040,Kendall Campus,MUT 1242 - 0002   Sightsinging & Ear Training 2 Year,0002-LAB Main Sess,Staff,25,11,14,0,0
9043,Kendall Campus,MUT 1242 - 0003   Sightsinging & Ear Training 2 Year,0003-LAB Main Sess,Staff,16,15,1,0,0
9042,Wolfson Campus,MUT 1242 - 0004   Sightsinging & Ear Training 2 Year,0004-LAB Main Sess,Staff,15,12,3,0,0
9041,Wolfson Campus,MUT 1242 - 0005   Sightsinging & Ear Training 2 Year,0005-LAB Main Sess,Staff,20,11,9,0,0
16374,Wolfson Campus,MUS 1241 - 0001   Diction In Singing 2,0001-LEC Main Sess,Staff,20,7,13,0,0
7926,North Campus,MUT 1241 - 0001   Sightsinging & Ear Training 1 Year,0001-LAB Main Sess,Staff,18,12,6,0,0
7928,Kendall Campus,MUT 1241 - 0003   Sightsinging & Ear Training 1 Year,0003-LAB Main Sess,Staff,25,7,18,0,0
7929,Kendall Campus,MUT 1241 - 0004   Sightsinging & Ear Training 1 Year,0004-LAB Main Sess,Staff,15,0,15,0,0
7931,Kendall Campus,MUT 1241 - 0006   Sightsinging & Ear Training 1 Year,0006-LAB Main Sess,Staff,16,8,8,0,0
7933,Kendall Campus,MUT 1241 - 0008   Sightsinging & Ear Training 1 Year,0008-LAB Main Sess,Staff,30,14,16,0,0
13211,Wolfson Campus,REL 1240 - 0001   Religion Of The New Testament,0001-LEC Main Sess,Staff,30,13,17,0,0
11892,Kendall Campus,TPA 1232 - 0001   Theatre Costuming,0001-LEC Main Sess,Staff,15,0,15,0,0
11891,Kendall Campus,TPA 1232 - 0002   Theatre Costuming,0002-LEC Main Sess,Staff,15,14,1,0,0
12218,Kendall Campus,HFT 1220 - 0001   Supervisory Development,0001-LEC Main Sess,Staff,30,28,2,0,0
12219,Wolfson Campus,HFT 1220 - 0003   Supervisory Development,0003-LEC Main Sess,Staff,30,0,30,0,0
12576,Kendall Campus,TPA 1220 - 0001   Lighting,0001-LEC Main Sess,Staff,20,10,10,0,0
12293,North Campus,MVS 1216 - 0001   Guitar Secondary Instrument First Year,0001-LEC Main Sess,Staff,1,0,1,0,0
12296,Kendall Campus,MVS 1216 - 0002   Guitar Secondary Instrument First Year,0002-LEC Main Sess,Staff,30,0,30,0,0
12295,Wolfson Campus,MVS 1216 - 0003   Guitar Secondary Instrument First Year,0003-LEC Main Sess,Staff,5,0,5,0,0
12294,Wolfson Campus,MVS 1216 - 0004   Guitar Secondary Instrument First Year,0004-LEC Main Sess,Staff,1,0,1,0,0
8089,North Campus,MVW 1215 - 0001   Saxophone Secondary Instrument First Year,0001-LEC Main Sess,Staff,1,0,1,0,0
7989,Wolfson Campus,MVJ 1214 - 0001   Electric Bass Secondary Instrument First Year,0001-LEC Main Sess,Staff,1,0,1,0,0
12292,Wolfson Campus,MVS 1214 - 0001   Bass Secondary Instrument First Year,0001-LEC Main Sess,Staff,1,0,1,0,0
12290,Wolfson Campus,MVK 1213 - 0001   Organ Secondary Instrument First Year,0001-LEC Main Sess,Staff,5,0,5,0,0
10417,Wolfson Campus,HFT 1212 - 0001   Safety And Sanitation,0001-LEC Main Sess,Staff,30,21,9,0,0
10420,Wolfson Campus,HFT 1212 - 0002   Safety And Sanitation,0002-LEC Main Sess,Staff,30,0,30,0,0
10419,Wolfson Campus,HFT 1212 - 0003   Safety And Sanitation,0003-LEC Main Sess,Staff,30,21,9,0,0
10418,Wolfson Campus,HFT 1212 - 0004   Safety And Sanitation,0004-LEC Main Sess,Staff,30,28,2,0,0
9048,Wolfson Campus,MVK 1211 - 0001   Piano Secondary Instrument First Year,0001-LEC Main Sess,Staff,1,0,1,0,0
9051,Wolfson Campus,MVK 1211 - 0002   Piano Secondary Instrument First Year,0002-LEC Main Sess,Staff,15,2,13,0,0
9049,Wolfson Campus,MVK 1211 - 0004   Piano Secondary Instrument First Year,0004-LEC Main Sess,Staff,1,0,1,0,0
9054,Wolfson Campus,MVP 1211 - 0002   Percussion Secondary Instrument First Year,0002-LEC Main Sess,Staff,10,0,10,0,0
16774,Wolfson Campus,MVS 1211 - 0001   Violin Secondary Instrument First Year,0001-LEC Main Sess,Staff,1,0,1,0,0
8071,North Campus,MVV 1211 - 0001   Voice Secondary Instrument First Year,0001-LEC Main Sess,Staff,1,0,1,0,0
8074,Wolfson Campus,MVV 1211 - 0002   Voice Secondary Instrument First Year,0002-LEC Main Sess,Staff,1,0,1,0,0
8072,Wolfson Campus,MVV 1211 - 0004   Voice Secondary Instrument First Year,0004-LEC Main Sess,Staff,25,15,10,0,0
12308,Wolfson Campus,MVW 1211 - 0001   Flute Secondary Instrument First Year,0001-LEC Main Sess,Staff,1,0,1,0,0
12309,Medical Campus,NUR 1211 - 0001   Medical-Surgical Nursing,0001-LEC Conversion,Staff,56,41,15,0,0
12310,Medical Campus,NUR 1211 - 0002   Medical-Surgical Nursing,0002-LEC Conversion,Staff,50,45,5,0,0
12311,Medical Campus,NUR 1211 - 0003   Medical-Surgical Nursing,0003-LEC Conversion,Staff,56,50,6,0,0
12312,Homestead Campus,NUR 1211 - 0004   Medical-Surgical Nursing,0004-LEC Conversion,Staff,50,42,8,0,0
13990,Medical Campus,PHT 1211 - 0001   Disabilities And Therapeutic Procedures 1,0001-LEC Main Sess,Staff,55,51,4,0,0
8389,Medical Campus,NUR 1211L - 0001   Medical Surgical Nursing Clinical Lab,0001-CLN Conversion,Staff,8,7,1,0,0
8398,Medical Campus,NUR 1211L - 0002   Medical Surgical Nursing Clinical Lab,0002-CLN Conversion,Staff,8,7,1,0,0
8399,Medical Campus,NUR 1211L - 0003   Medical Surgical Nursing Clinical Lab,0003-CLN Conversion,Staff,8,7,1,0,0
8390,Medical Campus,NUR 1211L - 0004   Medical Surgical Nursing Clinical Lab,0004-CLN Conversion,Staff,8,0,8,0,0
8391,Medical Campus,NUR 1211L - 0005   Medical Surgical Nursing Clinical Lab,0005-CLN Conversion,Staff,8,0,8,0,0
8392,Medical Campus,NUR 1211L - 0007   Medical Surgical Nursing Clinical Lab,0007-CLN Conversion,Staff,8,7,1,0,0
8401,Medical Campus,NUR 1211L - 0008   Medical Surgical Nursing Clinical Lab,0008-CLN Conversion,Staff,8,6,2,0,0
8393,Medical Campus,NUR 1211L - 0012   Medical Surgical Nursing Clinical Lab,0012-CLN Conversion,Staff,8,7,1,0,0
8384,Medical Campus,NUR 1211L - 0014   Medical Surgical Nursing Clinical Lab,0014-CLN Conversion,Staff,8,0,8,0,0
8404,Medical Campus,NUR 1211L - 0015   Medical Surgical Nursing Clinical Lab,0015-CLN Conversion,Staff,10,0,10,0,0
8385,Medical Campus,NUR 1211L - 0016   Medical Surgical Nursing Clinical Lab,0016-CLN Conversion,Staff,8,5,3,0,0
8387,Medical Campus,NUR 1211L - 0018   Medical Surgical Nursing Clinical Lab,0018-CLN Conversion,Staff,8,6,2,0,0
8395,Medical Campus,NUR 1211L - 0021   Medical Surgical Nursing Clinical Lab,0021-CLN Conversion,Staff,8,7,1,0,0
8396,Medical Campus,NUR 1211L - 0022   Medical Surgical Nursing Clinical Lab,0022-CLN Conversion,Staff,8,0,8,0,0
8397,Medical Campus,NUR 1211L - 0023   Medical Surgical Nursing Clinical Lab,0023-CLN Conversion,Staff,8,0,8,0,0
8408,Homestead Campus,NUR 1211L - 0027   Medical Surgical Nursing Clinical Lab,0027-CLN Conversion,Staff,8,7,1,0,0
8409,Homestead Campus,NUR 1211L - 0028   Medical Surgical Nursing Clinical Lab,0028-CLN Conversion,Staff,8,7,1,0,0
8383,Homestead Campus,NUR 1211L - 0029   Medical Surgical Nursing Clinical Lab,0029-CLN Conversion,Staff,8,0,8,0,0
12380,Medical Campus,PHT 1211L - 0001   Disabilities And Therapeutic Procedures 1 Lab,0001-LAB Main Sess,Staff,16,13,3,0,0
12383,Medical Campus,PHT 1211L - 0002   Disabilities And Therapeutic Procedures 1 Lab,0002-LAB Main Sess,Staff,16,13,3,0,0
12382,Medical Campus,PHT 1211L - 0003   Disabilities And Therapeutic Procedures 1 Lab,0003-LAB Main Sess,Staff,16,13,3,0,0
12381,Medical Campus,PHT 1211L - 0004   Disabilities And Therapeutic Procedures 1 Lab,0004-LAB Main Sess,Staff,16,12,4,0,0
5381,Homestead Campus,ASC 1210 - 0001   Aviation Meteorology,0001-LEC Main Sess,Staff,30,0,30,0,0
5383,Homestead Campus,ASC 1210 - 0002   Aviation Meteorology,0002-LEC Main Sess,Staff,30,18,12,0,0
5382,Homestead Campus,ASC 1210 - 0003   Aviation Meteorology,0003-LEC Main Sess,Staff,34,11,23,0,0
10412,North Campus,HFT 1210 - 0001   Human Relations And Supervisory Development,0001-LEC 1st Mon Sp,Staff,30,13,17,0,0
10407,North Campus,HFT 1210 - 0002   Human Relations And Supervisory Development,0002-LEC Main Sess,Staff,30,0,30,0,0
10408,Wolfson Campus,HFT 1210 - 0003   Human Relations And Supervisory Development,0003-LEC Main Sess,Staff,30,0,30,0,0
10411,Wolfson Campus,HFT 1210 - 0004   Human Relations And Supervisory Development,0004-LEC Twelve Wk,Staff,30,14,16,0,0
10409,Wolfson Campus,HFT 1210 - 0005   Human Relations And Supervisory Development,0005-LEC Main Sess,Staff,30,29,1,0,0
10410,Wolfson Campus,HFT 1210 - 0006   Human Relations And Supervisory Development,0006-LEC Main Sess,Staff,30,29,1,0,0
10423,Wolfson Campus,MUN 1210 - 0001   Symphony Orchestra,0001-LAB Conversion,Staff,50,7,43,0,0
10422,Wolfson Campus,MUN 1210 - 0002   Symphony Orchestra,0002-LAB Main Sess,Staff,35,13,22,0,0
13925,Wolfson Campus,MVJ 1210 - 0002   Jazz Piano Secondary Instrument First Year,0002-LEC Main Sess,Staff,5,2,3,0,0
13210,Wolfson Campus,REL 1210 - 0001   Religion Of The Old Testament,0001-LEC Main Sess,Staff,30,20,10,0,0
7780,Wolfson Campus,DAA 1205 - 0001   Intermediate Ballet,0001-LEC Main Sess,Staff,35,23,12,0,0
7770,North Campus,DAA 1204 - 0001   Ballet 1,0001-LEC Main Sess,Staff,5,4,1,0,0
7771,Kendall Campus,DAA 1204 - 0002   Ballet 1,0002-LEC Main Sess,Staff,30,0,30,0,0
7773,Wolfson Campus,DAA 1204 - 0003   Ballet 1,0003-LEC Conversion,Staff,30,27,3,0,0
7772,Wolfson Campus,DAA 1204 - 0004   Ballet 1,0004-LEC Main Sess,Staff,10,3,7,0,0
11160,Wolfson Campus,FSS 1204L - 0001   Food Production 2,0001-LAB Twelve Wk,Staff,16,6,10,0,0
11163,Wolfson Campus,FSS 1204L - 0002   Food Production 2,0002-LAB Twelve Wk,Staff,16,15,1,0,0
11162,Wolfson Campus,FSS 1204L - 0003   Food Production 2,0003-LAB Twelve Wk,Staff,16,11,5,0,0
6409,North Campus,INT 1202 - 0001   Sign To Voice Interpreting,0001-LEC Main Sess,Staff,20,12,8,0,0
16361,Wolfson Campus,MUC 1202 - 0001   Composition 2,0001-LEC Main Sess,Staff,10,1,9,0,0
16360,Wolfson Campus,MUC 1202 - 0002   Composition 2,0002-LEC Main Sess,Staff,10,0,10,0,0
11154,Wolfson Campus,FSS 1202L - 0001   Food Production 1,0001-LAB Twelve Wk,Staff,16,0,16,0,0
11156,Wolfson Campus,FSS 1202L - 0003   Food Production 1,0003-LAB Twelve Wk,Staff,16,0,16,0,0
11159,Wolfson Campus,FSS 1202L - 0004   Food Production 1,0004-LAB Conversion,Staff,16,8,8,0,0
11157,Wolfson Campus,FSS 1202L - 0005   Food Production 1,0005-LAB Twelve Wk,Staff,16,14,2,0,0
11158,Wolfson Campus,FSS 1202L - 0006   Food Production 1,0006-LAB Twelve Wk,Staff,16,12,4,0,0
7459,Kendall Campus,DAA 1201 - 0001   Intermediate Ballet Dance,0001-LEC Main Sess,Staff,25,6,19,0,0
11613,North Campus,HUN 1201 - 0002   Essentials Of Human Nutrition,0002-LEC Twelve Wk,Staff,40,32,8,0,0
11534,North Campus,HUN 1201 - 0003   Essentials Of Human Nutrition,0003-LEC Main Sess,Staff,40,33,7,0,0
11535,North Campus,HUN 1201 - 0004   Essentials Of Human Nutrition,0004-LEC Main Sess,Staff,40,37,3,0,0
11624,North Campus,HUN 1201 - 0006   Essentials Of Human Nutrition,0006-LEC Twelve Wk,Staff,40,39,1,0,0
11538,North Campus,HUN 1201 - 0008   Essentials Of Human Nutrition,0008-LEC Main Sess,Staff,20,0,20,0,0
11609,North Campus,HUN 1201 - 0009   Essentials Of Human Nutrition,0009-LEC Main Sess,Staff,40,37,3,0,0
11628,North Campus,HUN 1201 - 0010   Essentials Of Human Nutrition,0010-LEC Conversion,Staff,40,25,15,0,0
11539,North Campus,HUN 1201 - 0011   Essentials Of Human Nutrition,0011-LEC Main Sess,Staff,40,39,1,0,0
11540,North Campus,HUN 1201 - 0012   Essentials Of Human Nutrition,0012-LEC Main Sess,Staff,40,37,3,0,0
11541,North Campus,HUN 1201 - 0013   Essentials Of Human Nutrition,0013-LEC Main Sess,Staff,40,36,4,0,0
11542,North Campus,HUN 1201 - 0014   Essentials Of Human Nutrition,0014-LEC Main Sess,Staff,40,36,4,0,0
11543,North Campus,HUN 1201 - 0015   Essentials Of Human Nutrition,0015-LEC Main Sess,Staff,40,33,7,0,0
11544,North Campus,HUN 1201 - 0016   Essentials Of Human Nutrition,0016-LEC Main Sess,Staff,40,38,2,0,0
11547,North Campus,HUN 1201 - 0019   Essentials Of Human Nutrition,0019-LEC Main Sess,Staff,35,0,35,0,0
11622,North Campus,HUN 1201 - 0020   Essentials Of Human Nutrition,0020-LEC Twelve Wk,Staff,40,16,24,0,0
11621,North Campus,HUN 1201 - 0021   Essentials Of Human Nutrition,0021-LEC Twelve Wk,Staff,35,12,23,0,0
11548,Kendall Campus,HUN 1201 - 0022   Essentials Of Human Nutrition,0022-LEC Main Sess,Staff,49,34,15,0,0
11549,Kendall Campus,HUN 1201 - 0023   Essentials Of Human Nutrition,0023-LEC Main Sess,Staff,38,14,24,0,0
11550,Kendall Campus,HUN 1201 - 0024   Essentials Of Human Nutrition,0024-LEC Main Sess,Staff,49,48,1,0,0
11551,Kendall Campus,HUN 1201 - 0025   Essentials Of Human Nutrition,0025-LEC Main Sess,Staff,49,21,28,0,0
11552,Kendall Campus,HUN 1201 - 0026   Essentials Of Human Nutrition,0026-LEC Main Sess,Staff,49,16,33,0,0
11554,Kendall Campus,HUN 1201 - 0028   Essentials Of Human Nutrition,0028-LEC Main Sess,Staff,49,46,3,0,0
11555,Kendall Campus,HUN 1201 - 0029   Essentials Of Human Nutrition,0029-LEC Main Sess,Staff,39,35,4,0,0
11634,Kendall Campus,HUN 1201 - 0030   Essentials Of Human Nutrition,0030-LEC Weekend,Staff,49,20,29,0,0
11556,Kendall Campus,HUN 1201 - 0031   Essentials Of Human Nutrition,0031-LEC Main Sess,Staff,30,0,30,0,0
11620,Kendall Campus,HUN 1201 - 0033   Essentials Of Human Nutrition,0033-LEC Twelve Wk,Staff,49,34,15,0,0
11558,Kendall Campus,HUN 1201 - 0034   Essentials Of Human Nutrition,0034-LEC Main Sess,Staff,49,28,21,0,0
11559,Kendall Campus,HUN 1201 - 0035   Essentials Of Human Nutrition,0035-LEC Main Sess,Staff,38,30,8,0,0
11560,Kendall Campus,HUN 1201 - 0036   Essentials Of Human Nutrition,0036-LEC Main Sess,Staff,30,0,30,0,0
11632,Kendall Campus,HUN 1201 - 0037   Essentials Of Human Nutrition,0037-LEC Weekend,Staff,30,19,11,0,0
11561,Kendall Campus,HUN 1201 - 0038   Essentials Of Human Nutrition,0038-LEC Main Sess,Staff,40,0,40,0,0
11619,Kendall Campus,HUN 1201 - 0039   Essentials Of Human Nutrition,0039-LEC Twelve Wk,Staff,36,34,2,0,0
11610,Kendall Campus,HUN 1201 - 0040   Essentials Of Human Nutrition,0040-LEC Main Sess,Staff,25,24,1,0,0
11618,Wolfson Campus,HUN 1201 - 0041   Essentials Of Human Nutrition,0041-LEC Twelve Wk,Staff,45,32,13,0,0
11562,Wolfson Campus,HUN 1201 - 0042   Essentials Of Human Nutrition,0042-LEC Main Sess,Staff,45,0,45,0,0
11563,Wolfson Campus,HUN 1201 - 0043   Essentials Of Human Nutrition,0043-LEC Main Sess,Staff,45,41,4,0,0
11564,Wolfson Campus,HUN 1201 - 0044   Essentials Of Human Nutrition,0044-LEC Main Sess,Staff,45,12,33,0,0
11617,Wolfson Campus,HUN 1201 - 0045   Essentials Of Human Nutrition,0045-LEC Twelve Wk,Staff,45,42,3,0,0
11633,Wolfson Campus,HUN 1201 - 0046   Essentials Of Human Nutrition,0046-LEC Weekend,Staff,45,0,45,0,0
11565,Wolfson Campus,HUN 1201 - 0047   Essentials Of Human Nutrition,0047-LEC Main Sess,Staff,45,44,1,0,0
11566,Wolfson Campus,HUN 1201 - 0048   Essentials Of Human Nutrition,0048-LEC Main Sess,Staff,45,25,20,0,0
11567,Wolfson Campus,HUN 1201 - 0049   Essentials Of Human Nutrition,0049-LEC Main Sess,Staff,45,44,1,0,0
11616,Wolfson Campus,HUN 1201 - 0050   Essentials Of Human Nutrition,0050-LEC Twelve Wk,Staff,45,40,5,0,0
11568,Wolfson Campus,HUN 1201 - 0051   Essentials Of Human Nutrition,0051-LEC Main Sess,Staff,45,0,45,0,0
11569,Wolfson Campus,HUN 1201 - 0052   Essentials Of Human Nutrition,0052-LEC Main Sess,Staff,45,35,10,0,0
11570,Wolfson Campus,HUN 1201 - 0053   Essentials Of Human Nutrition,0053-LEC Main Sess,Staff,45,39,6,0,0
11571,Wolfson Campus,HUN 1201 - 0054   Essentials Of Human Nutrition,0054-LEC Main Sess,Staff,46,43,3,0,0
11572,Wolfson Campus,HUN 1201 - 0055   Essentials Of Human Nutrition,0055-LEC Main Sess,Staff,45,24,21,0,0
11573,Wolfson Campus,HUN 1201 - 0056   Essentials Of Human Nutrition,0056-LEC Main Sess,Staff,45,28,17,0,0
11574,Wolfson Campus,HUN 1201 - 0057   Essentials Of Human Nutrition,0057-LEC Main Sess,Staff,45,23,22,0,0
11575,Wolfson Campus,HUN 1201 - 0058   Essentials Of Human Nutrition,0058-LEC Main Sess,Staff,45,29,16,0,0
11576,Wolfson Campus,HUN 1201 - 0059   Essentials Of Human Nutrition,0059-LEC Main Sess,Staff,45,43,2,0,0
11577,Wolfson Campus,HUN 1201 - 0060   Essentials Of Human Nutrition,0060-LEC Main Sess,Staff,45,18,27,0,0
11578,Wolfson Campus,HUN 1201 - 0061   Essentials Of Human Nutrition,0061-LEC Main Sess,Staff,34,29,5,0,0
11579,Wolfson Campus,HUN 1201 - 0062   Essentials Of Human Nutrition,0062-LEC Main Sess,Staff,34,31,3,0,0
11580,Wolfson Campus,HUN 1201 - 0063   Essentials Of Human Nutrition,0063-LEC Main Sess,Staff,34,27,7,0,0
11581,Wolfson Campus,HUN 1201 - 0066   Essentials Of Human Nutrition,0066-LEC Main Sess,Staff,30,28,2,0,0
11582,Wolfson Campus,HUN 1201 - 0067   Essentials Of Human Nutrition,0067-LEC Main Sess,Staff,34,30,4,0,0
11626,Wolfson Campus,HUN 1201 - 0068   Essentials Of Human Nutrition,0068-LEC Conversion,Staff,34,31,3,0,0
11631,Wolfson Campus,HUN 1201 - 0069   Essentials Of Human Nutrition,0069-LEC Conversion,Staff,34,30,4,0,0
11583,Wolfson Campus,HUN 1201 - 0070   Essentials Of Human Nutrition,0070-LEC Main Sess,Staff,30,26,4,0,0
11584,Wolfson Campus,HUN 1201 - 0071   Essentials Of Human Nutrition,0071-LEC Main Sess,Staff,30,27,3,0,0
11630,Wolfson Campus,HUN 1201 - 0072   Essentials Of Human Nutrition,0072-LEC Conversion,Staff,34,29,5,0,0
11585,Wolfson Campus,HUN 1201 - 0073   Essentials Of Human Nutrition,0073-LEC Main Sess,Staff,30,28,2,0,0
11586,Wolfson Campus,HUN 1201 - 0074   Essentials Of Human Nutrition,0074-LEC Main Sess,Staff,30,25,5,0,0
11587,Wolfson Campus,HUN 1201 - 0075   Essentials Of Human Nutrition,0075-LEC Main Sess,Staff,30,24,6,0,0
11588,Wolfson Campus,HUN 1201 - 0076   Essentials Of Human Nutrition,0076-LEC Main Sess,Staff,30,29,1,0,0
11589,Wolfson Campus,HUN 1201 - 0077   Essentials Of Human Nutrition,0077-LEC Main Sess,Staff,34,25,9,0,0
11590,InterAmerican Campus,HUN 1201 - 0078   Essentials Of Human Nutrition,0078-LEC Main Sess,Staff,35,32,3,0,0
11615,InterAmerican Campus,HUN 1201 - 0079   Essentials Of Human Nutrition,0079-LEC Twelve Wk,Staff,40,25,15,0,0
11591,InterAmerican Campus,HUN 1201 - 0080   Essentials Of Human Nutrition,0080-LEC Main Sess,Staff,30,0,30,0,0
11592,InterAmerican Campus,HUN 1201 - 0081   Essentials Of Human Nutrition,0081-LEC Main Sess,Staff,37,0,37,0,0
11593,InterAmerican Campus,HUN 1201 - 0082   Essentials Of Human Nutrition,0082-LEC Main Sess,Staff,30,29,1,0,0
11594,InterAmerican Campus,HUN 1201 - 0083   Essentials Of Human Nutrition,0083-LEC Main Sess,Staff,30,19,11,0,0
11595,Hialeah Campus,HUN 1201 - 0084   Essentials Of Human Nutrition,0084-LEC Main Sess,Staff,30,26,4,0,0
11596,Hialeah Campus,HUN 1201 - 0085   Essentials Of Human Nutrition,0085-LEC Main Sess,Staff,33,22,11,0,0
11614,Hialeah Campus,HUN 1201 - 0086   Essentials Of Human Nutrition,0086-LEC Twelve Wk,Staff,35,20,15,0,0
11597,Hialeah Campus,HUN 1201 - 0087   Essentials Of Human Nutrition,0087-LEC Main Sess,Staff,38,36,2,0,0
11598,Hialeah Campus,HUN 1201 - 0088   Essentials Of Human Nutrition,0088-LEC Main Sess,Staff,30,27,3,0,0
11599,Hialeah Campus,HUN 1201 - 0089   Essentials Of Human Nutrition,0089-LEC Main Sess,Staff,31,22,9,0,0
11611,Hialeah Campus,HUN 1201 - 0090   Essentials Of Human Nutrition,0090-LEC Main Sess,Staff,33,0,33,0,0
11600,West Campus,HUN 1201 - 0091   Essentials Of Human Nutrition,0091-LEC Main Sess,Staff,35,10,25,0,0
11627,West Campus,HUN 1201 - 0092   Essentials Of Human Nutrition,0092-LEC Conversion,Staff,35,20,15,0,0
11612,West Campus,HUN 1201 - 0093   Essentials Of Human Nutrition,0093-LEC Main Sess,Staff,35,16,19,0,0
11601,West Campus,HUN 1201 - 0094   Essentials Of Human Nutrition,0094-LEC Main Sess,Staff,35,0,35,0,0
11602,West Campus,HUN 1201 - 0095   Essentials Of Human Nutrition,0095-LEC Main Sess,Staff,35,22,13,0,0
11623,West Campus,HUN 1201 - 0096   Essentials Of Human Nutrition,0096-LEC Twelve Wk,Staff,30,0,30,0,0
11603,West Campus,HUN 1201 - 0097   Essentials Of Human Nutrition,0097-LEC Main Sess,Staff,35,0,35,0,0
11604,West Campus,HUN 1201 - 0098   Essentials Of Human Nutrition,0098-LEC Main Sess,Staff,30,0,30,0,0
11605,West Campus,HUN 1201 - 0099   Essentials Of Human Nutrition,0099-LEC Main Sess,Staff,35,11,24,0,0
11606,West Campus,HUN 1201 - 0100   Essentials Of Human Nutrition,0100-LEC Main Sess,Staff,35,29,6,0,0
11607,West Campus,HUN 1201 - 0101   Essentials Of Human Nutrition,0101-LEC Main Sess,Staff,35,26,9,0,0
11608,West Campus,HUN 1201 - 0102   Essentials Of Human Nutrition,0102-LEC Main Sess,Staff,35,22,13,0,0
12239,Wolfson Campus,MUC 1201 - 0001   Composition 1,0001-LEC Main Sess,Staff,5,3,2,0,0
16457,Medical Campus,PHT 1201L - 0001   Introduction To Physical Therapy Laboratory,0001-LAB 1st Mon Sp,Staff,16,13,3,0,0
16454,Medical Campus,PHT 1201L - 0002   Introduction To Physical Therapy Laboratory,0002-LAB Conversion,Staff,16,12,4,0,0
16455,Medical Campus,PHT 1201L - 0003   Introduction To Physical Therapy Laboratory,0003-LAB Conversion,Staff,16,13,3,0,0
16456,Medical Campus,PHT 1201L - 0004   Introduction To Physical Therapy Laboratory,0004-LAB Conversion,Staff,16,13,3,0,0
13904,North Campus,DAA 1200 - 0001   Ballet Dance 1,0001-LEC Main Sess,Staff,12,5,7,0,0
13903,Kendall Campus,DAA 1200 - 0002   Ballet Dance 1,0002-LEC Main Sess,Staff,25,6,19,0,0
14191,Medical Campus,DES 1200 - 0001   Dental Radiology,0001-LEC Conversion,Staff,1,0,1,0,0
14487,Kendall Campus,EEC 1200 - 0001   Early Childhood Curriculum 1,0001-LEC Main Sess,Staff,30,9,21,0,0
14490,Kendall Campus,EEC 1200 - 0002   Early Childhood Curriculum 1,0002-LEC Twelve Wk,Staff,30,9,21,0,0
14488,Homestead Campus,EEC 1200 - 0003   Early Childhood Curriculum 1,0003-LEC Main Sess,Staff,30,0,30,0,0
14491,Homestead Campus,EEC 1200 - 0004   Early Childhood Curriculum 1,0004-LEC Twelve Wk,Staff,30,8,22,0,0
14492,InterAmerican Campus,EEC 1200 - 0005   Early Childhood Curriculum 1,0005-LEC Conversion,Staff,30,0,30,0,0
14489,Hialeah Campus,EEC 1200 - 0006   Early Childhood Curriculum 1,0006-LEC Twelve Wk,Staff,30,9,21,0,0
15267,Wolfson Campus,FSS 1200 - 0001   Culinary Terminology And Procedures,0001-LEC Main Sess,Staff,32,0,32,0,0
15270,Wolfson Campus,FSS 1200 - 0002   Culinary Terminology And Procedures,0002-LEC Main Sess,Staff,32,16,16,0,0
15269,Wolfson Campus,FSS 1200 - 0003   Culinary Terminology And Procedures,0003-LEC Main Sess,Staff,30,17,13,0,0
15268,Wolfson Campus,FSS 1200 - 0004   Culinary Terminology And Procedures,0004-LEC Main Sess,Staff,30,19,11,0,0
11644,Kendall Campus,IND 1200 - 0001   Interior Design 2,0001-LEC Main Sess,Staff,15,11,4,0,0
11646,Kendall Campus,IND 1200 - 0002   Interior Design 2,0002-LEC Main Sess,Staff,15,8,7,0,0
11645,Wolfson Campus,IND 1200 - 0003   Interior Design 2,0003-LEC Main Sess,Staff,15,8,7,0,0
14078,North Campus,TPA 1200 - 0001   Stagecraft,0001-LEC Main Sess,Staff,15,0,15,0,0
14077,Wolfson Campus,TPA 1200 - 0002   Stagecraft,0002-LEC Main Sess,Staff,25,14,11,0,0
6077,Medical Campus,DES 1200L - 0001   Dental Radiology Laboratory,0001-LAB Conversion,Staff,2,0,2,0,0
7808,Medical Campus,MLT 1196 - 0001   Laboratory Safety And Regulations,0001-LEC Main Sess,Staff,20,14,6,0,0
5916,North Campus,CCJ 1191 - 0001   Human Behavior In Criminal Justice,0001-LEC Conversion,Staff,30,28,2,0,0
5905,North Campus,CCJ 1191 - 0002   Human Behavior In Criminal Justice,0002-LEC Main Sess,Staff,30,22,8,0,0
5907,North Campus,CCJ 1191 - 0004   Human Behavior In Criminal Justice,0004-LEC Main Sess,Staff,40,25,15,0,0
5908,North Campus,CCJ 1191 - 0005   Human Behavior In Criminal Justice,0005-LEC Main Sess,Staff,30,24,6,0,0
5917,North Campus,CCJ 1191 - 0006   Human Behavior In Criminal Justice,0006-LEC 1st Mon Sp,Staff,25,0,25,0,0
5913,North Campus,CCJ 1191 - 0007   Human Behavior In Criminal Justice,0007-LEC Twelve Wk,Staff,30,0,30,0,0
5918,Kendall Campus,CCJ 1191 - 0008   Human Behavior In Criminal Justice,0008-LEC 1st Mon Sp,Staff,35,31,4,0,0
5914,Kendall Campus,CCJ 1191 - 0009   Human Behavior In Criminal Justice,0009-LEC Twelve Wk,Staff,30,27,3,0,0
5909,Wolfson Campus,CCJ 1191 - 0010   Human Behavior In Criminal Justice,0010-LEC Main Sess,Staff,30,29,1,0,0
5910,Wolfson Campus,CCJ 1191 - 0011   Human Behavior In Criminal Justice,0011-LEC Main Sess,Staff,40,21,19,0,0
5911,Wolfson Campus,CCJ 1191 - 0012   Human Behavior In Criminal Justice,0012-LEC Main Sess,Staff,34,32,2,0,0
5912,Wolfson Campus,CCJ 1191 - 0013   Human Behavior In Criminal Justice,0013-LEC Main Sess,Staff,30,24,6,0,0
5915,Wolfson Campus,CCJ 1191 - 0014   Human Behavior In Criminal Justice,0014-LEC Conversion,Staff,34,22,12,0,0
12225,Medical Campus,MLT 1191 - 0001   Histotechnology 1,0001-LEC Main Sess,Staff,20,13,7,0,0
16346,Medical Campus,MLT 1191L - 0003   Histotechnology 1 Lab,0003-LAB Main Sess,Staff,6,0,6,0,0
13231,Wolfson Campus,TPP 1190 - 0001   Studio Theatre-Cast,0001-LEC Conversion,Staff,30,1,29,0,0
12130,North Campus,ETI 1172 - 0001   Introduction To Quality Assurance,0001-LEC Twelve Wk,Staff,30,0,30,0,0
8294,North Campus,CET 1171 - 0001   Introduction To Computer Service And Maintenance,0001-LEC Eight Wk 1,Staff,24,14,10,0,0
8293,Kendall Campus,CET 1171 - 0002   Introduction To Computer Service And Maintenance,0002-LEC Eight Wk 1,Staff,24,9,15,0,0
17245,Wolfson Campus,TPP 1170 - 0001   Beginning Characterization,0001-LEC Conversion,Staff,25,10,15,0,0
17247,Wolfson Campus,TPP 1170 - 0002   Beginning Characterization,0002-LEC Conversion,Staff,25,10,15,0,0
17246,Wolfson Campus,TPP 1170 - 0003   Beginning Characterization,0003-LEC Conversion,Staff,25,15,10,0,0
5897,North Campus,CJC 1162 - 0001   Parole And Probation,0001-LEC Main Sess,Staff,40,0,40,0,0
5903,North Campus,CJC 1162 - 0002   Parole And Probation,0002-LEC Twelve Wk,Staff,30,16,14,0,0
5898,North Campus,CJC 1162 - 0003   Parole And Probation,0003-LEC Main Sess,Staff,40,33,7,0,0
5899,Kendall Campus,CJC 1162 - 0004   Parole And Probation,0004-LEC Main Sess,Staff,45,25,20,0,0
5900,Wolfson Campus,CJC 1162 - 0005   Parole And Probation,0005-LEC Main Sess,Staff,30,29,1,0,0
5901,Homestead Campus,CJC 1162 - 0006   Parole And Probation,0006-LEC Main Sess,Staff,30,17,13,0,0
5902,West Campus,CJC 1162 - 0007   Parole And Probation,0007-LEC Main Sess,Staff,35,13,22,0,0
7110,Kendall Campus,ISS 1161 - 0001   The Individual In Society,0001-LEC Main Sess,Staff,45,35,10,0,0
7111,Kendall Campus,ISS 1161 - 0002   The Individual In Society,0002-LEC Main Sess,Staff,40,19,21,0,0
7112,Kendall Campus,ISS 1161 - 0003   The Individual In Society,0003-LEC Main Sess,Staff,49,19,30,0,0
7113,Kendall Campus,ISS 1161 - 0004   The Individual In Society,0004-LEC Main Sess,Staff,30,0,30,0,0
7120,Kendall Campus,ISS 1161 - 0005   The Individual In Society,0005-LEC Eight Wk 2,Staff,36,0,36,0,0
7114,Wolfson Campus,ISS 1161 - 0006   The Individual In Society,0006-LEC Main Sess,Staff,47,18,29,0,0
7115,Wolfson Campus,ISS 1161 - 0007   The Individual In Society,0007-LEC Main Sess,Staff,47,0,47,0,0
7117,Wolfson Campus,ISS 1161 - 0008   The Individual In Society,0008-LEC Main Sess,Staff,30,26,4,0,0
7121,Wolfson Campus,ISS 1161 - 0009   The Individual In Society,0009-LEC Conversion,Staff,34,33,1,0,0
7118,InterAmerican Campus,ISS 1161 - 0010   The Individual In Society,0010-LEC Main Sess,Staff,29,13,16,0,0
7119,Hialeah Campus,ISS 1161 - 0011   The Individual In Society,0011-LEC Main Sess,Staff,33,0,33,0,0
7116,Hialeah Campus,ISS 1161 - 0012   The Individual In Society,0012-LEC Main Sess,Staff,33,0,33,0,0
11494,Wolfson Campus,MKA 1161 - 0001   Introduction To Customer Service,0001-LEC Main Sess,Staff,30,0,30,0,0
11495,Wolfson Campus,MKA 1161 - 0002   Introduction To Customer Service,0002-LEC Main Sess,Staff,30,25,5,0,0
11496,Wolfson Campus,MKA 1161 - 0003   Introduction To Customer Service,0003-LEC Conversion,Staff,30,21,9,0,0
11898,Wolfson Campus,TPP 1161 - 0001   Voice & Movement 1 Continuation,0001-LEC Main Sess,Staff,25,13,12,0,0
11900,Wolfson Campus,TPP 1161 - 0002   Voice & Movement 1 Continuation,0002-LEC Conversion,Staff,25,16,9,0,0
11899,Wolfson Campus,TPP 1161 - 0003   Voice & Movement 1 Continuation,0003-LEC Conversion,Staff,25,11,14,0,0
12580,Wolfson Campus,TPP 1160 - 0001   Voice & Movement 1,0001-LEC Conversion,Staff,25,4,21,0,0
12582,Wolfson Campus,TPP 1160 - 0002   Voice & Movement 1,0002-LEC Conversion,Staff,40,3,37,0,0
12581,Wolfson Campus,TPP 1160 - 0003   Voice & Movement 1,0003-LEC Conversion,Staff,25,4,21,0,0
17248,Wolfson Campus,TRA 1154 - 0001   Introduction To Supply Chain Management,0001-LEC Main Sess,Staff,30,11,19,0,0
17249,Homestead Campus,TRA 1154 - 0002   Introduction To Supply Chain Management,0002-LEC Eight Wk 1,Staff,30,21,9,0,0
11388,Wolfson Campus,IDS 1153 - 0001   Earth Literacy And Sustainability 1,0001-LEC 1st Mon Sp,Staff,25,0,25,0,0
16905,Medical Campus,OPT 1150 - 0001   Ophthalmic Lenses,0001-LEC Main Sess,Staff,40,29,11,0,0
14079,North Campus,TPP 1150 - 0001   Scene Study 1,0001-LEC Main Sess,Staff,12,7,5,0,0
14082,Wolfson Campus,TPP 1150 - 0002   Scene Study 1,0002-LEC Main Sess,Staff,15,10,5,0,0
14081,Wolfson Campus,TPP 1150 - 0003   Scene Study 1,0003-LEC Main Sess,Staff,25,13,12,0,0
14080,Wolfson Campus,TPP 1150 - 0004   Scene Study 1,0004-LEC Main Sess,Staff,25,15,10,0,0
7362,North Campus,MAC 1147 - 0001   Pre-Calculus Algebra And Trigonometry,0001-LEC Main Sess,Staff,40,32,8,0,0
7363,North Campus,MAC 1147 - 0002   Pre-Calculus Algebra And Trigonometry,0002-LEC Main Sess,Staff,40,35,5,0,0
7364,North Campus,MAC 1147 - 0003   Pre-Calculus Algebra And Trigonometry,0003-LEC Main Sess,Staff,40,17,23,0,0
7365,North Campus,MAC 1147 - 0004   Pre-Calculus Algebra And Trigonometry,0004-LEC Main Sess,Staff,40,34,6,0,0
7366,North Campus,MAC 1147 - 0005   Pre-Calculus Algebra And Trigonometry,0005-LEC Main Sess,Staff,20,0,20,0,0
7367,Kendall Campus,MAC 1147 - 0006   Pre-Calculus Algebra And Trigonometry,0006-LEC Main Sess,Staff,25,18,7,0,0
7369,Kendall Campus,MAC 1147 - 0008   Pre-Calculus Algebra And Trigonometry,0008-LEC Main Sess,Staff,36,31,5,0,0
7370,Kendall Campus,MAC 1147 - 0009   Pre-Calculus Algebra And Trigonometry,0009-LEC Main Sess,Staff,40,21,19,0,0
7371,Kendall Campus,MAC 1147 - 0010   Pre-Calculus Algebra And Trigonometry,0010-LEC Main Sess,Staff,40,39,1,0,0
7372,Kendall Campus,MAC 1147 - 0011   Pre-Calculus Algebra And Trigonometry,0011-LEC Main Sess,Staff,40,39,1,0,0
7374,Kendall Campus,MAC 1147 - 0013   Pre-Calculus Algebra And Trigonometry,0013-LEC Main Sess,Staff,36,35,1,0,0
7391,Kendall Campus,MAC 1147 - 0014   Pre-Calculus Algebra And Trigonometry,0014-LEC Weekend,Staff,30,15,15,0,0
7375,Wolfson Campus,MAC 1147 - 0015   Pre-Calculus Algebra And Trigonometry,0015-LEC Main Sess,Staff,38,34,4,0,0
7376,Wolfson Campus,MAC 1147 - 0016   Pre-Calculus Algebra And Trigonometry,0016-LEC Main Sess,Staff,38,35,3,0,0
7377,Wolfson Campus,MAC 1147 - 0017   Pre-Calculus Algebra And Trigonometry,0017-LEC Main Sess,Staff,38,22,16,0,0
7379,Wolfson Campus,MAC 1147 - 0019   Pre-Calculus Algebra And Trigonometry,0019-LEC Main Sess,Staff,35,14,21,0,0
7380,Wolfson Campus,MAC 1147 - 0020   Pre-Calculus Algebra And Trigonometry,0020-LEC Main Sess,Staff,30,23,7,0,0
7381,Wolfson Campus,MAC 1147 - 0021   Pre-Calculus Algebra And Trigonometry,0021-LEC Main Sess,Staff,30,26,4,0,0
7382,Wolfson Campus,MAC 1147 - 0022   Pre-Calculus Algebra And Trigonometry,0022-LEC Main Sess,Staff,30,27,3,0,0
7384,InterAmerican Campus,MAC 1147 - 0024   Pre-Calculus Algebra And Trigonometry,0024-LEC Main Sess,Staff,20,17,3,0,0
7385,InterAmerican Campus,MAC 1147 - 0025   Pre-Calculus Algebra And Trigonometry,0025-LEC Main Sess,Staff,37,35,2,0,0
7386,InterAmerican Campus,MAC 1147 - 0026   Pre-Calculus Algebra And Trigonometry,0026-LEC Main Sess,Staff,37,35,2,0,0
7387,InterAmerican Campus,MAC 1147 - 0027   Pre-Calculus Algebra And Trigonometry,0027-LEC Main Sess,Staff,30,0,30,0,0
7388,Hialeah Campus,MAC 1147 - 0028   Pre-Calculus Algebra And Trigonometry,0028-LEC Main Sess,Staff,30,28,2,0,0
7389,Hialeah Campus,MAC 1147 - 0029   Pre-Calculus Algebra And Trigonometry,0029-LEC Main Sess,Staff,35,19,16,0,0
7390,Hialeah Campus,MAC 1147 - 0030   Pre-Calculus Algebra And Trigonometry,0030-LEC Main Sess,Staff,35,18,17,0,0
13008,Wolfson Campus,NUR 1142 - 0001   Introduction To Nursing Math & Pharmacology,0001-LEC Conversion,Staff,30,28,2,0,0
13014,Wolfson Campus,NUR 1142 - 0002   Introduction To Nursing Math & Pharmacology,0002-LEC Conversion,Staff,30,12,18,0,0
13012,Medical Campus,NUR 1142 - 0004   Introduction To Nursing Math & Pharmacology,0004-LEC Conversion,Staff,25,20,5,0,0
13005,Medical Campus,NUR 1142 - 0008   Introduction To Nursing Math & Pharmacology,0008-LEC Conversion,Staff,40,17,23,0,0
13007,Homestead Campus,NUR 1142 - 0009   Introduction To Nursing Math & Pharmacology,0009-LEC Conversion,Staff,35,19,16,0,0
13006,Homestead Campus,NUR 1142 - 0010   Introduction To Nursing Math & Pharmacology,0010-LEC Conversion,Staff,65,44,21,0,0
8098,Medical Campus,NUR 1141 - 0001   Nursing Math & Pharmacology,0001-LEC Conversion,Staff,56,44,12,0,0
8097,Medical Campus,NUR 1141 - 0002   Nursing Math & Pharmacology,0002-LEC Conversion,Staff,40,0,40,0,0
8099,Medical Campus,NUR 1141 - 0003   Nursing Math & Pharmacology,0003-LEC Conversion,Staff,50,42,8,0,0
8100,Homestead Campus,NUR 1141 - 0005   Nursing Math & Pharmacology,0005-LEC Conversion,Staff,50,46,4,0,0
12792,North Campus,MAC 1140 - 0001   Pre-Calculus Algebra,0001-LEC Weekend,Staff,30,12,18,0,0
12763,North Campus,MAC 1140 - 0002   Pre-Calculus Algebra,0002-LEC Main Sess,Staff,40,20,20,0,0
12764,North Campus,MAC 1140 - 0003   Pre-Calculus Algebra,0003-LEC Main Sess,Staff,40,15,25,0,0
12769,North Campus,MAC 1140 - 0005   Pre-Calculus Algebra,0005-LEC Main Sess,Staff,40,37,3,0,0
12771,Kendall Campus,MAC 1140 - 0007   Pre-Calculus Algebra,0007-LEC Main Sess,Staff,38,23,15,0,0
12772,Kendall Campus,MAC 1140 - 0008   Pre-Calculus Algebra,0008-LEC Main Sess,Staff,40,16,24,0,0
12774,Kendall Campus,MAC 1140 - 0010   Pre-Calculus Algebra,0010-LEC Main Sess,Staff,40,39,1,0,0
12775,Kendall Campus,MAC 1140 - 0011   Pre-Calculus Algebra,0011-LEC Main Sess,Staff,40,39,1,0,0
12776,Kendall Campus,MAC 1140 - 0012   Pre-Calculus Algebra,0012-LEC Main Sess,Staff,40,20,20,0,0
12789,Kendall Campus,MAC 1140 - 0013   Pre-Calculus Algebra,0013-LEC Eight Wk 2,Staff,39,0,39,0,0
12777,Kendall Campus,MAC 1140 - 0014   Pre-Calculus Algebra,0014-LEC Main Sess,Staff,40,24,16,0,0
12778,Kendall Campus,MAC 1140 - 0015   Pre-Calculus Algebra,0015-LEC Main Sess,Staff,38,36,2,0,0
12780,Wolfson Campus,MAC 1140 - 0017   Pre-Calculus Algebra,0017-LEC Main Sess,Staff,35,23,12,0,0
12781,Wolfson Campus,MAC 1140 - 0018   Pre-Calculus Algebra,0018-LEC Main Sess,Staff,38,25,13,0,0
12782,Wolfson Campus,MAC 1140 - 0019   Pre-Calculus Algebra,0019-LEC Main Sess,Staff,38,35,3,0,0
12783,Wolfson Campus,MAC 1140 - 0020   Pre-Calculus Algebra,0020-LEC Main Sess,Staff,38,11,27,0,0
12784,Wolfson Campus,MAC 1140 - 0021   Pre-Calculus Algebra,0021-LEC Main Sess,Staff,25,0,25,0,0
12785,Wolfson Campus,MAC 1140 - 0022   Pre-Calculus Algebra,0022-LEC Main Sess,Staff,30,26,4,0,0
12786,Wolfson Campus,MAC 1140 - 0023   Pre-Calculus Algebra,0023-LEC Main Sess,Staff,30,25,5,0,0
12791,Wolfson Campus,MAC 1140 - 0024   Pre-Calculus Algebra,0024-LEC Conversion,Staff,30,28,2,0,0
12790,InterAmerican Campus,MAC 1140 - 0026   Pre-Calculus Algebra,0026-LEC Eight Wk 2,Staff,37,0,37,0,0
12788,InterAmerican Campus,MAC 1140 - 0027   Pre-Calculus Algebra,0027-LEC Main Sess,Staff,30,19,11,0,0
12767,InterAmerican Campus,MAC 1140 - 0028   Pre-Calculus Algebra,0028-LEC Main Sess,Staff,30,27,3,0,0
12766,Hialeah Campus,MAC 1140 - 0029   Pre-Calculus Algebra,0029-LEC Main Sess,Staff,35,27,8,0,0
5522,North Campus,CTS 1134 - 0001   Networking Technologies,0001-LEC Conversion,Staff,20,0,20,0,0
5512,North Campus,CTS 1134 - 0002   Networking Technologies,0002-LEC Main Sess,Staff,24,23,1,0,0
5513,North Campus,CTS 1134 - 0003   Networking Technologies,0003-LEC Main Sess,Staff,30,29,1,0,0
5514,North Campus,CTS 1134 - 0004   Networking Technologies,0004-LEC Main Sess,Staff,5,0,5,0,0
5515,Kendall Campus,CTS 1134 - 0005   Networking Technologies,0005-LEC Main Sess,Staff,28,0,28,0,0
5516,Kendall Campus,CTS 1134 - 0006   Networking Technologies,0006-LEC Main Sess,Staff,28,27,1,0,0
5517,Kendall Campus,CTS 1134 - 0007   Networking Technologies,0007-LEC Main Sess,Staff,28,27,1,0,0
5518,Wolfson Campus,CTS 1134 - 0008   Networking Technologies,0008-LEC Main Sess,Staff,16,14,2,0,0
5519,Wolfson Campus,CTS 1134 - 0009   Networking Technologies,0009-LEC Main Sess,Staff,16,12,4,0,0
5520,Homestead Campus,CTS 1134 - 0010   Networking Technologies,0010-LEC Main Sess,Staff,20,0,20,0,0
5521,InterAmerican Campus,CTS 1134 - 0011   Networking Technologies,0011-LEC Main Sess,Staff,35,14,21,0,0
14193,Wolfson Campus,DIG 1132 - 0001   Digital Art And Design,0001-LEC Main Sess,Staff,24,23,1,0,0
14195,Wolfson Campus,DIG 1132 - 0002   Digital Art And Design,0002-LEC Conversion,Staff,24,23,1,0,0
14194,Wolfson Campus,DIG 1132 - 0003   Digital Art And Design,0003-LEC Main Sess,Staff,24,20,4,0,0
8667,North Campus,CTS 1131 - 0001   A+ Computer Essentials & Support,0001-LEC 1st Mon Sp,Staff,25,21,4,0,0
8664,North Campus,CTS 1131 - 0002   A+ Computer Essentials & Support,0002-LEC Main Sess,Staff,25,0,25,0,0
14654,Wolfson Campus,IND 1130 - 0001   History Of Interiors 2,0001-LEC Main Sess,Staff,20,6,14,0,0
7123,North Campus,ARC 1126 - 0001   Architectural Drawing 1,0001-LEC Main Sess,Staff,20,17,3,0,0
7124,North Campus,ARC 1126 - 0002   Architectural Drawing 1,0002-LEC Main Sess,Staff,20,17,3,0,0
7129,Wolfson Campus,ARC 1126 - 0007   Architectural Drawing 1,0007-LEC Main Sess,Staff,20,17,3,0,0
7130,Wolfson Campus,ARC 1126 - 0008   Architectural Drawing 1,0008-LEC Main Sess,Staff,20,19,1,0,0
7131,Wolfson Campus,ARC 1126 - 0009   Architectural Drawing 1,0009-LEC Main Sess,Staff,20,18,2,0,0
7132,Wolfson Campus,ARC 1126 - 0010   Architectural Drawing 1,0010-LEC Conversion,Staff,2,0,2,0,0
15722,North Campus,SLS 1125 - 0001   Student Support Seminar,0001-LEC Main Sess,Staff,33,29,4,0,0
15723,North Campus,SLS 1125 - 0002   Student Support Seminar,0002-LEC Main Sess,Staff,30,27,3,0,0
15747,North Campus,SLS 1125 - 0003   Student Support Seminar,0003-LEC Main Sess,Staff,30,24,6,0,0
15748,North Campus,SLS 1125 - 0004   Student Support Seminar,0004-LEC Main Sess,Staff,30,27,3,0,0
15749,North Campus,SLS 1125 - 0005   Student Support Seminar,0005-LEC Main Sess,Staff,40,0,40,0,0
15750,North Campus,SLS 1125 - 0006   Student Support Seminar,0006-LEC Main Sess,Staff,40,28,12,0,0
15773,North Campus,SLS 1125 - 0007   Student Support Seminar,0007-LEC Twelve Wk,Staff,35,33,2,0,0
15751,North Campus,SLS 1125 - 0008   Student Support Seminar,0008-LEC Main Sess,Staff,30,0,30,0,0
15752,North Campus,SLS 1125 - 0009   Student Support Seminar,0009-LEC Main Sess,Staff,40,32,8,0,0
15772,North Campus,SLS 1125 - 0010   Student Support Seminar,0010-LEC Twelve Wk,Staff,37,22,15,0,0
15771,North Campus,SLS 1125 - 0011   Student Support Seminar,0011-LEC Twelve Wk,Staff,37,29,8,0,0
15781,North Campus,SLS 1125 - 0012   Student Support Seminar,0012-LEC Conversion,Staff,37,30,7,0,0
15770,North Campus,SLS 1125 - 0013   Student Support Seminar,0013-LEC Twelve Wk,Staff,37,19,18,0,0
15753,Kendall Campus,SLS 1125 - 0014   Student Support Seminar,0014-LEC Main Sess,Staff,30,24,6,0,0
15754,Kendall Campus,SLS 1125 - 0015   Student Support Seminar,0015-LEC Main Sess,Staff,30,29,1,0,0
15755,Kendall Campus,SLS 1125 - 0016   Student Support Seminar,0016-LEC Main Sess,Staff,25,24,1,0,0
15756,Kendall Campus,SLS 1125 - 0017   Student Support Seminar,0017-LEC Main Sess,Staff,30,28,2,0,0
15757,Kendall Campus,SLS 1125 - 0018   Student Support Seminar,0018-LEC Main Sess,Staff,30,22,8,0,0
15758,Kendall Campus,SLS 1125 - 0019   Student Support Seminar,0019-LEC Main Sess,Staff,36,35,1,0,0
15783,Kendall Campus,SLS 1125 - 0020   Student Support Seminar,0020-LEC Weekend,Staff,30,27,3,0,0
15776,Kendall Campus,SLS 1125 - 0022   Student Support Seminar,0022-LEC Eight Wk 2,Staff,30,28,2,0,0
15759,Kendall Campus,SLS 1125 - 0023   Student Support Seminar,0023-LEC Main Sess,Staff,30,28,2,0,0
15746,Kendall Campus,SLS 1125 - 0024   Student Support Seminar,0024-LEC Main Sess,Staff,30,27,3,0,0
15745,Kendall Campus,SLS 1125 - 0025   Student Support Seminar,0025-LEC Main Sess,Staff,30,26,4,0,0
15744,Kendall Campus,SLS 1125 - 0026   Student Support Seminar,0026-LEC Main Sess,Staff,30,28,2,0,0
15743,Kendall Campus,SLS 1125 - 0027   Student Support Seminar,0027-LEC Main Sess,Staff,30,26,4,0,0
15742,Kendall Campus,SLS 1125 - 0028   Student Support Seminar,0028-LEC Main Sess,Staff,26,25,1,0,0
15741,Kendall Campus,SLS 1125 - 0029   Student Support Seminar,0029-LEC Main Sess,Staff,30,28,2,0,0
15777,Kendall Campus,SLS 1125 - 0032   Student Support Seminar,0032-LEC Eight Wk 2,Staff,30,28,2,0,0
15778,Kendall Campus,SLS 1125 - 0033   Student Support Seminar,0033-LEC Eight Wk 2,Staff,28,26,2,0,0
15780,Kendall Campus,SLS 1125 - 0035   Student Support Seminar,0035-LEC Eight Wk 2,Staff,25,20,5,0,0
15739,Kendall Campus,SLS 1125 - 0036   Student Support Seminar,0036-LEC Main Sess,Staff,30,29,1,0,0
15738,Kendall Campus,SLS 1125 - 0037   Student Support Seminar,0037-LEC Main Sess,Staff,30,29,1,0,0
15737,Wolfson Campus,SLS 1125 - 0040   Student Support Seminar,0040-LEC Main Sess,Staff,37,31,6,0,0
15736,Wolfson Campus,SLS 1125 - 0041   Student Support Seminar,0041-LEC Main Sess,Staff,37,33,4,0,0
15735,Wolfson Campus,SLS 1125 - 0042   Student Support Seminar,0042-LEC Main Sess,Staff,30,29,1,0,0
15734,Wolfson Campus,SLS 1125 - 0043   Student Support Seminar,0043-LEC Main Sess,Staff,37,35,2,0,0
15733,Wolfson Campus,SLS 1125 - 0044   Student Support Seminar,0044-LEC Main Sess,Staff,37,34,3,0,0
15732,Wolfson Campus,SLS 1125 - 0045   Student Support Seminar,0045-LEC Main Sess,Staff,37,33,4,0,0
15763,Wolfson Campus,SLS 1125 - 0046   Student Support Seminar,0046-LEC Twelve Wk,Staff,37,36,1,0,0
15764,Wolfson Campus,SLS 1125 - 0047   Student Support Seminar,0047-LEC Twelve Wk,Staff,37,34,3,0,0
15765,Wolfson Campus,SLS 1125 - 0048   Student Support Seminar,0048-LEC Twelve Wk,Staff,30,0,30,0,0
15731,Wolfson Campus,SLS 1125 - 0049   Student Support Seminar,0049-LEC Main Sess,Staff,37,23,14,0,0
15766,Wolfson Campus,SLS 1125 - 0050   Student Support Seminar,0050-LEC Twelve Wk,Staff,40,29,11,0,0
15782,Wolfson Campus,SLS 1125 - 0051   Student Support Seminar,0051-LEC Conversion,Staff,30,0,30,0,0
15730,Homestead Campus,SLS 1125 - 0052   Student Support Seminar,0052-LEC Main Sess,Staff,39,34,5,0,0
15729,Homestead Campus,SLS 1125 - 0053   Student Support Seminar,0053-LEC Main Sess,Staff,39,26,13,0,0
15728,InterAmerican Campus,SLS 1125 - 0054   Student Support Seminar,0054-LEC Main Sess,Staff,29,15,14,0,0
15767,InterAmerican Campus,SLS 1125 - 0055   Student Support Seminar,0055-LEC Twelve Wk,Staff,30,26,4,0,0
15768,InterAmerican Campus,SLS 1125 - 0056   Student Support Seminar,0056-LEC Twelve Wk,Staff,25,22,3,0,0
15727,Hialeah Campus,SLS 1125 - 0058   Student Support Seminar,0058-LEC Main Sess,Staff,30,27,3,0,0
15726,Hialeah Campus,SLS 1125 - 0059   Student Support Seminar,0059-LEC Main Sess,Staff,32,29,3,0,0
15725,West Campus,SLS 1125 - 0060   Student Support Seminar,0060-LEC Main Sess,Staff,35,33,2,0,0
15774,West Campus,SLS 1125 - 0061   Student Support Seminar,0061-LEC Twelve Wk,Staff,35,32,3,0,0
15724,West Campus,SLS 1125 - 0062   Student Support Seminar,0062-LEC Main Sess,Staff,35,18,17,0,0
6042,Homestead Campus,AVM 1121 - 0001   Hazardous Materials/Dangerous Goods,0001-LEC Main Sess,Staff,30,9,21,0,0
5427,Kendall Campus,CHI 1121 - 0001   Elementary Mandarin Chinese 2,0001-LEC Main Sess,Staff,15,7,8,0,0
5430,Wolfson Campus,CHI 1121 - 0002   Elementary Mandarin Chinese 2,0002-LEC Main Sess,Staff,20,5,15,0,0
5429,Wolfson Campus,CHI 1121 - 0003   Elementary Mandarin Chinese 2,0003-LEC Main Sess,Staff,20,0,20,0,0
5428,Hialeah Campus,CHI 1121 - 0004   Elementary Mandarin Chinese 2,0004-LEC Main Sess,Staff,15,7,8,0,0
16243,North Campus,FRE 1121 - 0001   Elementary French 2,0001-LEC Eight Wk 2,Staff,28,16,12,0,0
16244,North Campus,FRE 1121 - 0002   Elementary French 2,0002-LEC Eight Wk 2,Staff,28,0,28,0,0
16240,Kendall Campus,FRE 1121 - 0003   Elementary French 2,0003-LEC Main Sess,Staff,25,12,13,0,0
16241,Wolfson Campus,FRE 1121 - 0004   Elementary French 2,0004-LEC Eight Wk 2,Staff,28,18,10,0,0
16245,Wolfson Campus,FRE 1121 - 0005   Elementary French 2,0005-LEC Weekend,Staff,2,0,2,0,0
16246,Wolfson Campus,FRE 1121 - 0006   Elementary French 2,0006-LEC Weekend,Staff,25,0,25,0,0
16239,InterAmerican Campus,FRE 1121 - 0007   Elementary French 2,0007-LEC Main Sess,Staff,30,0,30,0,0
16242,Hialeah Campus,FRE 1121 - 0008   Elementary French 2,0008-LEC Eight Wk 2,Staff,27,0,27,0,0
6378,Kendall Campus,GER 1121 - 0001   Elementary German 2,0001-LEC Main Sess,Staff,25,0,25,0,0
6377,InterAmerican Campus,GER 1121 - 0002   Elementary German 2,0002-LEC Main Sess,Staff,30,9,21,0,0
11647,Kendall Campus,ITA 1121 - 0001   Elementary Italian 2,0001-LEC Main Sess,Staff,25,6,19,0,0
11648,Kendall Campus,ITA 1121 - 0002   Elementary Italian 2,0002-LEC Main Sess,Staff,25,6,19,0,0
11650,Hialeah Campus,ITA 1121 - 0003   Elementary Italian 2,0003-LEC Eight Wk 2,Staff,30,0,30,0,0
11649,Hialeah Campus,ITA 1121 - 0004   Elementary Italian 2,0004-LEC Main Sess,Staff,30,7,23,0,0
10911,Kendall Campus,POR 1121 - 0001   Elementary Portuguese 2,0001-LEC Main Sess,Staff,20,4,16,0,0
10912,Wolfson Campus,POR 1121 - 0002   Elementary Portuguese 2,0002-LEC Weekend,Staff,25,13,12,0,0
11995,North Campus,PSC 1121 - 0001   General Education Physical Science,0001-LEC Main Sess,Staff,35,0,35,0,0
11996,North Campus,PSC 1121 - 0002   General Education Physical Science,0002-LEC Main Sess,Staff,35,0,35,0,0
11997,Wolfson Campus,PSC 1121 - 0003   General Education Physical Science,0003-LEC Main Sess,Staff,45,23,22,0,0
11998,Wolfson Campus,PSC 1121 - 0004   General Education Physical Science,0004-LEC Main Sess,Staff,30,29,1,0,0
11999,Wolfson Campus,PSC 1121 - 0005   General Education Physical Science,0005-LEC Main Sess,Staff,30,24,6,0,0
12000,Wolfson Campus,PSC 1121 - 0006   General Education Physical Science,0006-LEC Main Sess,Staff,30,28,2,0,0
12001,Wolfson Campus,PSC 1121 - 0007   General Education Physical Science,0007-LEC Conversion,Staff,30,29,1,0,0
14004,Wolfson Campus,RUS 1121 - 0001   Elementary Russian 2,0001-LEC Main Sess,Staff,25,7,18,0,0
14005,Wolfson Campus,RUS 1121 - 0002   Elementary Russian 2,0002-LEC Eight Wk 2,Staff,5,2,3,0,0
11088,North Campus,SPN 1121 - 0001   Elementary Spanish 2,0001-LEC Main Sess,Staff,30,27,3,0,0
11100,North Campus,SPN 1121 - 0002   Elementary Spanish 2,0002-LEC Eight Wk 2,Staff,30,26,4,0,0
11089,North Campus,SPN 1121 - 0003   Elementary Spanish 2,0003-LEC Main Sess,Staff,28,17,11,0,0
11099,North Campus,SPN 1121 - 0004   Elementary Spanish 2,0004-LEC Eight Wk 2,Staff,29,21,8,0,0
11096,North Campus,SPN 1121 - 0005   Elementary Spanish 2,0005-LEC Main Sess,Staff,28,17,11,0,0
11095,Kendall Campus,SPN 1121 - 0007   Elementary Spanish 2,0007-LEC Main Sess,Staff,25,20,5,0,0
11093,Kendall Campus,SPN 1121 - 0009   Elementary Spanish 2,0009-LEC Main Sess,Staff,25,10,15,0,0
11097,Kendall Campus,SPN 1121 - 0010   Elementary Spanish 2,0010-LEC Eight Wk 2,Staff,25,15,10,0,0
11092,Kendall Campus,SPN 1121 - 0011   Elementary Spanish 2,0011-LEC Main Sess,Staff,25,12,13,0,0
11101,Wolfson Campus,SPN 1121 - 0012   Elementary Spanish 2,0012-LEC Eight Wk 2,Staff,30,19,11,0,0
11103,Wolfson Campus,SPN 1121 - 0013   Elementary Spanish 2,0013-LEC Weekend,Staff,30,15,15,0,0
11102,Wolfson Campus,SPN 1121 - 0014   Elementary Spanish 2,0014-LEC Eight Wk 2,Staff,30,17,13,0,0
11091,Homestead Campus,SPN 1121 - 0015   Elementary Spanish 2,0015-LEC Main Sess,Staff,30,13,17,0,0
11090,InterAmerican Campus,SPN 1121 - 0016   Elementary Spanish 2,0016-LEC Main Sess,Staff,30,0,30,0,0
5747,North Campus,CHI 1120 - 0001   Elementary Mandarin Chinese 1,0001-LEC Main Sess,Staff,30,4,26,0,0
5748,Kendall Campus,CHI 1120 - 0002   Elementary Mandarin Chinese 1,0002-LEC Main Sess,Staff,16,15,1,0,0
5752,Kendall Campus,CHI 1120 - 0003   Elementary Mandarin Chinese 1,0003-LEC Main Sess,Staff,15,8,7,0,0
5750,Wolfson Campus,CHI 1120 - 0004   Elementary Mandarin Chinese 1,0004-LEC Main Sess,Staff,20,9,11,0,0
5751,Wolfson Campus,CHI 1120 - 0005   Elementary Mandarin Chinese 1,0005-LEC Main Sess,Staff,20,14,6,0,0
5749,Hialeah Campus,CHI 1120 - 0006   Elementary Mandarin Chinese 1,0006-LEC Main Sess,Staff,14,6,8,0,0
5984,North Campus,CTS 1120 - 0001   Fundamentals Of Networking Security,0001-LEC Main Sess,Staff,30,0,30,0,0
5983,Wolfson Campus,CTS 1120 - 0002   Fundamentals Of Networking Security,0002-LEC Main Sess,Staff,20,0,20,0,0
10384,North Campus,FRE 1120 - 0001   Elementary French 1,0001-LEC Eight Wk 1,Staff,29,15,14,0,0
10385,North Campus,FRE 1120 - 0002   Elementary French 1,0002-LEC Eight Wk 1,Staff,29,0,29,0,0
10378,Kendall Campus,FRE 1120 - 0004   Elementary French 1,0004-LEC Main Sess,Staff,25,8,17,0,0
10379,Kendall Campus,FRE 1120 - 0005   Elementary French 1,0005-LEC Main Sess,Staff,25,19,6,0,0
10387,Wolfson Campus,FRE 1120 - 0006   Elementary French 1,0006-LEC Weekend,Staff,25,0,25,0,0
10382,Wolfson Campus,FRE 1120 - 0007   Elementary French 1,0007-LEC Eight Wk 1,Staff,28,19,9,0,0
10386,Wolfson Campus,FRE 1120 - 0008   Elementary French 1,0008-LEC Weekend,Staff,30,0,30,0,0
10383,Hialeah Campus,FRE 1120 - 0009   Elementary French 1,0009-LEC Eight Wk 1,Staff,27,13,14,0,0
10380,West Campus,FRE 1120 - 0010   Elementary French 1,0010-LEC Main Sess,Staff,35,8,27,0,0
7057,InterAmerican Campus,GER 1120 - 0001   Elementary German 1,0001-LEC Main Sess,Staff,30,10,20,0,0
7676,North Campus,ISS 1120 - 0001   The Social Environment,0001-LEC Main Sess,Staff,40,37,3,0,0
7677,North Campus,ISS 1120 - 0002   The Social Environment,0002-LEC Main Sess,Staff,40,31,9,0,0
7678,North Campus,ISS 1120 - 0003   The Social Environment,0003-LEC Main Sess,Staff,35,0,35,0,0
7679,North Campus,ISS 1120 - 0004   The Social Environment,0004-LEC Main Sess,Staff,40,38,2,0,0
7680,North Campus,ISS 1120 - 0005   The Social Environment,0005-LEC Main Sess,Staff,40,32,8,0,0
7681,North Campus,ISS 1120 - 0006   The Social Environment,0006-LEC Main Sess,Staff,40,36,4,0,0
7682,North Campus,ISS 1120 - 0007   The Social Environment,0007-LEC Main Sess,Staff,35,0,35,0,0
7683,North Campus,ISS 1120 - 0008   The Social Environment,0008-LEC Main Sess,Staff,28,0,28,0,0
7684,North Campus,ISS 1120 - 0009   The Social Environment,0009-LEC Main Sess,Staff,40,0,40,0,0
7685,North Campus,ISS 1120 - 0010   The Social Environment,0010-LEC Main Sess,Staff,40,34,6,0,0
7686,North Campus,ISS 1120 - 0011   The Social Environment,0011-LEC Main Sess,Staff,40,0,40,0,0
7744,North Campus,ISS 1120 - 0012   The Social Environment,0012-LEC Eight Wk 2,Staff,40,31,9,0,0
7745,North Campus,ISS 1120 - 0013   The Social Environment,0013-LEC Eight Wk 2,Staff,40,0,40,0,0
7756,North Campus,ISS 1120 - 0014   The Social Environment,0014-LEC 1st Mon Sp,Staff,40,38,2,0,0
7741,North Campus,ISS 1120 - 0015   The Social Environment,0015-LEC Twelve Wk,Staff,40,27,13,0,0
7739,North Campus,ISS 1120 - 0016   The Social Environment,0016-LEC Twelve Wk,Staff,40,20,20,0,0
7687,Kendall Campus,ISS 1120 - 0017   The Social Environment,0017-LEC Main Sess,Staff,45,20,25,0,0
7688,Kendall Campus,ISS 1120 - 0018   The Social Environment,0018-LEC Main Sess,Staff,45,37,8,0,0
7689,Kendall Campus,ISS 1120 - 0019   The Social Environment,0019-LEC Main Sess,Staff,45,18,27,0,0
7690,Kendall Campus,ISS 1120 - 0020   The Social Environment,0020-LEC Main Sess,Staff,50,13,37,0,0
7691,Kendall Campus,ISS 1120 - 0021   The Social Environment,0021-LEC Main Sess,Staff,36,23,13,0,0
7692,Kendall Campus,ISS 1120 - 0022   The Social Environment,0022-LEC Main Sess,Staff,30,25,5,0,0
7693,Kendall Campus,ISS 1120 - 0023   The Social Environment,0023-LEC Main Sess,Staff,30,23,7,0,0
7695,Kendall Campus,ISS 1120 - 0025   The Social Environment,0025-LEC Main Sess,Staff,45,42,3,0,0
7696,Kendall Campus,ISS 1120 - 0026   The Social Environment,0026-LEC Main Sess,Staff,49,25,24,0,0
7697,Kendall Campus,ISS 1120 - 0027   The Social Environment,0027-LEC Main Sess,Staff,40,13,27,0,0
7698,Kendall Campus,ISS 1120 - 0028   The Social Environment,0028-LEC Main Sess,Staff,45,44,1,0,0
7699,Kendall Campus,ISS 1120 - 0029   The Social Environment,0029-LEC Main Sess,Staff,45,44,1,0,0
7746,Kendall Campus,ISS 1120 - 0030   The Social Environment,0030-LEC Eight Wk 2,Staff,40,38,2,0,0
7700,Kendall Campus,ISS 1120 - 0031   The Social Environment,0031-LEC Main Sess,Staff,36,33,3,0,0
7701,Kendall Campus,ISS 1120 - 0032   The Social Environment,0032-LEC Main Sess,Staff,45,22,23,0,0
7702,Kendall Campus,ISS 1120 - 0033   The Social Environment,0033-LEC Main Sess,Staff,49,0,49,0,0
7703,Kendall Campus,ISS 1120 - 0034   The Social Environment,0034-LEC Main Sess,Staff,30,13,17,0,0
7704,Kendall Campus,ISS 1120 - 0035   The Social Environment,0035-LEC Main Sess,Staff,45,44,1,0,0
7705,Kendall Campus,ISS 1120 - 0036   The Social Environment,0036-LEC Main Sess,Staff,45,15,30,0,0
7706,Kendall Campus,ISS 1120 - 0037   The Social Environment,0037-LEC Main Sess,Staff,45,12,33,0,0
7707,Kendall Campus,ISS 1120 - 0038   The Social Environment,0038-LEC Main Sess,Staff,30,29,1,0,0
7743,Kendall Campus,ISS 1120 - 0039   The Social Environment,0039-LEC Eight Wk 2,Staff,28,17,11,0,0
7757,Kendall Campus,ISS 1120 - 0040   The Social Environment,0040-LEC Weekend,Staff,30,0,30,0,0
7708,Wolfson Campus,ISS 1120 - 0041   The Social Environment,0041-LEC Main Sess,Staff,47,29,18,0,0
7709,Wolfson Campus,ISS 1120 - 0042   The Social Environment,0042-LEC Main Sess,Staff,42,41,1,0,0
7710,Wolfson Campus,ISS 1120 - 0043   The Social Environment,0043-LEC Main Sess,Staff,47,23,24,0,0
7711,Wolfson Campus,ISS 1120 - 0044   The Social Environment,0044-LEC Main Sess,Staff,45,25,20,0,0
7748,Wolfson Campus,ISS 1120 - 0045   The Social Environment,0045-LEC Conversion,Staff,47,29,18,0,0
7747,Wolfson Campus,ISS 1120 - 0046   The Social Environment,0046-LEC Conversion,Staff,15,7,8,0,0
7712,Wolfson Campus,ISS 1120 - 0047   The Social Environment,0047-LEC Main Sess,Staff,47,36,11,0,0
7713,Wolfson Campus,ISS 1120 - 0048   The Social Environment,0048-LEC Main Sess,Staff,45,16,29,0,0
7740,Wolfson Campus,ISS 1120 - 0049   The Social Environment,0049-LEC Twelve Wk,Staff,47,0,47,0,0
7714,Wolfson Campus,ISS 1120 - 0050   The Social Environment,0050-LEC Main Sess,Staff,47,27,20,0,0
7715,Wolfson Campus,ISS 1120 - 0051   The Social Environment,0051-LEC Main Sess,Staff,47,21,26,0,0
7716,Wolfson Campus,ISS 1120 - 0052   The Social Environment,0052-LEC Main Sess,Staff,47,28,19,0,0
7717,Wolfson Campus,ISS 1120 - 0053   The Social Environment,0053-LEC Main Sess,Staff,47,22,25,0,0
7718,Wolfson Campus,ISS 1120 - 0054   The Social Environment,0054-LEC Main Sess,Staff,30,27,3,0,0
7719,Wolfson Campus,ISS 1120 - 0055   The Social Environment,0055-LEC Main Sess,Staff,30,26,4,0,0
7720,Wolfson Campus,ISS 1120 - 0056   The Social Environment,0056-LEC Main Sess,Staff,34,32,2,0,0
7753,Wolfson Campus,ISS 1120 - 0057   The Social Environment,0057-LEC Conversion,Staff,34,0,34,0,0
7721,Wolfson Campus,ISS 1120 - 0058   The Social Environment,0058-LEC Main Sess,Staff,34,32,2,0,0
7722,Wolfson Campus,ISS 1120 - 0059   The Social Environment,0059-LEC Main Sess,Staff,34,21,13,0,0
7754,Wolfson Campus,ISS 1120 - 0060   The Social Environment,0060-LEC Conversion,Staff,34,31,3,0,0
7752,Wolfson Campus,ISS 1120 - 0061   The Social Environment,0061-LEC Conversion,Staff,34,0,34,0,0
7751,Wolfson Campus,ISS 1120 - 0062   The Social Environment,0062-LEC Conversion,Staff,34,27,7,0,0
7723,Wolfson Campus,ISS 1120 - 0063   The Social Environment,0063-LEC Main Sess,Staff,30,27,3,0,0
7724,Wolfson Campus,ISS 1120 - 0064   The Social Environment,0064-LEC Main Sess,Staff,34,31,3,0,0
7750,Wolfson Campus,ISS 1120 - 0065   The Social Environment,0065-LEC Conversion,Staff,34,0,34,0,0
7749,Wolfson Campus,ISS 1120 - 0066   The Social Environment,0066-LEC Conversion,Staff,34,0,34,0,0
7725,InterAmerican Campus,ISS 1120 - 0067   The Social Environment,0067-LEC Main Sess,Staff,25,11,14,0,0
7726,InterAmerican Campus,ISS 1120 - 0068   The Social Environment,0068-LEC Main Sess,Staff,35,14,21,0,0
7727,InterAmerican Campus,ISS 1120 - 0069   The Social Environment,0069-LEC Main Sess,Staff,37,21,16,0,0
7755,InterAmerican Campus,ISS 1120 - 0070   The Social Environment,0070-LEC 1st Mon Sp,Staff,35,0,35,0,0
7728,Hialeah Campus,ISS 1120 - 0071   The Social Environment,0071-LEC Main Sess,Staff,31,28,3,0,0
7729,Hialeah Campus,ISS 1120 - 0072   The Social Environment,0072-LEC Main Sess,Staff,30,28,2,0,0
7730,Hialeah Campus,ISS 1120 - 0073   The Social Environment,0073-LEC Main Sess,Staff,30,27,3,0,0
7731,Hialeah Campus,ISS 1120 - 0074   The Social Environment,0074-LEC Main Sess,Staff,32,24,8,0,0
7738,Hialeah Campus,ISS 1120 - 0075   The Social Environment,0075-LEC Twelve Wk,Staff,36,23,13,0,0
7733,West Campus,ISS 1120 - 0077   The Social Environment,0077-LEC Main Sess,Staff,35,0,35,0,0
7734,West Campus,ISS 1120 - 0078   The Social Environment,0078-LEC Main Sess,Staff,35,14,21,0,0
7735,West Campus,ISS 1120 - 0079   The Social Environment,0079-LEC Main Sess,Staff,35,0,35,0,0
7736,West Campus,ISS 1120 - 0080   The Social Environment,0080-LEC Main Sess,Staff,35,15,20,0,0
7742,West Campus,ISS 1120 - 0081   The Social Environment,0081-LEC Eight Wk 2,Staff,35,6,29,0,0
7737,West Campus,ISS 1120 - 0082   The Social Environment,0082-LEC Main Sess,Staff,35,0,35,0,0
12755,Kendall Campus,ITA 1120 - 0001   Elementary Italian 1,0001-LEC Main Sess,Staff,25,10,15,0,0
12756,Kendall Campus,ITA 1120 - 0002   Elementary Italian 1,0002-LEC Main Sess,Staff,25,15,10,0,0
12757,Wolfson Campus,ITA 1120 - 0003   Elementary Italian 1,0003-LEC Main Sess,Staff,25,14,11,0,0
12759,Hialeah Campus,ITA 1120 - 0004   Elementary Italian 1,0004-LEC Eight Wk 1,Staff,30,7,23,0,0
12758,West Campus,ITA 1120 - 0005   Elementary Italian 1,0005-LEC Main Sess,Staff,30,0,30,0,0
14852,Kendall Campus,MUN 1120 - 0001   Concert Band,0001-LAB Main Sess,Staff,25,17,8,0,0
14853,Kendall Campus,MUN 1120 - 0002   Concert Band,0002-LAB Main Sess,Staff,50,18,32,0,0
14854,Wolfson Campus,MUN 1120 - 0003   Concert Band,0003-LAB Conversion,Staff,50,8,42,0,0
12399,Wolfson Campus,POR 1120 - 0001   Elementary Portuguese 1,0001-LEC Weekend,Staff,25,17,8,0,0
12398,West Campus,POR 1120 - 0002   Elementary Portuguese 1,0002-LEC Weekend,Staff,35,9,26,0,0
15709,Wolfson Campus,RUS 1120 - 0001   Elementary Russian 1,0001-LEC Eight Wk 1,Staff,5,0,5,0,0
15708,Wolfson Campus,RUS 1120 - 0002   Elementary Russian 1,0002-LEC Eight Wk 1,Staff,5,3,2,0,0
12567,North Campus,SPN 1120 - 0001   Elementary Spanish 1,0001-LEC Eight Wk 1,Staff,28,24,4,0,0
12554,North Campus,SPN 1120 - 0002   Elementary Spanish 1,0002-LEC Main Sess,Staff,30,24,6,0,0
12571,North Campus,SPN 1120 - 0003   Elementary Spanish 1,0003-LEC Eight Wk 1,Staff,29,23,6,0,0
12555,North Campus,SPN 1120 - 0004   Elementary Spanish 1,0004-LEC Main Sess,Staff,29,25,4,0,0
12563,North Campus,SPN 1120 - 0005   Elementary Spanish 1,0005-LEC Main Sess,Staff,29,20,9,0,0
12556,North Campus,SPN 1120 - 0006   Elementary Spanish 1,0006-LEC Main Sess,Staff,28,21,7,0,0
12570,North Campus,SPN 1120 - 0007   Elementary Spanish 1,0007-LEC Eight Wk 1,Staff,28,22,6,0,0
12564,Kendall Campus,SPN 1120 - 0008   Elementary Spanish 1,0008-LEC Main Sess,Staff,25,22,3,0,0
12569,Kendall Campus,SPN 1120 - 0009   Elementary Spanish 1,0009-LEC Eight Wk 1,Staff,25,15,10,0,0
12565,Kendall Campus,SPN 1120 - 0010   Elementary Spanish 1,0010-LEC Main Sess,Staff,25,10,15,0,0
12566,Kendall Campus,SPN 1120 - 0011   Elementary Spanish 1,0011-LEC Main Sess,Staff,25,0,25,0,0
12574,Kendall Campus,SPN 1120 - 0012   Elementary Spanish 1,0012-LEC Weekend,Staff,25,9,16,0,0
12562,Kendall Campus,SPN 1120 - 0013   Elementary Spanish 1,0013-LEC Main Sess,Staff,25,21,4,0,0
12568,Wolfson Campus,SPN 1120 - 0014   Elementary Spanish 1,0014-LEC Eight Wk 1,Staff,30,17,13,0,0
12572,Wolfson Campus,SPN 1120 - 0015   Elementary Spanish 1,0015-LEC Eight Wk 1,Staff,30,23,7,0,0
12561,Wolfson Campus,SPN 1120 - 0016   Elementary Spanish 1,0016-LEC Main Sess,Staff,30,27,3,0,0
12573,Wolfson Campus,SPN 1120 - 0017   Elementary Spanish 1,0017-LEC Weekend,Staff,30,0,30,0,0
12560,Homestead Campus,SPN 1120 - 0018   Elementary Spanish 1,0018-LEC Main Sess,Staff,30,17,13,0,0
12559,Homestead Campus,SPN 1120 - 0019   Elementary Spanish 1,0019-LEC Main Sess,Staff,30,17,13,0,0
12558,InterAmerican Campus,SPN 1120 - 0020   Elementary Spanish 1,0020-LEC Main Sess,Staff,30,14,16,0,0
12557,West Campus,SPN 1120 - 0021   Elementary Spanish 1,0021-LEC Main Sess,Staff,30,0,30,0,0
9686,North Campus,TPP 1120 - 0001   Improvisation Ensemble,0001-LEC Main Sess,Staff,15,8,7,0,0
9685,North Campus,TPP 1120 - 0002   Improvisation Ensemble,0002-LEC Main Sess,Staff,15,0,15,0,0
9688,Wolfson Campus,TPP 1120 - 0003   Improvisation Ensemble,0003-LEC Conversion,Staff,25,5,20,0,0
9689,Wolfson Campus,TPP 1120 - 0004   Improvisation Ensemble,0004-LEC Conversion,Staff,25,6,19,0,0
9687,Wolfson Campus,TPP 1120 - 0005   Improvisation Ensemble,0005-LEC Conversion,Staff,40,13,27,0,0
6329,North Campus,EMS 1119L - 0001   Emergency Medical Technician Lab And Clinic,0001-LAB Main Sess,Staff,6,0,6,0,0
6332,North Campus,EMS 1119L - 0003   Emergency Medical Technician Lab And Clinic,0003-LAB Main Sess,Staff,6,0,6,0,0
6335,North Campus,EMS 1119L - 0004   Emergency Medical Technician Lab And Clinic,0004-LAB Main Sess,Staff,6,0,6,0,0
6337,Medical Campus,EMS 1119L - 0013   Emergency Medical Technician Lab And Clinic,0013-LAB Conversion,Staff,6,5,1,0,0
8680,North Campus,ARC 1115 - 0001   Architectural Communications 1,0001-LEC Main Sess,Staff,20,19,1,0,0
8681,Kendall Campus,ARC 1115 - 0002   Architectural Communications 1,0002-LEC Main Sess,Staff,20,19,1,0,0
8685,Kendall Campus,ARC 1115 - 0003   Architectural Communications 1,0003-LEC Main Sess,Staff,20,18,2,0,0
8684,Wolfson Campus,ARC 1115 - 0005   Architectural Communications 1,0005-LEC Main Sess,Staff,20,11,9,0,0
8682,Wolfson Campus,ARC 1115 - 0006   Architectural Communications 1,0006-LEC Main Sess,Staff,20,18,2,0,0
11341,North Campus,MAC 1114 - 0001   Trigonometry,0001-LEC Main Sess,Staff,40,35,5,0,0
11342,North Campus,MAC 1114 - 0002   Trigonometry,0002-LEC Main Sess,Staff,40,36,4,0,0
11345,North Campus,MAC 1114 - 0003   Trigonometry,0003-LEC Main Sess,Staff,35,31,4,0,0
11361,North Campus,MAC 1114 - 0004   Trigonometry,0004-LEC Eight Wk 2,Staff,30,16,14,0,0
11346,Kendall Campus,MAC 1114 - 0005   Trigonometry,0005-LEC Main Sess,Staff,42,40,2,0,0
11347,Kendall Campus,MAC 1114 - 0006   Trigonometry,0006-LEC Main Sess,Staff,49,46,3,0,0
11348,Kendall Campus,MAC 1114 - 0007   Trigonometry,0007-LEC Main Sess,Staff,45,42,3,0,0
11349,Kendall Campus,MAC 1114 - 0008   Trigonometry,0008-LEC Main Sess,Staff,45,23,22,0,0
11351,Kendall Campus,MAC 1114 - 0010   Trigonometry,0010-LEC Main Sess,Staff,38,0,38,0,0
11352,Kendall Campus,MAC 1114 - 0011   Trigonometry,0011-LEC Main Sess,Staff,39,32,7,0,0
11353,Wolfson Campus,MAC 1114 - 0012   Trigonometry,0012-LEC Main Sess,Staff,35,20,15,0,0
11354,Wolfson Campus,MAC 1114 - 0013   Trigonometry,0013-LEC Main Sess,Staff,1,0,1,0,0
11355,Wolfson Campus,MAC 1114 - 0014   Trigonometry,0014-LEC Main Sess,Staff,38,37,1,0,0
11356,Wolfson Campus,MAC 1114 - 0015   Trigonometry,0015-LEC Main Sess,Staff,38,35,3,0,0
11357,Wolfson Campus,MAC 1114 - 0016   Trigonometry,0016-LEC Main Sess,Staff,38,36,2,0,0
11358,Wolfson Campus,MAC 1114 - 0017   Trigonometry,0017-LEC Main Sess,Staff,30,20,10,0,0
11359,Wolfson Campus,MAC 1114 - 0018   Trigonometry,0018-LEC Main Sess,Staff,30,23,7,0,0
11360,Homestead Campus,MAC 1114 - 0019   Trigonometry,0019-LEC Main Sess,Staff,35,31,4,0,0
11344,InterAmerican Campus,MAC 1114 - 0020   Trigonometry,0020-LEC Main Sess,Staff,35,0,35,0,0
11362,InterAmerican Campus,MAC 1114 - 0021   Trigonometry,0021-LEC Conversion,Staff,35,22,13,0,0
11343,InterAmerican Campus,MAC 1114 - 0022   Trigonometry,0022-LEC Main Sess,Staff,30,29,1,0,0
11363,InterAmerican Campus,MAC 1114 - 0023   Trigonometry,0023-LEC 1st Mon Sp,Staff,30,27,3,0,0
10322,North Campus,ENC 1113 - 0005   Writing Skills Review,0005-LEC Conversion,Staff,30,0,30,0,0
10323,North Campus,ENC 1113 - 0006   Writing Skills Review,0006-LEC Conversion,Staff,1,0,1,0,0
10328,North Campus,ENC 1113 - 0007   Writing Skills Review,0007-LEC Conversion,Staff,1,0,1,0,0
10327,North Campus,ENC 1113 - 0008   Writing Skills Review,0008-LEC Conversion,Staff,1,0,1,0,0
10317,Wolfson Campus,ENC 1113 - 0009   Writing Skills Review,0009-LEC Twelve Wk,Staff,10,0,10,0,0
10316,Wolfson Campus,ENC 1113 - 0010   Writing Skills Review,0010-LEC Twelve Wk,Staff,25,0,25,0,0
10319,InterAmerican Campus,ENC 1113 - 0011   Writing Skills Review,0011-LEC Eight Wk 2,Staff,25,15,10,0,0
10318,InterAmerican Campus,ENC 1113 - 0012   Writing Skills Review,0012-LEC Eight Wk 1,Staff,20,6,14,0,0
10326,InterAmerican Campus,ENC 1113 - 0013   Writing Skills Review,0013-LEC Conversion,Staff,35,34,1,0,0
11321,Wolfson Campus,ENC 1112 - 0001   Essential Elements Of English Grammar,0001-LEC Twelve Wk,Staff,10,3,7,0,0
14859,North Campus,MUT 1112 - 0001   Theory 2,0001-LEC Main Sess,Staff,10,6,4,0,0
14860,Kendall Campus,MUT 1112 - 0002   Theory 2,0002-LEC Main Sess,Staff,21,17,4,0,0
14861,Kendall Campus,MUT 1112 - 0003   Theory 2,0003-LEC Main Sess,Staff,25,12,13,0,0
14862,Wolfson Campus,MUT 1112 - 0004   Theory 2,0004-LEC Main Sess,Staff,15,14,1,0,0
14864,Wolfson Campus,MUT 1112 - 0005   Theory 2,0005-LEC Conversion,Staff,50,14,36,0,0
14863,Wolfson Campus,MUT 1112 - 0006   Theory 2,0006-LEC Main Sess,Staff,25,10,15,0,0
14865,Wolfson Campus,MUT 1112 - 0007   Theory 2,0007-LEC Conversion,Staff,50,17,33,0,0
12289,North Campus,MVK 1112 - 0001   Class Piano 2,0001-LAB Eight Wk 2,Staff,20,17,3,0,0
12282,Kendall Campus,MVK 1112 - 0002   Class Piano 2,0002-LAB Main Sess,Staff,12,11,1,0,0
12283,Kendall Campus,MVK 1112 - 0003   Class Piano 2,0003-LAB Main Sess,Staff,12,8,4,0,0
12284,Kendall Campus,MVK 1112 - 0004   Class Piano 2,0004-LAB Main Sess,Staff,12,8,4,0,0
12285,Wolfson Campus,MVK 1112 - 0005   Class Piano 2,0005-LAB Main Sess,Staff,5,4,1,0,0
12286,Wolfson Campus,MVK 1112 - 0006   Class Piano 2,0006-LAB Main Sess,Staff,5,0,5,0,0
12287,Wolfson Campus,MVK 1112 - 0007   Class Piano 2,0007-LAB Main Sess,Staff,15,12,3,0,0
6868,Kendall Campus,AFR 1111 - 0001   Introduction To The United States Air Force - Part 3 Sem Basic Air Force Rotc,0001-LEC Main Sess,Staff,20,6,14,0,0
8534,Wolfson Campus,CTS 1111 - 0001   Linux +,0001-LEC Main Sess,Staff,22,0,22,0,0
6852,Wolfson Campus,DIG 1111 - 0001   Digital Character Design,0001-LEC Main Sess,Staff,27,26,1,0,0
6851,Wolfson Campus,DIG 1111 - 0002   Digital Character Design,0002-LEC Main Sess,Staff,27,26,1,0,0
10435,North Campus,MUT 1111 - 0002   Theory 1,0002-LEC Main Sess,Staff,20,14,6,0,0
10436,Kendall Campus,MUT 1111 - 0003   Theory 1,0003-LEC Main Sess,Staff,25,8,17,0,0
10441,Kendall Campus,MUT 1111 - 0004   Theory 1,0004-LEC Main Sess,Staff,16,11,5,0,0
10440,Kendall Campus,MUT 1111 - 0007   Theory 1,0007-LEC Main Sess,Staff,16,13,3,0,0
16398,Kendall Campus,MVK 1111 - 0003   Class Piano 1,0003-LAB Main Sess,Staff,12,11,1,0,0
16399,Kendall Campus,MVK 1111 - 0004   Class Piano 1,0004-LAB Main Sess,Staff,12,10,2,0,0
16400,Kendall Campus,MVK 1111 - 0005   Class Piano 1,0005-LAB Main Sess,Staff,12,0,12,0,0
16401,Kendall Campus,MVK 1111 - 0006   Class Piano 1,0006-LAB Main Sess,Staff,12,11,1,0,0
16402,Kendall Campus,MVK 1111 - 0007   Class Piano 1,0007-LAB Main Sess,Staff,12,9,3,0,0
16403,Wolfson Campus,MVK 1111 - 0008   Class Piano 1,0008-LAB Main Sess,Staff,12,0,12,0,0
16404,Wolfson Campus,MVK 1111 - 0009   Class Piano 1,0009-LAB Main Sess,Staff,12,4,8,0,0
16405,Wolfson Campus,MVK 1111 - 0010   Class Piano 1,0010-LAB Main Sess,Staff,12,8,4,0,0
14885,Wolfson Campus,MVV 1111 - 0001   Voice Class,0001-LAB Main Sess,Staff,5,0,5,0,0
12226,Medical Campus,HIM 1110 - 0001   Health Information Technology And Data Collection,0001-LEC Conversion,Staff,30,8,22,0,0
12577,Wolfson Campus,TPP 1110 - 0001   Acting 1,0001-LEC Main Sess,Staff,30,13,17,0,0
12578,Wolfson Campus,TPP 1110 - 0002   Acting 1,0002-LEC Main Sess,Staff,30,14,16,0,0
12579,Homestead Campus,TPP 1110 - 0003   Acting 1,0003-LEC Eight Wk 2,Staff,30,0,30,0,0
8425,Medical Campus,HIM 1110L - 0001   Health Information Management Data Collection Lab,0001-LAB Conversion,Staff,30,8,22,0,0
10343,North Campus,MGF 1107 - 0001   Mathematics For Liberal Arts 2,0001-LEC Main Sess,Staff,30,29,1,0,0
10344,North Campus,MGF 1107 - 0002   Mathematics For Liberal Arts 2,0002-LEC Main Sess,Staff,35,33,2,0,0
10372,North Campus,MGF 1107 - 0003   Mathematics For Liberal Arts 2,0003-LEC Eight Wk 2,Staff,40,18,22,0,0
10351,North Campus,MGF 1107 - 0004   Mathematics For Liberal Arts 2,0004-LEC Main Sess,Staff,40,37,3,0,0
10352,North Campus,MGF 1107 - 0005   Mathematics For Liberal Arts 2,0005-LEC Main Sess,Staff,35,33,2,0,0
10371,North Campus,MGF 1107 - 0006   Mathematics For Liberal Arts 2,0006-LEC Twelve Wk,Staff,35,19,16,0,0
10353,North Campus,MGF 1107 - 0007   Mathematics For Liberal Arts 2,0007-LEC Main Sess,Staff,35,0,35,0,0
10354,Kendall Campus,MGF 1107 - 0008   Mathematics For Liberal Arts 2,0008-LEC Main Sess,Staff,39,0,39,0,0
10374,Kendall Campus,MGF 1107 - 0009   Mathematics For Liberal Arts 2,0009-LEC Eight Wk 2,Staff,45,37,8,0,0
10355,Kendall Campus,MGF 1107 - 0010   Mathematics For Liberal Arts 2,0010-LEC Main Sess,Staff,45,38,7,0,0
10356,Kendall Campus,MGF 1107 - 0011   Mathematics For Liberal Arts 2,0011-LEC Main Sess,Staff,40,39,1,0,0
10373,Kendall Campus,MGF 1107 - 0012   Mathematics For Liberal Arts 2,0012-LEC Eight Wk 2,Staff,40,0,40,0,0
10358,Kendall Campus,MGF 1107 - 0014   Mathematics For Liberal Arts 2,0014-LEC Main Sess,Staff,39,32,7,0,0
10361,Wolfson Campus,MGF 1107 - 0017   Mathematics For Liberal Arts 2,0017-LEC Main Sess,Staff,38,35,3,0,0
10363,Wolfson Campus,MGF 1107 - 0019   Mathematics For Liberal Arts 2,0019-LEC Main Sess,Staff,30,29,1,0,0
10364,Wolfson Campus,MGF 1107 - 0020   Mathematics For Liberal Arts 2,0020-LEC Main Sess,Staff,30,29,1,0,0
10365,Wolfson Campus,MGF 1107 - 0021   Mathematics For Liberal Arts 2,0021-LEC Main Sess,Staff,30,27,3,0,0
10366,Wolfson Campus,MGF 1107 - 0022   Mathematics For Liberal Arts 2,0022-LEC Main Sess,Staff,30,28,2,0,0
10367,Homestead Campus,MGF 1107 - 0023   Mathematics For Liberal Arts 2,0023-LEC Main Sess,Staff,35,27,8,0,0
10377,Homestead Campus,MGF 1107 - 0024   Mathematics For Liberal Arts 2,0024-LEC Conversion,Staff,35,0,35,0,0
10376,Homestead Campus,MGF 1107 - 0025   Mathematics For Liberal Arts 2,0025-LEC Conversion,Staff,30,22,8,0,0
10368,InterAmerican Campus,MGF 1107 - 0026   Mathematics For Liberal Arts 2,0026-LEC Main Sess,Staff,35,34,1,0,0
10369,InterAmerican Campus,MGF 1107 - 0027   Mathematics For Liberal Arts 2,0027-LEC Main Sess,Staff,30,0,30,0,0
10370,Hialeah Campus,MGF 1107 - 0028   Mathematics For Liberal Arts 2,0028-LEC Main Sess,Staff,38,35,3,0,0
10350,Hialeah Campus,MGF 1107 - 0029   Mathematics For Liberal Arts 2,0029-LEC Main Sess,Staff,38,0,38,0,0
10349,Hialeah Campus,MGF 1107 - 0030   Mathematics For Liberal Arts 2,0030-LEC Main Sess,Staff,38,22,16,0,0
10348,Hialeah Campus,MGF 1107 - 0031   Mathematics For Liberal Arts 2,0031-LEC Main Sess,Staff,31,0,31,0,0
10347,Hialeah Campus,MGF 1107 - 0032   Mathematics For Liberal Arts 2,0032-LEC Main Sess,Staff,40,35,5,0,0
10346,West Campus,MGF 1107 - 0033   Mathematics For Liberal Arts 2,0033-LEC Main Sess,Staff,35,13,22,0,0
10375,West Campus,MGF 1107 - 0035   Mathematics For Liberal Arts 2,0035-LEC Eight Wk 2,Staff,30,0,30,0,0
12838,North Campus,MGF 1106 - 0001   Mathematics For Liberal Arts 1,0001-LEC Main Sess,Staff,40,37,3,0,0
12839,North Campus,MGF 1106 - 0002   Mathematics For Liberal Arts 1,0002-LEC Main Sess,Staff,34,33,1,0,0
12881,North Campus,MGF 1106 - 0003   Mathematics For Liberal Arts 1,0003-LEC Eight Wk 1,Staff,40,9,31,0,0
12883,North Campus,MGF 1106 - 0004   Mathematics For Liberal Arts 1,0004-LEC Eight Wk 2,Staff,30,0,30,0,0
12884,North Campus,MGF 1106 - 0005   Mathematics For Liberal Arts 1,0005-LEC Eight Wk 2,Staff,30,0,30,0,0
12885,North Campus,MGF 1106 - 0006   Mathematics For Liberal Arts 1,0006-LEC Eight Wk 2,Staff,30,0,30,0,0
12844,North Campus,MGF 1106 - 0007   Mathematics For Liberal Arts 1,0007-LEC Main Sess,Staff,34,29,5,0,0
12879,North Campus,MGF 1106 - 0008   Mathematics For Liberal Arts 1,0008-LEC Twelve Wk,Staff,30,27,3,0,0
12886,North Campus,MGF 1106 - 0009   Mathematics For Liberal Arts 1,0009-LEC Eight Wk 2,Staff,30,16,14,0,0
12845,North Campus,MGF 1106 - 0010   Mathematics For Liberal Arts 1,0010-LEC Main Sess,Staff,40,18,22,0,0
12950,North Campus,MGF 1106 - 0011   Mathematics For Liberal Arts 1,0011-LEC 1st Mon Sp,Staff,40,14,26,0,0
12887,North Campus,MGF 1106 - 0012   Mathematics For Liberal Arts 1,0012-LEC Eight Wk 2,Staff,24,22,2,0,0
12888,North Campus,MGF 1106 - 0013   Mathematics For Liberal Arts 1,0013-LEC Eight Wk 2,Staff,30,11,19,0,0
12889,North Campus,MGF 1106 - 0014   Mathematics For Liberal Arts 1,0014-LEC Eight Wk 2,Staff,30,0,30,0,0
12890,North Campus,MGF 1106 - 0015   Mathematics For Liberal Arts 1,0015-LEC Eight Wk 2,Staff,30,22,8,0,0
12891,North Campus,MGF 1106 - 0016   Mathematics For Liberal Arts 1,0016-LEC Eight Wk 2,Staff,30,0,30,0,0
12892,North Campus,MGF 1106 - 0017   Mathematics For Liberal Arts 1,0017-LEC Eight Wk 2,Staff,30,15,15,0,0
12893,North Campus,MGF 1106 - 0018   Mathematics For Liberal Arts 1,0018-LEC Eight Wk 2,Staff,30,24,6,0,0
12894,North Campus,MGF 1106 - 0019   Mathematics For Liberal Arts 1,0019-LEC Eight Wk 2,Staff,30,18,12,0,0
12895,North Campus,MGF 1106 - 0020   Mathematics For Liberal Arts 1,0020-LEC Eight Wk 2,Staff,30,17,13,0,0
12896,North Campus,MGF 1106 - 0021   Mathematics For Liberal Arts 1,0021-LEC Eight Wk 2,Staff,30,22,8,0,0
12897,North Campus,MGF 1106 - 0022   Mathematics For Liberal Arts 1,0022-LEC Eight Wk 2,Staff,30,0,30,0,0
12898,North Campus,MGF 1106 - 0023   Mathematics For Liberal Arts 1,0023-LEC Eight Wk 2,Staff,30,15,15,0,0
12899,North Campus,MGF 1106 - 0024   Mathematics For Liberal Arts 1,0024-LEC Eight Wk 2,Staff,35,20,15,0,0
12900,North Campus,MGF 1106 - 0025   Mathematics For Liberal Arts 1,0025-LEC Eight Wk 2,Staff,30,0,30,0,0
12878,North Campus,MGF 1106 - 0026   Mathematics For Liberal Arts 1,0026-LEC Twelve Wk,Staff,40,30,10,0,0
12901,North Campus,MGF 1106 - 0027   Mathematics For Liberal Arts 1,0027-LEC Eight Wk 2,Staff,30,0,30,0,0
12902,North Campus,MGF 1106 - 0028   Mathematics For Liberal Arts 1,0028-LEC Eight Wk 2,Staff,30,13,17,0,0
12846,Kendall Campus,MGF 1106 - 0029   Mathematics For Liberal Arts 1,0029-LEC Main Sess,Staff,40,39,1,0,0
12847,Kendall Campus,MGF 1106 - 0030   Mathematics For Liberal Arts 1,0030-LEC Main Sess,Staff,39,27,12,0,0
12848,Kendall Campus,MGF 1106 - 0031   Mathematics For Liberal Arts 1,0031-LEC Main Sess,Staff,40,36,4,0,0
12849,Kendall Campus,MGF 1106 - 0032   Mathematics For Liberal Arts 1,0032-LEC Main Sess,Staff,40,34,6,0,0
12903,Kendall Campus,MGF 1106 - 0034   Mathematics For Liberal Arts 1,0034-LEC Eight Wk 2,Staff,32,22,10,0,0
12904,Kendall Campus,MGF 1106 - 0035   Mathematics For Liberal Arts 1,0035-LEC Eight Wk 2,Staff,32,18,14,0,0
12905,Kendall Campus,MGF 1106 - 0036   Mathematics For Liberal Arts 1,0036-LEC Eight Wk 2,Staff,32,26,6,0,0
12851,Kendall Campus,MGF 1106 - 0038   Mathematics For Liberal Arts 1,0038-LEC Main Sess,Staff,40,39,1,0,0
12951,Kendall Campus,MGF 1106 - 0039   Mathematics For Liberal Arts 1,0039-LEC Weekend,Staff,30,0,30,0,0
12906,Kendall Campus,MGF 1106 - 0040   Mathematics For Liberal Arts 1,0040-LEC Eight Wk 2,Staff,30,0,30,0,0
12907,Kendall Campus,MGF 1106 - 0041   Mathematics For Liberal Arts 1,0041-LEC Eight Wk 2,Staff,32,0,32,0,0
12908,Kendall Campus,MGF 1106 - 0042   Mathematics For Liberal Arts 1,0042-LEC Eight Wk 2,Staff,32,19,13,0,0
12909,Kendall Campus,MGF 1106 - 0043   Mathematics For Liberal Arts 1,0043-LEC Eight Wk 2,Staff,32,22,10,0,0
12910,Kendall Campus,MGF 1106 - 0044   Mathematics For Liberal Arts 1,0044-LEC Eight Wk 2,Staff,30,0,30,0,0
12852,Kendall Campus,MGF 1106 - 0045   Mathematics For Liberal Arts 1,0045-LEC Main Sess,Staff,39,35,4,0,0
12853,Kendall Campus,MGF 1106 - 0046   Mathematics For Liberal Arts 1,0046-LEC Main Sess,Staff,40,32,8,0,0
12855,Kendall Campus,MGF 1106 - 0048   Mathematics For Liberal Arts 1,0048-LEC Main Sess,Staff,39,26,13,0,0
12880,Kendall Campus,MGF 1106 - 0049   Mathematics For Liberal Arts 1,0049-LEC Eight Wk 1,Staff,40,0,40,0,0
12911,Kendall Campus,MGF 1106 - 0050   Mathematics For Liberal Arts 1,0050-LEC Eight Wk 2,Staff,32,28,4,0,0
12912,Kendall Campus,MGF 1106 - 0051   Mathematics For Liberal Arts 1,0051-LEC Eight Wk 2,Staff,32,0,32,0,0
12913,Kendall Campus,MGF 1106 - 0052   Mathematics For Liberal Arts 1,0052-LEC Eight Wk 2,Staff,32,0,32,0,0
12914,Kendall Campus,MGF 1106 - 0053   Mathematics For Liberal Arts 1,0053-LEC Eight Wk 2,Staff,32,0,32,0,0
12915,Kendall Campus,MGF 1106 - 0054   Mathematics For Liberal Arts 1,0054-LEC Eight Wk 2,Staff,30,0,30,0,0
12916,Kendall Campus,MGF 1106 - 0055   Mathematics For Liberal Arts 1,0055-LEC Eight Wk 2,Staff,30,25,5,0,0
12856,Kendall Campus,MGF 1106 - 0056   Mathematics For Liberal Arts 1,0056-LEC Main Sess,Staff,39,32,7,0,0
12857,Kendall Campus,MGF 1106 - 0057   Mathematics For Liberal Arts 1,0057-LEC Main Sess,Staff,40,38,2,0,0
12858,Kendall Campus,MGF 1106 - 0058   Mathematics For Liberal Arts 1,0058-LEC Main Sess,Staff,38,37,1,0,0
12917,Kendall Campus,MGF 1106 - 0059   Mathematics For Liberal Arts 1,0059-LEC Eight Wk 2,Staff,32,22,10,0,0
12918,Kendall Campus,MGF 1106 - 0060   Mathematics For Liberal Arts 1,0060-LEC Eight Wk 2,Staff,32,30,2,0,0
12919,Kendall Campus,MGF 1106 - 0061   Mathematics For Liberal Arts 1,0061-LEC Eight Wk 2,Staff,32,11,21,0,0
12920,Kendall Campus,MGF 1106 - 0062   Mathematics For Liberal Arts 1,0062-LEC Eight Wk 2,Staff,30,0,30,0,0
12921,Kendall Campus,MGF 1106 - 0063   Mathematics For Liberal Arts 1,0063-LEC Eight Wk 2,Staff,32,0,32,0,0
12922,Kendall Campus,MGF 1106 - 0064   Mathematics For Liberal Arts 1,0064-LEC Eight Wk 2,Staff,32,0,32,0,0
12923,Kendall Campus,MGF 1106 - 0065   Mathematics For Liberal Arts 1,0065-LEC Eight Wk 2,Staff,32,17,15,0,0
12924,Wolfson Campus,MGF 1106 - 0067   Mathematics For Liberal Arts 1,0067-LEC Eight Wk 2,Staff,38,0,38,0,0
12925,Wolfson Campus,MGF 1106 - 0068   Mathematics For Liberal Arts 1,0068-LEC Eight Wk 2,Staff,41,0,41,0,0
12926,Wolfson Campus,MGF 1106 - 0069   Mathematics For Liberal Arts 1,0069-LEC Eight Wk 2,Staff,41,24,17,0,0
12860,Wolfson Campus,MGF 1106 - 0070   Mathematics For Liberal Arts 1,0070-LEC Main Sess,Staff,35,30,5,0,0
12861,Wolfson Campus,MGF 1106 - 0071   Mathematics For Liberal Arts 1,0071-LEC Main Sess,Staff,35,33,2,0,0
12927,Wolfson Campus,MGF 1106 - 0072   Mathematics For Liberal Arts 1,0072-LEC Eight Wk 2,Staff,41,0,41,0,0
12928,Wolfson Campus,MGF 1106 - 0073   Mathematics For Liberal Arts 1,0073-LEC Eight Wk 2,Staff,2,0,2,0,0
12862,Wolfson Campus,MGF 1106 - 0074   Mathematics For Liberal Arts 1,0074-LEC Main Sess,Staff,35,34,1,0,0
12929,Wolfson Campus,MGF 1106 - 0076   Mathematics For Liberal Arts 1,0076-LEC Eight Wk 2,Staff,41,35,6,0,0
12930,Wolfson Campus,MGF 1106 - 0077   Mathematics For Liberal Arts 1,0077-LEC Eight Wk 2,Staff,38,0,38,0,0
12931,Wolfson Campus,MGF 1106 - 0078   Mathematics For Liberal Arts 1,0078-LEC Eight Wk 2,Staff,41,39,2,0,0
12932,Wolfson Campus,MGF 1106 - 0079   Mathematics For Liberal Arts 1,0079-LEC Eight Wk 2,Staff,40,23,17,0,0
12933,Wolfson Campus,MGF 1106 - 0080   Mathematics For Liberal Arts 1,0080-LEC Eight Wk 2,Staff,41,32,9,0,0
12934,Wolfson Campus,MGF 1106 - 0081   Mathematics For Liberal Arts 1,0081-LEC Eight Wk 2,Staff,35,29,6,0,0
12864,Wolfson Campus,MGF 1106 - 0082   Mathematics For Liberal Arts 1,0082-LEC Main Sess,Staff,30,28,2,0,0
12865,Wolfson Campus,MGF 1106 - 0083   Mathematics For Liberal Arts 1,0083-LEC Main Sess,Staff,30,24,6,0,0
12867,Wolfson Campus,MGF 1106 - 0085   Mathematics For Liberal Arts 1,0085-LEC Main Sess,Staff,30,29,1,0,0
12868,Wolfson Campus,MGF 1106 - 0086   Mathematics For Liberal Arts 1,0086-LEC Main Sess,Staff,30,26,4,0,0
12869,Wolfson Campus,MGF 1106 - 0087   Mathematics For Liberal Arts 1,0087-LEC Main Sess,Staff,30,26,4,0,0
12870,Wolfson Campus,MGF 1106 - 0088   Mathematics For Liberal Arts 1,0088-LEC Main Sess,Staff,30,26,4,0,0
12871,Wolfson Campus,MGF 1106 - 0089   Mathematics For Liberal Arts 1,0089-LEC Main Sess,Staff,30,27,3,0,0
12872,Homestead Campus,MGF 1106 - 0090   Mathematics For Liberal Arts 1,0090-LEC Main Sess,Staff,1,0,1,0,0
12935,Homestead Campus,MGF 1106 - 0091   Mathematics For Liberal Arts 1,0091-LEC Eight Wk 2,Staff,35,26,9,0,0
12936,Homestead Campus,MGF 1106 - 0092   Mathematics For Liberal Arts 1,0092-LEC Eight Wk 2,Staff,35,0,35,0,0
12873,Homestead Campus,MGF 1106 - 0093   Mathematics For Liberal Arts 1,0093-LEC Main Sess,Staff,35,34,1,0,0
12874,Homestead Campus,MGF 1106 - 0094   Mathematics For Liberal Arts 1,0094-LEC Main Sess,Staff,39,0,39,0,0
12937,Homestead Campus,MGF 1106 - 0095   Mathematics For Liberal Arts 1,0095-LEC Eight Wk 2,Staff,35,21,14,0,0
12949,Homestead Campus,MGF 1106 - 0096   Mathematics For Liberal Arts 1,0096-LEC Conversion,Staff,30,15,15,0,0
12938,InterAmerican Campus,MGF 1106 - 0097   Mathematics For Liberal Arts 1,0097-LEC Eight Wk 2,Staff,30,23,7,0,0
12939,InterAmerican Campus,MGF 1106 - 0098   Mathematics For Liberal Arts 1,0098-LEC Eight Wk 2,Staff,30,0,30,0,0
12875,InterAmerican Campus,MGF 1106 - 0099   Mathematics For Liberal Arts 1,0099-LEC Main Sess,Staff,37,21,16,0,0
12940,InterAmerican Campus,MGF 1106 - 0100   Mathematics For Liberal Arts 1,0100-LEC Eight Wk 2,Staff,30,0,30,0,0
12876,InterAmerican Campus,MGF 1106 - 0101   Mathematics For Liberal Arts 1,0101-LEC Main Sess,Staff,30,17,13,0,0
12877,InterAmerican Campus,MGF 1106 - 0102   Mathematics For Liberal Arts 1,0102-LEC Main Sess,Staff,30,24,6,0,0
12843,Hialeah Campus,MGF 1106 - 0103   Mathematics For Liberal Arts 1,0103-LEC Main Sess,Staff,35,30,5,0,0
12842,Hialeah Campus,MGF 1106 - 0104   Mathematics For Liberal Arts 1,0104-LEC Main Sess,Staff,36,25,11,0,0
12941,Hialeah Campus,MGF 1106 - 0105   Mathematics For Liberal Arts 1,0105-LEC Eight Wk 2,Staff,30,0,30,0,0
12841,Hialeah Campus,MGF 1106 - 0106   Mathematics For Liberal Arts 1,0106-LEC Main Sess,Staff,40,35,5,0,0
12942,Hialeah Campus,MGF 1106 - 0107   Mathematics For Liberal Arts 1,0107-LEC Eight Wk 2,Staff,30,24,6,0,0
12840,Hialeah Campus,MGF 1106 - 0108   Mathematics For Liberal Arts 1,0108-LEC Main Sess,Staff,36,28,8,0,0
12944,Hialeah Campus,MGF 1106 - 0110   Mathematics For Liberal Arts 1,0110-LEC Eight Wk 2,Staff,30,28,2,0,0
12882,West Campus,MGF 1106 - 0111   Mathematics For Liberal Arts 1,0111-LEC Eight Wk 1,Staff,35,31,4,0,0
12945,West Campus,MGF 1106 - 0112   Mathematics For Liberal Arts 1,0112-LEC Eight Wk 2,Staff,35,18,17,0,0
12946,West Campus,MGF 1106 - 0113   Mathematics For Liberal Arts 1,0113-LEC Eight Wk 2,Staff,30,9,21,0,0
12947,West Campus,MGF 1106 - 0114   Mathematics For Liberal Arts 1,0114-LEC Eight Wk 2,Staff,35,18,17,0,0
12948,West Campus,MGF 1106 - 0115   Mathematics For Liberal Arts 1,0115-LEC Eight Wk 2,Staff,30,14,16,0,0
12484,North Campus,SLS 1106 - 0001   First Year Experience Seminar,0001-LEC Eight Wk 2,Staff,35,23,12,0,0
12503,North Campus,SLS 1106 - 0002   First Year Experience Seminar,0002-LEC Eight Wk 2,Staff,35,33,2,0,0
12544,North Campus,SLS 1106 - 0003   First Year Experience Seminar,0003-LEC Conversion,Staff,35,27,8,0,0
12545,North Campus,SLS 1106 - 0004   First Year Experience Seminar,0004-LEC Conversion,Staff,35,0,35,0,0
12479,North Campus,SLS 1106 - 0005   First Year Experience Seminar,0005-LEC Eight Wk 1,Staff,35,31,4,0,0
12486,North Campus,SLS 1106 - 0006   First Year Experience Seminar,0006-LEC Eight Wk 2,Staff,35,26,9,0,0
12487,North Campus,SLS 1106 - 0007   First Year Experience Seminar,0007-LEC Eight Wk 2,Staff,35,34,1,0,0
12478,North Campus,SLS 1106 - 0008   First Year Experience Seminar,0008-LEC Eight Wk 1,Staff,35,33,2,0,0
12488,North Campus,SLS 1106 - 0009   First Year Experience Seminar,0009-LEC Eight Wk 2,Staff,35,17,18,0,0
12477,North Campus,SLS 1106 - 0010   First Year Experience Seminar,0010-LEC Eight Wk 1,Staff,35,31,4,0,0
12476,North Campus,SLS 1106 - 0011   First Year Experience Seminar,0011-LEC Eight Wk 1,Staff,35,32,3,0,0
12537,Kendall Campus,SLS 1106 - 0012   First Year Experience Seminar,0012-LEC Conversion,Staff,30,28,2,0,0
12532,Kendall Campus,SLS 1106 - 0013   First Year Experience Seminar,0013-LEC Conversion,Staff,30,12,18,0,0
12489,Kendall Campus,SLS 1106 - 0015   First Year Experience Seminar,0015-LEC Eight Wk 2,Staff,30,29,1,0,0
12490,Kendall Campus,SLS 1106 - 0016   First Year Experience Seminar,0016-LEC Eight Wk 2,Staff,25,23,2,0,0
12528,Kendall Campus,SLS 1106 - 0017   First Year Experience Seminar,0017-LEC Conversion,Staff,32,29,3,0,0
12529,Kendall Campus,SLS 1106 - 0018   First Year Experience Seminar,0018-LEC Conversion,Staff,25,18,7,0,0
12538,Kendall Campus,SLS 1106 - 0019   First Year Experience Seminar,0019-LEC Conversion,Staff,25,24,1,0,0
12534,Kendall Campus,SLS 1106 - 0021   First Year Experience Seminar,0021-LEC Conversion,Staff,30,8,22,0,0
12530,Kendall Campus,SLS 1106 - 0023   First Year Experience Seminar,0023-LEC Conversion,Staff,25,14,11,0,0
12510,Kendall Campus,SLS 1106 - 0025   First Year Experience Seminar,0025-LEC Conversion,Staff,30,28,2,0,0
12540,Kendall Campus,SLS 1106 - 0027   First Year Experience Seminar,0027-LEC Conversion,Staff,30,29,1,0,0
12531,Kendall Campus,SLS 1106 - 0029   First Year Experience Seminar,0029-LEC Conversion,Staff,30,29,1,0,0
12522,Kendall Campus,SLS 1106 - 0031   First Year Experience Seminar,0031-LEC Conversion,Staff,25,20,5,0,0
12549,Kendall Campus,SLS 1106 - 0032   First Year Experience Seminar,0032-LEC Conversion,Staff,30,0,30,0,0
12512,Kendall Campus,SLS 1106 - 0033   First Year Experience Seminar,0033-LEC Conversion,Staff,28,27,1,0,0
12520,Kendall Campus,SLS 1106 - 0036   First Year Experience Seminar,0036-LEC Conversion,Staff,30,25,5,0,0
12523,Kendall Campus,SLS 1106 - 0037   First Year Experience Seminar,0037-LEC Conversion,Staff,30,28,2,0,0
12524,Kendall Campus,SLS 1106 - 0038   First Year Experience Seminar,0038-LEC Conversion,Staff,30,28,2,0,0
12504,Kendall Campus,SLS 1106 - 0039   First Year Experience Seminar,0039-LEC Conversion,Staff,30,29,1,0,0
12521,Kendall Campus,SLS 1106 - 0040   First Year Experience Seminar,0040-LEC Conversion,Staff,30,28,2,0,0
12515,Kendall Campus,SLS 1106 - 0041   First Year Experience Seminar,0041-LEC Conversion,Staff,30,27,3,0,0
12516,Kendall Campus,SLS 1106 - 0042   First Year Experience Seminar,0042-LEC Conversion,Staff,30,14,16,0,0
12525,Kendall Campus,SLS 1106 - 0043   First Year Experience Seminar,0043-LEC Conversion,Staff,30,18,12,0,0
12508,Wolfson Campus,SLS 1106 - 0044   First Year Experience Seminar,0044-LEC Conversion,Staff,35,31,4,0,0
12509,Wolfson Campus,SLS 1106 - 0045   First Year Experience Seminar,0045-LEC Conversion,Staff,35,0,35,0,0
12526,Wolfson Campus,SLS 1106 - 0046   First Year Experience Seminar,0046-LEC Conversion,Staff,35,33,2,0,0
12505,Wolfson Campus,SLS 1106 - 0047   First Year Experience Seminar,0047-LEC Conversion,Staff,35,0,35,0,0
12547,Wolfson Campus,SLS 1106 - 0048   First Year Experience Seminar,0048-LEC Conversion,Staff,35,34,1,0,0
12527,Wolfson Campus,SLS 1106 - 0049   First Year Experience Seminar,0049-LEC Conversion,Staff,35,30,5,0,0
12536,Wolfson Campus,SLS 1106 - 0050   First Year Experience Seminar,0050-LEC Conversion,Staff,35,29,6,0,0
12507,Wolfson Campus,SLS 1106 - 0051   First Year Experience Seminar,0051-LEC Conversion,Staff,35,24,11,0,0
12550,Wolfson Campus,SLS 1106 - 0052   First Year Experience Seminar,0052-LEC Conversion,Staff,30,29,1,0,0
12548,Wolfson Campus,SLS 1106 - 0054   First Year Experience Seminar,0054-LEC Conversion,Staff,35,22,13,0,0
12518,Wolfson Campus,SLS 1106 - 0055   First Year Experience Seminar,0055-LEC Conversion,Staff,35,34,1,0,0
12506,Wolfson Campus,SLS 1106 - 0056   First Year Experience Seminar,0056-LEC Conversion,Staff,35,12,23,0,0
12475,Homestead Campus,SLS 1106 - 0057   First Year Experience Seminar,0057-LEC Eight Wk 1,Staff,25,13,12,0,0
12541,Homestead Campus,SLS 1106 - 0059   First Year Experience Seminar,0059-LEC Conversion,Staff,30,9,21,0,0
12473,Homestead Campus,SLS 1106 - 0060   First Year Experience Seminar,0060-LEC Eight Wk 1,Staff,30,26,4,0,0
12464,Homestead Campus,SLS 1106 - 0061   First Year Experience Seminar,0061-LEC Eight Wk 1,Staff,30,29,1,0,0
12465,InterAmerican Campus,SLS 1106 - 0063   First Year Experience Seminar,0063-LEC Eight Wk 1,Staff,30,23,7,0,0
12463,InterAmerican Campus,SLS 1106 - 0064   First Year Experience Seminar,0064-LEC Twelve Wk,Staff,25,22,3,0,0
12543,InterAmerican Campus,SLS 1106 - 0065   First Year Experience Seminar,0065-LEC Conversion,Staff,21,14,7,0,0
12462,InterAmerican Campus,SLS 1106 - 0066   First Year Experience Seminar,0066-LEC Twelve Wk,Staff,21,0,21,0,0
12492,InterAmerican Campus,SLS 1106 - 0067   First Year Experience Seminar,0067-LEC Eight Wk 2,Staff,21,20,1,0,0
12493,Hialeah Campus,SLS 1106 - 0068   First Year Experience Seminar,0068-LEC Eight Wk 2,Staff,30,0,30,0,0
12494,Hialeah Campus,SLS 1106 - 0069   First Year Experience Seminar,0069-LEC Eight Wk 2,Staff,30,0,30,0,0
12495,Hialeah Campus,SLS 1106 - 0070   First Year Experience Seminar,0070-LEC Eight Wk 2,Staff,30,0,30,0,0
12467,Hialeah Campus,SLS 1106 - 0072   First Year Experience Seminar,0072-LEC Eight Wk 1,Staff,30,15,15,0,0
12496,Hialeah Campus,SLS 1106 - 0073   First Year Experience Seminar,0073-LEC Eight Wk 2,Staff,30,0,30,0,0
12468,Hialeah Campus,SLS 1106 - 0074   First Year Experience Seminar,0074-LEC Eight Wk 1,Staff,30,10,20,0,0
12497,Hialeah Campus,SLS 1106 - 0075   First Year Experience Seminar,0075-LEC Eight Wk 2,Staff,30,0,30,0,0
12469,Hialeah Campus,SLS 1106 - 0076   First Year Experience Seminar,0076-LEC Eight Wk 1,Staff,30,29,1,0,0
12498,Hialeah Campus,SLS 1106 - 0077   First Year Experience Seminar,0077-LEC Eight Wk 2,Staff,30,0,30,0,0
12499,Hialeah Campus,SLS 1106 - 0078   First Year Experience Seminar,0078-LEC Eight Wk 2,Staff,30,0,30,0,0
12471,Hialeah Campus,SLS 1106 - 0080   First Year Experience Seminar,0080-LEC Eight Wk 1,Staff,30,27,3,0,0
12502,Hialeah Campus,SLS 1106 - 0081   First Year Experience Seminar,0081-LEC Eight Wk 2,Staff,30,0,30,0,0
12472,Hialeah Campus,SLS 1106 - 0082   First Year Experience Seminar,0082-LEC Eight Wk 1,Staff,30,29,1,0,0
12480,Hialeah Campus,SLS 1106 - 0083   First Year Experience Seminar,0083-LEC Eight Wk 1,Staff,30,26,4,0,0
12501,Hialeah Campus,SLS 1106 - 0084   First Year Experience Seminar,0084-LEC Eight Wk 2,Staff,30,0,30,0,0
12500,Hialeah Campus,SLS 1106 - 0085   First Year Experience Seminar,0085-LEC Eight Wk 2,Staff,30,0,30,0,0
12483,Hialeah Campus,SLS 1106 - 0086   First Year Experience Seminar,0086-LEC Eight Wk 1,Staff,30,29,1,0,0
12482,Hialeah Campus,SLS 1106 - 0087   First Year Experience Seminar,0087-LEC Eight Wk 1,Staff,30,29,1,0,0
12542,West Campus,SLS 1106 - 0088   First Year Experience Seminar,0088-LEC Conversion,Staff,35,14,21,0,0
12551,West Campus,SLS 1106 - 0089   First Year Experience Seminar,0089-LEC 1st Mon Sp,Staff,35,10,25,0,0
12485,West Campus,SLS 1106 - 0090   First Year Experience Seminar,0090-LEC Eight Wk 2,Staff,35,14,21,0,0
12457,West Campus,SLS 1106 - 0091   First Year Experience Seminar,0091-LEC Main Sess,Staff,30,0,30,0,0
12461,West Campus,SLS 1106 - 0092   First Year Experience Seminar,0092-LEC Main Sess,Staff,35,27,8,0,0
12460,West Campus,SLS 1106 - 0093   First Year Experience Seminar,0093-LEC Main Sess,Staff,30,0,30,0,0
12459,West Campus,SLS 1106 - 0094   First Year Experience Seminar,0094-LEC Main Sess,Staff,35,27,8,0,0
12553,West Campus,SLS 1106 - 0095   First Year Experience Seminar,0095-LEC 1st Mon Sp,Staff,35,0,35,0,0
12481,West Campus,SLS 1106 - 0096   First Year Experience Seminar,0096-LEC Eight Wk 1,Staff,35,14,21,0,0
12552,West Campus,SLS 1106 - 0097   First Year Experience Seminar,0097-LEC 1st Mon Sp,Staff,35,0,35,0,0
13894,Kendall Campus,DAA 1105 - 0001   Intermediate Modern,0001-LEC Main Sess,Staff,30,6,24,0,0
13895,Wolfson Campus,DAA 1105 - 0003   Intermediate Modern,0003-LEC Main Sess,Staff,35,23,12,0,0
7054,North Campus,FSE 1105 - 0001   Funeral Service Chemistry,0001-LEC Main Sess,Staff,30,18,12,0,0
13249,North Campus,MAC 1105 - 0001   College Algebra,0001-LEC Main Sess,Staff,40,37,3,0,0
13251,North Campus,MAC 1105 - 0003   College Algebra,0003-LEC Main Sess,Staff,40,38,2,0,0
13252,North Campus,MAC 1105 - 0004   College Algebra,0004-LEC Main Sess,Staff,40,33,7,0,0
13253,North Campus,MAC 1105 - 0005   College Algebra,0005-LEC Main Sess,Staff,40,24,16,0,0
13423,North Campus,MAC 1105 - 0006   College Algebra,0006-LEC Main Sess,Staff,35,0,35,0,0
13438,North Campus,MAC 1105 - 0007   College Algebra,0007-LEC Twelve Wk,Staff,30,18,12,0,0
13439,North Campus,MAC 1105 - 0008   College Algebra,0008-LEC Twelve Wk,Staff,40,31,9,0,0
13470,North Campus,MAC 1105 - 0009   College Algebra,0009-LEC Eight Wk 2,Staff,17,9,8,0,0
13460,North Campus,MAC 1105 - 0010   College Algebra,0010-LEC Eight Wk 2,Staff,40,16,24,0,0
13254,North Campus,MAC 1105 - 0011   College Algebra,0011-LEC Main Sess,Staff,40,39,1,0,0
13255,North Campus,MAC 1105 - 0012   College Algebra,0012-LEC Main Sess,Staff,40,34,6,0,0
13256,North Campus,MAC 1105 - 0013   College Algebra,0013-LEC Main Sess,Staff,40,30,10,0,0
13424,North Campus,MAC 1105 - 0014   College Algebra,0014-LEC Main Sess,Staff,30,28,2,0,0
13485,North Campus,MAC 1105 - 0015   College Algebra,0015-LEC Weekend,Staff,40,0,40,0,0
13440,North Campus,MAC 1105 - 0016   College Algebra,0016-LEC Twelve Wk,Staff,30,26,4,0,0
13461,North Campus,MAC 1105 - 0017   College Algebra,0017-LEC Eight Wk 2,Staff,35,17,18,0,0
13257,North Campus,MAC 1105 - 0018   College Algebra,0018-LEC Main Sess,Staff,40,26,14,0,0
13258,North Campus,MAC 1105 - 0019   College Algebra,0019-LEC Main Sess,Staff,40,11,29,0,0
13259,North Campus,MAC 1105 - 0020   College Algebra,0020-LEC Main Sess,Staff,37,24,13,0,0
13261,North Campus,MAC 1105 - 0022   College Algebra,0022-LEC Main Sess,Staff,40,37,3,0,0
13262,North Campus,MAC 1105 - 0023   College Algebra,0023-LEC Main Sess,Staff,40,36,4,0,0
13263,North Campus,MAC 1105 - 0024   College Algebra,0024-LEC Main Sess,Staff,40,19,21,0,0
13264,North Campus,MAC 1105 - 0025   College Algebra,0025-LEC Main Sess,Staff,40,22,18,0,0
13478,North Campus,MAC 1105 - 0026   College Algebra,0026-LEC 1st Mon Sp,Staff,40,31,9,0,0
13477,North Campus,MAC 1105 - 0027   College Algebra,0027-LEC 1st Mon Sp,Staff,40,35,5,0,0
13265,North Campus,MAC 1105 - 0028   College Algebra,0028-LEC Main Sess,Staff,20,0,20,0,0
13266,North Campus,MAC 1105 - 0029   College Algebra,0029-LEC Main Sess,Staff,40,14,26,0,0
13267,North Campus,MAC 1105 - 0030   College Algebra,0030-LEC Main Sess,Staff,40,26,14,0,0
13268,North Campus,MAC 1105 - 0031   College Algebra,0031-LEC Main Sess,Staff,30,18,12,0,0
13269,North Campus,MAC 1105 - 0032   College Algebra,0032-LEC Main Sess,Staff,40,37,3,0,0
13270,North Campus,MAC 1105 - 0033   College Algebra,0033-LEC Main Sess,Staff,34,30,4,0,0
13271,North Campus,MAC 1105 - 0034   College Algebra,0034-LEC Main Sess,Staff,40,0,40,0,0
13425,North Campus,MAC 1105 - 0035   College Algebra,0035-LEC Main Sess,Staff,40,0,40,0,0
13441,North Campus,MAC 1105 - 0036   College Algebra,0036-LEC Twelve Wk,Staff,40,21,19,0,0
13462,North Campus,MAC 1105 - 0037   College Algebra,0037-LEC Eight Wk 2,Staff,40,31,9,0,0
13463,North Campus,MAC 1105 - 0038   College Algebra,0038-LEC Eight Wk 2,Staff,35,23,12,0,0
13442,North Campus,MAC 1105 - 0039   College Algebra,0039-LEC Twelve Wk,Staff,15,0,15,0,0
13475,North Campus,MAC 1105 - 0040   College Algebra,0040-LEC Conversion,Staff,1,0,1,0,0
13443,North Campus,MAC 1105 - 0041   College Algebra,0041-LEC Twelve Wk,Staff,30,0,30,0,0
13444,North Campus,MAC 1105 - 0042   College Algebra,0042-LEC Twelve Wk,Staff,30,20,10,0,0
13272,North Campus,MAC 1105 - 0043   College Algebra,0043-LEC Main Sess,Staff,30,20,10,0,0
13445,North Campus,MAC 1105 - 0044   College Algebra,0044-LEC Twelve Wk,Staff,30,0,30,0,0
13446,North Campus,MAC 1105 - 0045   College Algebra,0045-LEC Twelve Wk,Staff,30,0,30,0,0
13273,North Campus,MAC 1105 - 0046   College Algebra,0046-LEC Main Sess,Staff,30,0,30,0,0
13473,North Campus,MAC 1105 - 0047   College Algebra,0047-LEC Conversion,Staff,30,14,16,0,0
13274,North Campus,MAC 1105 - 0048   College Algebra,0048-LEC Main Sess,Staff,40,37,3,0,0
13275,North Campus,MAC 1105 - 0049   College Algebra,0049-LEC Main Sess,Staff,40,0,40,0,0
13458,North Campus,MAC 1105 - 0050   College Algebra,0050-LEC Eight Wk 1,Staff,40,18,22,0,0
13276,Kendall Campus,MAC 1105 - 0051   College Algebra,0051-LEC Main Sess,Staff,40,39,1,0,0
13277,Kendall Campus,MAC 1105 - 0052   College Algebra,0052-LEC Main Sess,Staff,40,39,1,0,0
13278,Kendall Campus,MAC 1105 - 0053   College Algebra,0053-LEC Main Sess,Staff,39,34,5,0,0
13279,Kendall Campus,MAC 1105 - 0054   College Algebra,0054-LEC Main Sess,Staff,40,39,1,0,0
13280,Kendall Campus,MAC 1105 - 0055   College Algebra,0055-LEC Main Sess,Staff,40,0,40,0,0
13282,Kendall Campus,MAC 1105 - 0057   College Algebra,0057-LEC Main Sess,Staff,40,39,1,0,0
13283,Kendall Campus,MAC 1105 - 0058   College Algebra,0058-LEC Main Sess,Staff,40,38,2,0,0
13286,Kendall Campus,MAC 1105 - 0061   College Algebra,0061-LEC Main Sess,Staff,40,38,2,0,0
13287,Kendall Campus,MAC 1105 - 0062   College Algebra,0062-LEC Main Sess,Staff,36,35,1,0,0
13288,Kendall Campus,MAC 1105 - 0063   College Algebra,0063-LEC Main Sess,Staff,30,29,1,0,0
13447,Kendall Campus,MAC 1105 - 0064   College Algebra,0064-LEC Twelve Wk,Staff,32,29,3,0,0
13448,Kendall Campus,MAC 1105 - 0065   College Algebra,0065-LEC Twelve Wk,Staff,45,26,19,0,0
13289,Kendall Campus,MAC 1105 - 0066   College Algebra,0066-LEC Main Sess,Staff,40,30,10,0,0
13457,Kendall Campus,MAC 1105 - 0068   College Algebra,0068-LEC Eight Wk 1,Staff,30,22,8,0,0
13292,Kendall Campus,MAC 1105 - 0070   College Algebra,0070-LEC Main Sess,Staff,40,38,2,0,0
13294,Kendall Campus,MAC 1105 - 0072   College Algebra,0072-LEC Main Sess,Staff,40,38,2,0,0
13295,Kendall Campus,MAC 1105 - 0073   College Algebra,0073-LEC Main Sess,Staff,40,39,1,0,0
13296,Kendall Campus,MAC 1105 - 0074   College Algebra,0074-LEC Main Sess,Staff,40,38,2,0,0
13297,Kendall Campus,MAC 1105 - 0075   College Algebra,0075-LEC Main Sess,Staff,40,38,2,0,0
13298,Kendall Campus,MAC 1105 - 0076   College Algebra,0076-LEC Main Sess,Staff,40,0,40,0,0
13299,Kendall Campus,MAC 1105 - 0077   College Algebra,0077-LEC Main Sess,Staff,40,36,4,0,0
13300,Kendall Campus,MAC 1105 - 0078   College Algebra,0078-LEC Main Sess,Staff,40,37,3,0,0
13301,Kendall Campus,MAC 1105 - 0079   College Algebra,0079-LEC Main Sess,Staff,39,38,1,0,0
13302,Kendall Campus,MAC 1105 - 0080   College Algebra,0080-LEC Main Sess,Staff,30,28,2,0,0
13303,Kendall Campus,MAC 1105 - 0081   College Algebra,0081-LEC Main Sess,Staff,40,34,6,0,0
13481,Kendall Campus,MAC 1105 - 0083   College Algebra,0083-LEC Weekend,Staff,35,0,35,0,0
13482,Kendall Campus,MAC 1105 - 0084   College Algebra,0084-LEC Weekend,Staff,30,0,30,0,0
13305,Kendall Campus,MAC 1105 - 0085   College Algebra,0085-LEC Main Sess,Staff,30,29,1,0,0
13308,Kendall Campus,MAC 1105 - 0088   College Algebra,0088-LEC Main Sess,Staff,40,0,40,0,0
13309,Kendall Campus,MAC 1105 - 0089   College Algebra,0089-LEC Main Sess,Staff,40,0,40,0,0
13310,Kendall Campus,MAC 1105 - 0090   College Algebra,0090-LEC Main Sess,Staff,39,37,2,0,0
13311,Kendall Campus,MAC 1105 - 0091   College Algebra,0091-LEC Main Sess,Staff,40,38,2,0,0
13312,Kendall Campus,MAC 1105 - 0092   College Algebra,0092-LEC Main Sess,Staff,40,28,12,0,0
13314,Kendall Campus,MAC 1105 - 0094   College Algebra,0094-LEC Main Sess,Staff,39,31,8,0,0
13315,Kendall Campus,MAC 1105 - 0095   College Algebra,0095-LEC Main Sess,Staff,110,67,43,0,0
13316,Kendall Campus,MAC 1105 - 0096   College Algebra,0096-LEC Main Sess,Staff,40,23,17,0,0
13317,Kendall Campus,MAC 1105 - 0097   College Algebra,0097-LEC Main Sess,Staff,110,105,5,0,0
13318,Kendall Campus,MAC 1105 - 0098   College Algebra,0098-LEC Main Sess,Staff,40,38,2,0,0
13319,Kendall Campus,MAC 1105 - 0099   College Algebra,0099-LEC Main Sess,Staff,39,19,20,0,0
13320,Kendall Campus,MAC 1105 - 0100   College Algebra,0100-LEC Main Sess,Staff,40,0,40,0,0
13449,Kendall Campus,MAC 1105 - 0101   College Algebra,0101-LEC Twelve Wk,Staff,45,19,26,0,0
13450,Kendall Campus,MAC 1105 - 0102   College Algebra,0102-LEC Twelve Wk,Staff,39,12,27,0,0
13456,Kendall Campus,MAC 1105 - 0103   College Algebra,0103-LEC Eight Wk 1,Staff,40,25,15,0,0
13323,Kendall Campus,MAC 1105 - 0106   College Algebra,0106-LEC Main Sess,Staff,40,37,3,0,0
13325,Kendall Campus,MAC 1105 - 0108   College Algebra,0108-LEC Main Sess,Staff,40,39,1,0,0
13326,Kendall Campus,MAC 1105 - 0109   College Algebra,0109-LEC Main Sess,Staff,40,38,2,0,0
13328,Kendall Campus,MAC 1105 - 0111   College Algebra,0111-LEC Main Sess,Staff,40,39,1,0,0
13329,Kendall Campus,MAC 1105 - 0112   College Algebra,0112-LEC Main Sess,Staff,40,33,7,0,0
13330,Kendall Campus,MAC 1105 - 0113   College Algebra,0113-LEC Main Sess,Staff,30,0,30,0,0
13451,Kendall Campus,MAC 1105 - 0114   College Algebra,0114-LEC Twelve Wk,Staff,39,0,39,0,0
13428,Kendall Campus,MAC 1105 - 0115   College Algebra,0115-LEC Twelve Wk,Staff,36,33,3,0,0
13455,Kendall Campus,MAC 1105 - 0116   College Algebra,0116-LEC Eight Wk 1,Staff,39,0,39,0,0
13454,Kendall Campus,MAC 1105 - 0117   College Algebra,0117-LEC Eight Wk 1,Staff,45,0,45,0,0
13332,Wolfson Campus,MAC 1105 - 0119   College Algebra,0119-LEC Main Sess,Staff,38,30,8,0,0
13333,Wolfson Campus,MAC 1105 - 0120   College Algebra,0120-LEC Main Sess,Staff,38,36,2,0,0
13334,Wolfson Campus,MAC 1105 - 0121   College Algebra,0121-LEC Main Sess,Staff,38,37,1,0,0
13335,Wolfson Campus,MAC 1105 - 0122   College Algebra,0122-LEC Main Sess,Staff,38,36,2,0,0
13336,Wolfson Campus,MAC 1105 - 0123   College Algebra,0123-LEC Main Sess,Staff,38,37,1,0,0
13337,Wolfson Campus,MAC 1105 - 0124   College Algebra,0124-LEC Main Sess,Staff,38,27,11,0,0
13338,Wolfson Campus,MAC 1105 - 0125   College Algebra,0125-LEC Main Sess,Staff,38,36,2,0,0
13339,Wolfson Campus,MAC 1105 - 0126   College Algebra,0126-LEC Main Sess,Staff,38,33,5,0,0
13341,Wolfson Campus,MAC 1105 - 0128   College Algebra,0128-LEC Main Sess,Staff,38,13,25,0,0
13342,Wolfson Campus,MAC 1105 - 0129   College Algebra,0129-LEC Main Sess,Staff,38,36,2,0,0
13343,Wolfson Campus,MAC 1105 - 0130   College Algebra,0130-LEC Main Sess,Staff,38,34,4,0,0
13344,Wolfson Campus,MAC 1105 - 0131   College Algebra,0131-LEC Main Sess,Staff,38,19,19,0,0
13345,Wolfson Campus,MAC 1105 - 0132   College Algebra,0132-LEC Main Sess,Staff,38,20,18,0,0
13346,Wolfson Campus,MAC 1105 - 0133   College Algebra,0133-LEC Main Sess,Staff,39,36,3,0,0
13472,Wolfson Campus,MAC 1105 - 0134   College Algebra,0134-LEC Conversion,Staff,35,15,20,0,0
13467,Wolfson Campus,MAC 1105 - 0135   College Algebra,0135-LEC Eight Wk 2,Staff,25,8,17,0,0
13347,Wolfson Campus,MAC 1105 - 0136   College Algebra,0136-LEC Main Sess,Staff,38,33,5,0,0
13348,Wolfson Campus,MAC 1105 - 0137   College Algebra,0137-LEC Main Sess,Staff,38,37,1,0,0
13349,Wolfson Campus,MAC 1105 - 0138   College Algebra,0138-LEC Main Sess,Staff,38,27,11,0,0
13350,Wolfson Campus,MAC 1105 - 0139   College Algebra,0139-LEC Main Sess,Staff,38,35,3,0,0
13351,Wolfson Campus,MAC 1105 - 0140   College Algebra,0140-LEC Main Sess,Staff,38,21,17,0,0
13352,Wolfson Campus,MAC 1105 - 0141   College Algebra,0141-LEC Main Sess,Staff,25,16,9,0,0
13437,Wolfson Campus,MAC 1105 - 0142   College Algebra,0142-LEC Twelve Wk,Staff,38,33,5,0,0
13436,Wolfson Campus,MAC 1105 - 0143   College Algebra,0143-LEC Twelve Wk,Staff,1,0,1,0,0
13435,Wolfson Campus,MAC 1105 - 0144   College Algebra,0144-LEC Twelve Wk,Staff,38,0,38,0,0
13434,Wolfson Campus,MAC 1105 - 0145   College Algebra,0145-LEC Twelve Wk,Staff,38,33,5,0,0
13353,Wolfson Campus,MAC 1105 - 0146   College Algebra,0146-LEC Main Sess,Staff,38,35,3,0,0
13354,Wolfson Campus,MAC 1105 - 0147   College Algebra,0147-LEC Main Sess,Staff,38,30,8,0,0
13355,Wolfson Campus,MAC 1105 - 0148   College Algebra,0148-LEC Main Sess,Staff,38,34,4,0,0
13357,Wolfson Campus,MAC 1105 - 0150   College Algebra,0150-LEC Main Sess,Staff,35,0,35,0,0
13358,Wolfson Campus,MAC 1105 - 0151   College Algebra,0151-LEC Main Sess,Staff,38,29,9,0,0
13359,Wolfson Campus,MAC 1105 - 0152   College Algebra,0152-LEC Main Sess,Staff,38,31,7,0,0
13360,Wolfson Campus,MAC 1105 - 0153   College Algebra,0153-LEC Main Sess,Staff,38,26,12,0,0
13483,Wolfson Campus,MAC 1105 - 0154   College Algebra,0154-LEC Weekend,Staff,38,0,38,0,0
13361,Wolfson Campus,MAC 1105 - 0155   College Algebra,0155-LEC Main Sess,Staff,30,23,7,0,0
13362,Wolfson Campus,MAC 1105 - 0156   College Algebra,0156-LEC Main Sess,Staff,30,27,3,0,0
13363,Wolfson Campus,MAC 1105 - 0157   College Algebra,0157-LEC Main Sess,Staff,30,27,3,0,0
13364,Wolfson Campus,MAC 1105 - 0158   College Algebra,0158-LEC Main Sess,Staff,30,28,2,0,0
13365,Wolfson Campus,MAC 1105 - 0159   College Algebra,0159-LEC Main Sess,Staff,30,27,3,0,0
13366,Wolfson Campus,MAC 1105 - 0160   College Algebra,0160-LEC Main Sess,Staff,30,29,1,0,0
13367,Wolfson Campus,MAC 1105 - 0161   College Algebra,0161-LEC Main Sess,Staff,30,28,2,0,0
13370,Wolfson Campus,MAC 1105 - 0164   College Algebra,0164-LEC Main Sess,Staff,30,25,5,0,0
13371,Wolfson Campus,MAC 1105 - 0165   College Algebra,0165-LEC Main Sess,Staff,30,28,2,0,0
13372,Wolfson Campus,MAC 1105 - 0166   College Algebra,0166-LEC Main Sess,Staff,30,26,4,0,0
13373,Wolfson Campus,MAC 1105 - 0167   College Algebra,0167-LEC Main Sess,Staff,30,24,6,0,0
13374,Wolfson Campus,MAC 1105 - 0168   College Algebra,0168-LEC Main Sess,Staff,30,29,1,0,0
13375,Wolfson Campus,MAC 1105 - 0169   College Algebra,0169-LEC Main Sess,Staff,30,29,1,0,0
13376,Homestead Campus,MAC 1105 - 0170   College Algebra,0170-LEC Main Sess,Staff,25,23,2,0,0
13377,Homestead Campus,MAC 1105 - 0171   College Algebra,0171-LEC Main Sess,Staff,35,33,2,0,0
13379,Homestead Campus,MAC 1105 - 0173   College Algebra,0173-LEC Main Sess,Staff,35,34,1,0,0
13380,Homestead Campus,MAC 1105 - 0174   College Algebra,0174-LEC Main Sess,Staff,25,23,2,0,0
13381,Homestead Campus,MAC 1105 - 0175   College Algebra,0175-LEC Main Sess,Staff,35,29,6,0,0
13433,Homestead Campus,MAC 1105 - 0176   College Algebra,0176-LEC Twelve Wk,Staff,35,30,5,0,0
13466,Homestead Campus,MAC 1105 - 0177   College Algebra,0177-LEC Eight Wk 2,Staff,25,0,25,0,0
13383,Homestead Campus,MAC 1105 - 0179   College Algebra,0179-LEC Main Sess,Staff,25,23,2,0,0
13465,Homestead Campus,MAC 1105 - 0180   College Algebra,0180-LEC Eight Wk 2,Staff,28,0,28,0,0
13459,Homestead Campus,MAC 1105 - 0181   College Algebra,0181-LEC Eight Wk 2,Staff,25,21,4,0,0
13384,Homestead Campus,MAC 1105 - 0182   College Algebra,0182-LEC Main Sess,Staff,35,0,35,0,0
13385,Homestead Campus,MAC 1105 - 0183   College Algebra,0183-LEC Main Sess,Staff,35,31,4,0,0
13474,Homestead Campus,MAC 1105 - 0184   College Algebra,0184-LEC Conversion,Staff,35,0,35,0,0
13464,Homestead Campus,MAC 1105 - 0185   College Algebra,0185-LEC Eight Wk 2,Staff,1,0,1,0,0
13387,InterAmerican Campus,MAC 1105 - 0187   College Algebra,0187-LEC Main Sess,Staff,30,28,2,0,0
13389,InterAmerican Campus,MAC 1105 - 0189   College Algebra,0189-LEC Main Sess,Staff,20,12,8,0,0
13390,InterAmerican Campus,MAC 1105 - 0190   College Algebra,0190-LEC Main Sess,Staff,37,35,2,0,0
13471,InterAmerican Campus,MAC 1105 - 0191   College Algebra,0191-LEC Conversion,Staff,30,23,7,0,0
13469,InterAmerican Campus,MAC 1105 - 0192   College Algebra,0192-LEC Eight Wk 2,Staff,35,0,35,0,0
13391,InterAmerican Campus,MAC 1105 - 0193   College Algebra,0193-LEC Main Sess,Staff,37,0,37,0,0
13392,InterAmerican Campus,MAC 1105 - 0194   College Algebra,0194-LEC Main Sess,Staff,37,16,21,0,0
13393,InterAmerican Campus,MAC 1105 - 0195   College Algebra,0195-LEC Main Sess,Staff,37,36,1,0,0
13394,InterAmerican Campus,MAC 1105 - 0196   College Algebra,0196-LEC Main Sess,Staff,37,32,5,0,0
13395,InterAmerican Campus,MAC 1105 - 0197   College Algebra,0197-LEC Main Sess,Staff,37,36,1,0,0
13396,InterAmerican Campus,MAC 1105 - 0198   College Algebra,0198-LEC Main Sess,Staff,37,31,6,0,0
13397,InterAmerican Campus,MAC 1105 - 0199   College Algebra,0199-LEC Main Sess,Staff,30,13,17,0,0
13398,InterAmerican Campus,MAC 1105 - 0200   College Algebra,0200-LEC Main Sess,Staff,37,22,15,0,0
13453,InterAmerican Campus,MAC 1105 - 0201   College Algebra,0201-LEC Eight Wk 1,Staff,37,0,37,0,0
13468,InterAmerican Campus,MAC 1105 - 0202   College Algebra,0202-LEC Eight Wk 2,Staff,30,27,3,0,0
13476,InterAmerican Campus,MAC 1105 - 0203   College Algebra,0203-LEC 1st Mon Sp,Staff,37,20,17,0,0
13399,Hialeah Campus,MAC 1105 - 0204   College Algebra,0204-LEC Main Sess,Staff,37,34,3,0,0
13400,Hialeah Campus,MAC 1105 - 0205   College Algebra,0205-LEC Main Sess,Staff,35,27,8,0,0
13401,Hialeah Campus,MAC 1105 - 0206   College Algebra,0206-LEC Main Sess,Staff,35,33,2,0,0
13402,Hialeah Campus,MAC 1105 - 0207   College Algebra,0207-LEC Main Sess,Staff,31,22,9,0,0
13404,Hialeah Campus,MAC 1105 - 0209   College Algebra,0209-LEC Main Sess,Staff,30,29,1,0,0
13405,Hialeah Campus,MAC 1105 - 0210   College Algebra,0210-LEC Main Sess,Staff,33,19,14,0,0
13406,Hialeah Campus,MAC 1105 - 0211   College Algebra,0211-LEC Main Sess,Staff,33,0,33,0,0
13479,Hialeah Campus,MAC 1105 - 0212   College Algebra,0212-LEC 1st Mon Sp,Staff,35,34,1,0,0
13407,Hialeah Campus,MAC 1105 - 0213   College Algebra,0213-LEC Main Sess,Staff,30,27,3,0,0
13408,Hialeah Campus,MAC 1105 - 0214   College Algebra,0214-LEC Main Sess,Staff,33,26,7,0,0
13409,Hialeah Campus,MAC 1105 - 0215   College Algebra,0215-LEC Main Sess,Staff,33,27,6,0,0
13432,Hialeah Campus,MAC 1105 - 0216   College Algebra,0216-LEC Twelve Wk,Staff,44,19,25,0,0
13410,Hialeah Campus,MAC 1105 - 0217   College Algebra,0217-LEC Main Sess,Staff,33,10,23,0,0
13411,Hialeah Campus,MAC 1105 - 0218   College Algebra,0218-LEC Main Sess,Staff,33,32,1,0,0
13431,Hialeah Campus,MAC 1105 - 0219   College Algebra,0219-LEC Twelve Wk,Staff,30,28,2,0,0
13430,Hialeah Campus,MAC 1105 - 0220   College Algebra,0220-LEC Twelve Wk,Staff,43,40,3,0,0
13412,Hialeah Campus,MAC 1105 - 0221   College Algebra,0221-LEC Main Sess,Staff,37,36,1,0,0
13413,Hialeah Campus,MAC 1105 - 0222   College Algebra,0222-LEC Main Sess,Staff,35,30,5,0,0
13484,Hialeah Campus,MAC 1105 - 0223   College Algebra,0223-LEC Weekend,Staff,33,31,2,0,0
13429,Hialeah Campus,MAC 1105 - 0224   College Algebra,0224-LEC Twelve Wk,Staff,45,39,6,0,0
13414,West Campus,MAC 1105 - 0225   College Algebra,0225-LEC Main Sess,Staff,35,29,6,0,0
13415,West Campus,MAC 1105 - 0226   College Algebra,0226-LEC Main Sess,Staff,30,15,15,0,0
13426,West Campus,MAC 1105 - 0227   College Algebra,0227-LEC Main Sess,Staff,35,0,35,0,0
13452,West Campus,MAC 1105 - 0228   College Algebra,0228-LEC Twelve Wk,Staff,35,27,8,0,0
13416,West Campus,MAC 1105 - 0229   College Algebra,0229-LEC Main Sess,Staff,35,10,25,0,0
13480,West Campus,MAC 1105 - 0230   College Algebra,0230-LEC Weekend,Staff,35,16,19,0,0
13417,West Campus,MAC 1105 - 0231   College Algebra,0231-LEC Main Sess,Staff,35,32,3,0,0
13418,West Campus,MAC 1105 - 0232   College Algebra,0232-LEC Main Sess,Staff,35,31,4,0,0
13419,West Campus,MAC 1105 - 0233   College Algebra,0233-LEC Main Sess,Staff,35,32,3,0,0
13427,West Campus,MAC 1105 - 0234   College Algebra,0234-LEC Twelve Wk,Staff,30,0,30,0,0
13420,West Campus,MAC 1105 - 0235   College Algebra,0235-LEC Main Sess,Staff,35,25,10,0,0
13422,West Campus,MAC 1105 - 0237   College Algebra,0237-LEC Main Sess,Staff,35,12,23,0,0
7458,North Campus,DAA 1104 - 0001   Modern 1,0001-LEC Main Sess,Staff,5,0,5,0,0
7457,Wolfson Campus,DAA 1104 - 0002   Modern 1,0002-LEC Main Sess,Staff,10,2,8,0,0
16751,North Campus,MTB 1103 - 0001   Business Mathematics,0001-LEC Main Sess,Staff,30,8,22,0,0
16752,North Campus,MTB 1103 - 0002   Business Mathematics,0002-LEC Main Sess,Staff,30,0,30,0,0
16755,Wolfson Campus,MTB 1103 - 0003   Business Mathematics,0003-LEC Twelve Wk,Staff,30,0,30,0,0
16756,Wolfson Campus,MTB 1103 - 0004   Business Mathematics,0004-LEC 1st Mon Sp,Staff,35,0,35,0,0
16753,Wolfson Campus,MTB 1103 - 0005   Business Mathematics,0005-LEC Main Sess,Staff,30,26,4,0,0
15800,North Campus,ENC 1102 - 0001   English Composition 2,0001-LEC Main Sess,Staff,25,24,1,0,0
15801,North Campus,ENC 1102 - 0002   English Composition 2,0002-LEC Main Sess,Staff,21,18,3,0,0
15802,North Campus,ENC 1102 - 0003   English Composition 2,0003-LEC Main Sess,Staff,25,0,25,0,0
15803,North Campus,ENC 1102 - 0004   English Composition 2,0004-LEC Main Sess,Staff,24,23,1,0,0
15804,North Campus,ENC 1102 - 0005   English Composition 2,0005-LEC Main Sess,Staff,25,22,3,0,0
15805,North Campus,ENC 1102 - 0006   English Composition 2,0006-LEC Main Sess,Staff,21,18,3,0,0
15807,North Campus,ENC 1102 - 0008   English Composition 2,0008-LEC Main Sess,Staff,25,15,10,0,0
15808,North Campus,ENC 1102 - 0009   English Composition 2,0009-LEC Main Sess,Staff,25,11,14,0,0
15809,North Campus,ENC 1102 - 0010   English Composition 2,0010-LEC Main Sess,Staff,25,15,10,0,0
15810,North Campus,ENC 1102 - 0011   English Composition 2,0011-LEC Main Sess,Staff,25,13,12,0,0
15811,North Campus,ENC 1102 - 0012   English Composition 2,0012-LEC Main Sess,Staff,25,23,2,0,0
16155,North Campus,ENC 1102 - 0013   English Composition 2,0013-LEC Twelve Wk,Staff,25,0,25,0,0
16213,North Campus,ENC 1102 - 0014   English Composition 2,0014-LEC Weekend,Staff,25,0,25,0,0
16170,North Campus,ENC 1102 - 0015   English Composition 2,0015-LEC Twelve Wk,Staff,25,24,1,0,0
16186,North Campus,ENC 1102 - 0016   English Composition 2,0016-LEC Eight Wk 2,Staff,25,0,25,0,0
15812,North Campus,ENC 1102 - 0017   English Composition 2,0017-LEC Main Sess,Staff,25,23,2,0,0
15814,North Campus,ENC 1102 - 0019   English Composition 2,0019-LEC Main Sess,Staff,25,19,6,0,0
15815,North Campus,ENC 1102 - 0020   English Composition 2,0020-LEC Main Sess,Staff,23,13,10,0,0
15816,North Campus,ENC 1102 - 0021   English Composition 2,0021-LEC Main Sess,Staff,25,0,25,0,0
15817,North Campus,ENC 1102 - 0022   English Composition 2,0022-LEC Main Sess,Staff,24,21,3,0,0
15820,North Campus,ENC 1102 - 0025   English Composition 2,0025-LEC Main Sess,Staff,23,21,2,0,0
15821,North Campus,ENC 1102 - 0026   English Composition 2,0026-LEC Main Sess,Staff,25,22,3,0,0
15822,North Campus,ENC 1102 - 0027   English Composition 2,0027-LEC Main Sess,Staff,19,16,3,0,0
15823,North Campus,ENC 1102 - 0028   English Composition 2,0028-LEC Main Sess,Staff,25,12,13,0,0
15825,North Campus,ENC 1102 - 0030   English Composition 2,0030-LEC Main Sess,Staff,18,15,3,0,0
15826,North Campus,ENC 1102 - 0031   English Composition 2,0031-LEC Main Sess,Staff,3,0,3,0,0
15827,North Campus,ENC 1102 - 0032   English Composition 2,0032-LEC Main Sess,Staff,20,0,20,0,0
15828,North Campus,ENC 1102 - 0033   English Composition 2,0033-LEC Main Sess,Staff,21,19,2,0,0
15829,North Campus,ENC 1102 - 0034   English Composition 2,0034-LEC Main Sess,Staff,3,0,3,0,0
15830,North Campus,ENC 1102 - 0036   English Composition 2,0036-LEC Main Sess,Staff,25,21,4,0,0
16184,North Campus,ENC 1102 - 0037   English Composition 2,0037-LEC Eight Wk 2,Staff,25,14,11,0,0
15832,North Campus,ENC 1102 - 0039   English Composition 2,0039-LEC Main Sess,Staff,24,19,5,0,0
15833,North Campus,ENC 1102 - 0040   English Composition 2,0040-LEC Main Sess,Staff,25,0,25,0,0
15835,North Campus,ENC 1102 - 0042   English Composition 2,0042-LEC Main Sess,Staff,25,14,11,0,0
15836,North Campus,ENC 1102 - 0043   English Composition 2,0043-LEC Main Sess,Staff,23,22,1,0,0
15837,North Campus,ENC 1102 - 0044   English Composition 2,0044-LEC Main Sess,Staff,25,24,1,0,0
15838,North Campus,ENC 1102 - 0045   English Composition 2,0045-LEC Main Sess,Staff,25,0,25,0,0
15840,North Campus,ENC 1102 - 0047   English Composition 2,0047-LEC Main Sess,Staff,25,18,7,0,0
15841,North Campus,ENC 1102 - 0048   English Composition 2,0048-LEC Main Sess,Staff,25,21,4,0,0
15842,North Campus,ENC 1102 - 0049   English Composition 2,0049-LEC Main Sess,Staff,20,16,4,0,0
15843,North Campus,ENC 1102 - 0050   English Composition 2,0050-LEC Main Sess,Staff,25,0,25,0,0
15844,North Campus,ENC 1102 - 0051   English Composition 2,0051-LEC Main Sess,Staff,25,18,7,0,0
16171,North Campus,ENC 1102 - 0053   English Composition 2,0053-LEC Eight Wk 1,Staff,25,22,3,0,0
15846,North Campus,ENC 1102 - 0054   English Composition 2,0054-LEC Main Sess,Staff,20,18,2,0,0
15847,North Campus,ENC 1102 - 0055   English Composition 2,0055-LEC Main Sess,Staff,25,23,2,0,0
15848,North Campus,ENC 1102 - 0056   English Composition 2,0056-LEC Main Sess,Staff,5,0,5,0,0
15849,North Campus,ENC 1102 - 0057   English Composition 2,0057-LEC Main Sess,Staff,25,23,2,0,0
15850,North Campus,ENC 1102 - 0058   English Composition 2,0058-LEC Main Sess,Staff,25,0,25,0,0
15851,North Campus,ENC 1102 - 0059   English Composition 2,0059-LEC Main Sess,Staff,22,21,1,0,0
15852,North Campus,ENC 1102 - 0060   English Composition 2,0060-LEC Main Sess,Staff,25,24,1,0,0
15853,North Campus,ENC 1102 - 0061   English Composition 2,0061-LEC Main Sess,Staff,25,22,3,0,0
15854,North Campus,ENC 1102 - 0062   English Composition 2,0062-LEC Main Sess,Staff,5,0,5,0,0
15856,North Campus,ENC 1102 - 0064   English Composition 2,0064-LEC Main Sess,Staff,25,20,5,0,0
15857,North Campus,ENC 1102 - 0065   English Composition 2,0065-LEC Main Sess,Staff,25,15,10,0,0
15858,North Campus,ENC 1102 - 0066   English Composition 2,0066-LEC Main Sess,Staff,25,23,2,0,0
15859,North Campus,ENC 1102 - 0067   English Composition 2,0067-LEC Main Sess,Staff,25,0,25,0,0
15860,North Campus,ENC 1102 - 0068   English Composition 2,0068-LEC Main Sess,Staff,25,0,25,0,0
15862,North Campus,ENC 1102 - 0070   English Composition 2,0070-LEC Main Sess,Staff,25,19,6,0,0
15863,North Campus,ENC 1102 - 0071   English Composition 2,0071-LEC Main Sess,Staff,25,0,25,0,0
16157,North Campus,ENC 1102 - 0072   English Composition 2,0072-LEC Twelve Wk,Staff,25,23,2,0,0
16158,North Campus,ENC 1102 - 0073   English Composition 2,0073-LEC Twelve Wk,Staff,3,0,3,0,0
16159,North Campus,ENC 1102 - 0074   English Composition 2,0074-LEC Twelve Wk,Staff,25,11,14,0,0
15864,North Campus,ENC 1102 - 0075   English Composition 2,0075-LEC Main Sess,Staff,25,9,16,0,0
15865,North Campus,ENC 1102 - 0076   English Composition 2,0076-LEC Main Sess,Staff,25,17,8,0,0
16206,North Campus,ENC 1102 - 0077   English Composition 2,0077-LEC 1st Mon Sp,Staff,25,16,9,0,0
15866,North Campus,ENC 1102 - 0078   English Composition 2,0078-LEC Main Sess,Staff,25,15,10,0,0
16214,North Campus,ENC 1102 - 0079   English Composition 2,0079-LEC Weekend,Staff,25,0,25,0,0
16189,North Campus,ENC 1102 - 0080   English Composition 2,0080-LEC Conversion,Staff,25,15,10,0,0
15867,Kendall Campus,ENC 1102 - 0081   English Composition 2,0081-LEC Main Sess,Staff,25,22,3,0,0
15869,Kendall Campus,ENC 1102 - 0083   English Composition 2,0083-LEC Main Sess,Staff,25,23,2,0,0
15871,Kendall Campus,ENC 1102 - 0085   English Composition 2,0085-LEC Main Sess,Staff,25,24,1,0,0
15872,Kendall Campus,ENC 1102 - 0086   English Composition 2,0086-LEC Main Sess,Staff,25,0,25,0,0
15873,Kendall Campus,ENC 1102 - 0087   English Composition 2,0087-LEC Main Sess,Staff,25,24,1,0,0
15874,Kendall Campus,ENC 1102 - 0088   English Composition 2,0088-LEC Main Sess,Staff,25,24,1,0,0
15875,Kendall Campus,ENC 1102 - 0089   English Composition 2,0089-LEC Main Sess,Staff,25,14,11,0,0
15876,Kendall Campus,ENC 1102 - 0090   English Composition 2,0090-LEC Main Sess,Staff,25,23,2,0,0
15877,Kendall Campus,ENC 1102 - 0091   English Composition 2,0091-LEC Main Sess,Staff,25,22,3,0,0
15878,Kendall Campus,ENC 1102 - 0092   English Composition 2,0092-LEC Main Sess,Staff,25,22,3,0,0
15879,Kendall Campus,ENC 1102 - 0093   English Composition 2,0093-LEC Main Sess,Staff,18,14,4,0,0
15880,Kendall Campus,ENC 1102 - 0094   English Composition 2,0094-LEC Main Sess,Staff,25,24,1,0,0
15882,Kendall Campus,ENC 1102 - 0096   English Composition 2,0096-LEC Main Sess,Staff,25,24,1,0,0
15883,Kendall Campus,ENC 1102 - 0097   English Composition 2,0097-LEC Main Sess,Staff,25,17,8,0,0
15887,Kendall Campus,ENC 1102 - 0101   English Composition 2,0101-LEC Main Sess,Staff,25,19,6,0,0
16215,Kendall Campus,ENC 1102 - 0103   English Composition 2,0103-LEC Weekend,Staff,25,24,1,0,0
16200,Kendall Campus,ENC 1102 - 0104   English Composition 2,0104-LEC Conversion,Staff,25,24,1,0,0
16160,Kendall Campus,ENC 1102 - 0105   English Composition 2,0105-LEC Twelve Wk,Staff,25,23,2,0,0
16162,Kendall Campus,ENC 1102 - 0107   English Composition 2,0107-LEC Twelve Wk,Staff,25,24,1,0,0
16163,Kendall Campus,ENC 1102 - 0108   English Composition 2,0108-LEC Twelve Wk,Staff,25,0,25,0,0
16207,Kendall Campus,ENC 1102 - 0109   English Composition 2,0109-LEC 1st Mon Sp,Staff,5,0,5,0,0
16174,Kendall Campus,ENC 1102 - 0110   English Composition 2,0110-LEC Eight Wk 2,Staff,25,22,3,0,0
15889,Kendall Campus,ENC 1102 - 0111   English Composition 2,0111-LEC Main Sess,Staff,25,23,2,0,0
15890,Kendall Campus,ENC 1102 - 0112   English Composition 2,0112-LEC Main Sess,Staff,25,23,2,0,0
15891,Kendall Campus,ENC 1102 - 0113   English Composition 2,0113-LEC Main Sess,Staff,25,24,1,0,0
15892,Kendall Campus,ENC 1102 - 0114   English Composition 2,0114-LEC Main Sess,Staff,25,18,7,0,0
15894,Kendall Campus,ENC 1102 - 0116   English Composition 2,0116-LEC Main Sess,Staff,25,23,2,0,0
15897,Kendall Campus,ENC 1102 - 0119   English Composition 2,0119-LEC Main Sess,Staff,25,24,1,0,0
15898,Kendall Campus,ENC 1102 - 0120   English Composition 2,0120-LEC Main Sess,Staff,25,22,3,0,0
15899,Kendall Campus,ENC 1102 - 0121   English Composition 2,0121-LEC Main Sess,Staff,25,23,2,0,0
15900,Kendall Campus,ENC 1102 - 0122   English Composition 2,0122-LEC Main Sess,Staff,25,23,2,0,0
15902,Kendall Campus,ENC 1102 - 0124   English Composition 2,0124-LEC Main Sess,Staff,25,24,1,0,0
15903,Kendall Campus,ENC 1102 - 0125   English Composition 2,0125-LEC Main Sess,Staff,25,21,4,0,0
15904,Kendall Campus,ENC 1102 - 0126   English Composition 2,0126-LEC Main Sess,Staff,25,23,2,0,0
15905,Kendall Campus,ENC 1102 - 0127   English Composition 2,0127-LEC Main Sess,Staff,25,18,7,0,0
15906,Kendall Campus,ENC 1102 - 0128   English Composition 2,0128-LEC Main Sess,Staff,25,24,1,0,0
15907,Kendall Campus,ENC 1102 - 0129   English Composition 2,0129-LEC Main Sess,Staff,25,24,1,0,0
15910,Kendall Campus,ENC 1102 - 0132   English Composition 2,0132-LEC Main Sess,Staff,25,18,7,0,0
15911,Kendall Campus,ENC 1102 - 0133   English Composition 2,0133-LEC Main Sess,Staff,25,22,3,0,0
15912,Kendall Campus,ENC 1102 - 0134   English Composition 2,0134-LEC Main Sess,Staff,25,12,13,0,0
16201,Kendall Campus,ENC 1102 - 0135   English Composition 2,0135-LEC Conversion,Staff,2,0,2,0,0
16164,Kendall Campus,ENC 1102 - 0136   English Composition 2,0136-LEC Twelve Wk,Staff,25,22,3,0,0
15914,Kendall Campus,ENC 1102 - 0138   English Composition 2,0138-LEC Main Sess,Staff,25,21,4,0,0
15915,Kendall Campus,ENC 1102 - 0139   English Composition 2,0139-LEC Main Sess,Staff,25,21,4,0,0
15916,Kendall Campus,ENC 1102 - 0140   English Composition 2,0140-LEC Main Sess,Staff,25,24,1,0,0
15918,Kendall Campus,ENC 1102 - 0142   English Composition 2,0142-LEC Main Sess,Staff,25,22,3,0,0
15919,Kendall Campus,ENC 1102 - 0143   English Composition 2,0143-LEC Main Sess,Staff,25,23,2,0,0
15920,Kendall Campus,ENC 1102 - 0144   English Composition 2,0144-LEC Main Sess,Staff,25,23,2,0,0
15921,Kendall Campus,ENC 1102 - 0145   English Composition 2,0145-LEC Main Sess,Staff,25,19,6,0,0
15923,Kendall Campus,ENC 1102 - 0147   English Composition 2,0147-LEC Main Sess,Staff,9,0,9,0,0
15924,Kendall Campus,ENC 1102 - 0148   English Composition 2,0148-LEC Main Sess,Staff,25,20,5,0,0
15925,Kendall Campus,ENC 1102 - 0149   English Composition 2,0149-LEC Main Sess,Staff,25,18,7,0,0
15926,Kendall Campus,ENC 1102 - 0150   English Composition 2,0150-LEC Main Sess,Staff,25,13,12,0,0
15927,Kendall Campus,ENC 1102 - 0151   English Composition 2,0151-LEC Main Sess,Staff,25,13,12,0,0
15928,Kendall Campus,ENC 1102 - 0152   English Composition 2,0152-LEC Main Sess,Staff,1,0,1,0,0
15930,Kendall Campus,ENC 1102 - 0154   English Composition 2,0154-LEC Main Sess,Staff,25,23,2,0,0
15931,Kendall Campus,ENC 1102 - 0155   English Composition 2,0155-LEC Main Sess,Staff,25,23,2,0,0
15932,Kendall Campus,ENC 1102 - 0156   English Composition 2,0156-LEC Main Sess,Staff,25,23,2,0,0
15935,Kendall Campus,ENC 1102 - 0159   English Composition 2,0159-LEC Main Sess,Staff,7,0,7,0,0
15936,Kendall Campus,ENC 1102 - 0160   English Composition 2,0160-LEC Main Sess,Staff,25,24,1,0,0
15937,Kendall Campus,ENC 1102 - 0161   English Composition 2,0161-LEC Main Sess,Staff,25,21,4,0,0
15938,Kendall Campus,ENC 1102 - 0162   English Composition 2,0162-LEC Main Sess,Staff,25,24,1,0,0
15939,Kendall Campus,ENC 1102 - 0163   English Composition 2,0163-LEC Main Sess,Staff,25,22,3,0,0
15940,Kendall Campus,ENC 1102 - 0164   English Composition 2,0164-LEC Main Sess,Staff,25,21,4,0,0
15941,Kendall Campus,ENC 1102 - 0165   English Composition 2,0165-LEC Main Sess,Staff,1,0,1,0,0
15942,Kendall Campus,ENC 1102 - 0166   English Composition 2,0166-LEC Main Sess,Staff,25,21,4,0,0
15943,Kendall Campus,ENC 1102 - 0167   English Composition 2,0167-LEC Main Sess,Staff,25,24,1,0,0
15944,Kendall Campus,ENC 1102 - 0168   English Composition 2,0168-LEC Main Sess,Staff,1,0,1,0,0
15945,Kendall Campus,ENC 1102 - 0169   English Composition 2,0169-LEC Main Sess,Staff,25,23,2,0,0
15947,Kendall Campus,ENC 1102 - 0171   English Composition 2,0171-LEC Main Sess,Staff,25,21,4,0,0
15948,Kendall Campus,ENC 1102 - 0172   English Composition 2,0172-LEC Main Sess,Staff,25,23,2,0,0
15949,Kendall Campus,ENC 1102 - 0173   English Composition 2,0173-LEC Main Sess,Staff,3,0,3,0,0
16199,Kendall Campus,ENC 1102 - 0174   English Composition 2,0174-LEC Conversion,Staff,25,23,2,0,0
15952,Kendall Campus,ENC 1102 - 0177   English Composition 2,0177-LEC Main Sess,Staff,3,0,3,0,0
15954,Kendall Campus,ENC 1102 - 0179   English Composition 2,0179-LEC Main Sess,Staff,25,24,1,0,0
15955,Kendall Campus,ENC 1102 - 0180   English Composition 2,0180-LEC Main Sess,Staff,1,0,1,0,0
16216,Kendall Campus,ENC 1102 - 0183   English Composition 2,0183-LEC Weekend,Staff,1,0,1,0,0
15959,Kendall Campus,ENC 1102 - 0185   English Composition 2,0185-LEC Main Sess,Staff,25,24,1,0,0
15965,Kendall Campus,ENC 1102 - 0191   English Composition 2,0191-LEC Main Sess,Staff,25,23,2,0,0
15967,Kendall Campus,ENC 1102 - 0193   English Composition 2,0193-LEC Main Sess,Staff,25,24,1,0,0
15968,Kendall Campus,ENC 1102 - 0194   English Composition 2,0194-LEC Main Sess,Staff,25,24,1,0,0
15969,Kendall Campus,ENC 1102 - 0195   English Composition 2,0195-LEC Main Sess,Staff,25,24,1,0,0
15970,Kendall Campus,ENC 1102 - 0196   English Composition 2,0196-LEC Main Sess,Staff,25,24,1,0,0
15972,Kendall Campus,ENC 1102 - 0198   English Composition 2,0198-LEC Main Sess,Staff,25,21,4,0,0
15973,Kendall Campus,ENC 1102 - 0199   English Composition 2,0199-LEC Main Sess,Staff,25,22,3,0,0
15974,Kendall Campus,ENC 1102 - 0200   English Composition 2,0200-LEC Main Sess,Staff,25,23,2,0,0
15975,Kendall Campus,ENC 1102 - 0201   English Composition 2,0201-LEC Main Sess,Staff,25,24,1,0,0
15976,Kendall Campus,ENC 1102 - 0202   English Composition 2,0202-LEC Main Sess,Staff,1,0,1,0,0
15977,Kendall Campus,ENC 1102 - 0203   English Composition 2,0203-LEC Main Sess,Staff,25,23,2,0,0
15978,Kendall Campus,ENC 1102 - 0204   English Composition 2,0204-LEC Main Sess,Staff,25,21,4,0,0
15979,Kendall Campus,ENC 1102 - 0205   English Composition 2,0205-LEC Main Sess,Staff,25,24,1,0,0
15981,Kendall Campus,ENC 1102 - 0207   English Composition 2,0207-LEC Main Sess,Staff,1,0,1,0,0
15983,Kendall Campus,ENC 1102 - 0209   English Composition 2,0209-LEC Main Sess,Staff,25,23,2,0,0
16221,Kendall Campus,ENC 1102 - 0210   English Composition 2,0210-LEC Weekend,Staff,25,24,1,0,0
16165,Kendall Campus,ENC 1102 - 0212   English Composition 2,0212-LEC Twelve Wk,Staff,25,24,1,0,0
16208,Kendall Campus,ENC 1102 - 0213   English Composition 2,0213-LEC 1st Mon Sp,Staff,25,23,2,0,0
15985,Kendall Campus,ENC 1102 - 0214   English Composition 2,0214-LEC Main Sess,Staff,25,21,4,0,0
15987,Kendall Campus,ENC 1102 - 0216   English Composition 2,0216-LEC Main Sess,Staff,3,0,3,0,0
15988,Kendall Campus,ENC 1102 - 0217   English Composition 2,0217-LEC Main Sess,Staff,25,24,1,0,0
15989,Kendall Campus,ENC 1102 - 0218   English Composition 2,0218-LEC Main Sess,Staff,25,22,3,0,0
15990,Wolfson Campus,ENC 1102 - 0219   English Composition 2,0219-LEC Main Sess,Staff,25,23,2,0,0
15991,Wolfson Campus,ENC 1102 - 0220   English Composition 2,0220-LEC Main Sess,Staff,25,21,4,0,0
15992,Wolfson Campus,ENC 1102 - 0221   English Composition 2,0221-LEC Main Sess,Staff,25,0,25,0,0
15993,Wolfson Campus,ENC 1102 - 0222   English Composition 2,0222-LEC Main Sess,Staff,25,22,3,0,0
15995,Wolfson Campus,ENC 1102 - 0224   English Composition 2,0224-LEC Main Sess,Staff,25,23,2,0,0
15996,Wolfson Campus,ENC 1102 - 0225   English Composition 2,0225-LEC Main Sess,Staff,25,24,1,0,0
15998,Wolfson Campus,ENC 1102 - 0227   English Composition 2,0227-LEC Main Sess,Staff,25,0,25,0,0
15999,Wolfson Campus,ENC 1102 - 0228   English Composition 2,0228-LEC Main Sess,Staff,25,24,1,0,0
16000,Wolfson Campus,ENC 1102 - 0229   English Composition 2,0229-LEC Main Sess,Staff,25,24,1,0,0
16001,Wolfson Campus,ENC 1102 - 0230   English Composition 2,0230-LEC Main Sess,Staff,25,21,4,0,0
16218,Wolfson Campus,ENC 1102 - 0232   English Composition 2,0232-LEC Weekend,Staff,25,24,1,0,0
16212,Wolfson Campus,ENC 1102 - 0234   English Composition 2,0234-LEC 1st Mon Sp,Staff,25,23,2,0,0
16003,Wolfson Campus,ENC 1102 - 0235   English Composition 2,0235-LEC Main Sess,Staff,25,22,3,0,0
16004,Wolfson Campus,ENC 1102 - 0236   English Composition 2,0236-LEC Main Sess,Staff,25,0,25,0,0
16006,Wolfson Campus,ENC 1102 - 0238   English Composition 2,0238-LEC Main Sess,Staff,25,23,2,0,0
16008,Wolfson Campus,ENC 1102 - 0240   English Composition 2,0240-LEC Main Sess,Staff,25,23,2,0,0
16009,Wolfson Campus,ENC 1102 - 0241   English Composition 2,0241-LEC Main Sess,Staff,25,24,1,0,0
16010,Wolfson Campus,ENC 1102 - 0242   English Composition 2,0242-LEC Main Sess,Staff,25,23,2,0,0
16011,Wolfson Campus,ENC 1102 - 0243   English Composition 2,0243-LEC Main Sess,Staff,25,22,3,0,0
16012,Wolfson Campus,ENC 1102 - 0244   English Composition 2,0244-LEC Main Sess,Staff,25,24,1,0,0
16016,Wolfson Campus,ENC 1102 - 0248   English Composition 2,0248-LEC Main Sess,Staff,25,0,25,0,0
16017,Wolfson Campus,ENC 1102 - 0249   English Composition 2,0249-LEC Main Sess,Staff,1,0,1,0,0
16167,Wolfson Campus,ENC 1102 - 0250   English Composition 2,0250-LEC Twelve Wk,Staff,25,22,3,0,0
16018,Wolfson Campus,ENC 1102 - 0252   English Composition 2,0252-LEC Main Sess,Staff,25,19,6,0,0
16020,Wolfson Campus,ENC 1102 - 0254   English Composition 2,0254-LEC Main Sess,Staff,25,19,6,0,0
16022,Wolfson Campus,ENC 1102 - 0256   English Composition 2,0256-LEC Main Sess,Staff,25,23,2,0,0
16024,Wolfson Campus,ENC 1102 - 0258   English Composition 2,0258-LEC Main Sess,Staff,25,24,1,0,0
16025,Wolfson Campus,ENC 1102 - 0259   English Composition 2,0259-LEC Main Sess,Staff,29,28,1,0,0
16026,Wolfson Campus,ENC 1102 - 0260   English Composition 2,0260-LEC Main Sess,Staff,25,0,25,0,0
16027,Wolfson Campus,ENC 1102 - 0261   English Composition 2,0261-LEC Main Sess,Staff,25,21,4,0,0
16028,Wolfson Campus,ENC 1102 - 0262   English Composition 2,0262-LEC Main Sess,Staff,25,23,2,0,0
16029,Wolfson Campus,ENC 1102 - 0263   English Composition 2,0263-LEC Main Sess,Staff,25,0,25,0,0
16031,Wolfson Campus,ENC 1102 - 0265   English Composition 2,0265-LEC Main Sess,Staff,25,23,2,0,0
16032,Wolfson Campus,ENC 1102 - 0266   English Composition 2,0266-LEC Main Sess,Staff,25,24,1,0,0
16033,Wolfson Campus,ENC 1102 - 0267   English Composition 2,0267-LEC Main Sess,Staff,25,23,2,0,0
16034,Wolfson Campus,ENC 1102 - 0268   English Composition 2,0268-LEC Main Sess,Staff,25,0,25,0,0
16036,Wolfson Campus,ENC 1102 - 0270   English Composition 2,0270-LEC Main Sess,Staff,25,23,2,0,0
16038,Wolfson Campus,ENC 1102 - 0272   English Composition 2,0272-LEC Main Sess,Staff,25,23,2,0,0
16039,Wolfson Campus,ENC 1102 - 0273   English Composition 2,0273-LEC Main Sess,Staff,25,23,2,0,0
16042,Wolfson Campus,ENC 1102 - 0276   English Composition 2,0276-LEC Main Sess,Staff,25,24,1,0,0
16043,Wolfson Campus,ENC 1102 - 0277   English Composition 2,0277-LEC Main Sess,Staff,25,0,25,0,0
16047,Wolfson Campus,ENC 1102 - 0281   English Composition 2,0281-LEC Main Sess,Staff,25,22,3,0,0
16048,Wolfson Campus,ENC 1102 - 0282   English Composition 2,0282-LEC Main Sess,Staff,25,22,3,0,0
16190,Wolfson Campus,ENC 1102 - 0283   English Composition 2,0283-LEC Conversion,Staff,25,24,1,0,0
16050,Wolfson Campus,ENC 1102 - 0287   English Composition 2,0287-LEC Main Sess,Staff,25,24,1,0,0
16052,Wolfson Campus,ENC 1102 - 0289   English Composition 2,0289-LEC Main Sess,Staff,25,23,2,0,0
16053,Wolfson Campus,ENC 1102 - 0290   English Composition 2,0290-LEC Main Sess,Staff,25,23,2,0,0
16054,Wolfson Campus,ENC 1102 - 0291   English Composition 2,0291-LEC Main Sess,Staff,25,19,6,0,0
16055,Wolfson Campus,ENC 1102 - 0292   English Composition 2,0292-LEC Main Sess,Staff,25,23,2,0,0
16191,Wolfson Campus,ENC 1102 - 0293   English Composition 2,0293-LEC Conversion,Staff,25,23,2,0,0
16056,Wolfson Campus,ENC 1102 - 0294   English Composition 2,0294-LEC Main Sess,Staff,25,24,1,0,0
16057,Wolfson Campus,ENC 1102 - 0296   English Composition 2,0296-LEC Main Sess,Staff,25,24,1,0,0
16059,Wolfson Campus,ENC 1102 - 0298   English Composition 2,0298-LEC Main Sess,Staff,25,22,3,0,0
16193,Wolfson Campus,ENC 1102 - 0299   English Composition 2,0299-LEC Conversion,Staff,25,22,3,0,0
16060,Wolfson Campus,ENC 1102 - 0300   English Composition 2,0300-LEC Main Sess,Staff,25,22,3,0,0
16061,Wolfson Campus,ENC 1102 - 0301   English Composition 2,0301-LEC Main Sess,Staff,25,20,5,0,0
16062,Wolfson Campus,ENC 1102 - 0302   English Composition 2,0302-LEC Main Sess,Staff,25,21,4,0,0
16063,Wolfson Campus,ENC 1102 - 0303   English Composition 2,0303-LEC Main Sess,Staff,25,18,7,0,0
16064,Wolfson Campus,ENC 1102 - 0304   English Composition 2,0304-LEC Main Sess,Staff,25,0,25,0,0
16065,Wolfson Campus,ENC 1102 - 0305   English Composition 2,0305-LEC Main Sess,Staff,25,20,5,0,0
16194,Wolfson Campus,ENC 1102 - 0306   English Composition 2,0306-LEC Conversion,Staff,25,24,1,0,0
16066,Wolfson Campus,ENC 1102 - 0307   English Composition 2,0307-LEC Main Sess,Staff,25,22,3,0,0
16195,Wolfson Campus,ENC 1102 - 0308   English Composition 2,0308-LEC Conversion,Staff,25,0,25,0,0
16067,Wolfson Campus,ENC 1102 - 0309   English Composition 2,0309-LEC Main Sess,Staff,25,21,4,0,0
16196,Wolfson Campus,ENC 1102 - 0310   English Composition 2,0310-LEC Conversion,Staff,25,24,1,0,0
16068,Wolfson Campus,ENC 1102 - 0311   English Composition 2,0311-LEC Main Sess,Staff,25,21,4,0,0
16069,Wolfson Campus,ENC 1102 - 0312   English Composition 2,0312-LEC Main Sess,Staff,25,24,1,0,0
16070,Wolfson Campus,ENC 1102 - 0313   English Composition 2,0313-LEC Main Sess,Staff,25,22,3,0,0
16071,Wolfson Campus,ENC 1102 - 0314   English Composition 2,0314-LEC Main Sess,Staff,25,18,7,0,0
16072,Wolfson Campus,ENC 1102 - 0315   English Composition 2,0315-LEC Main Sess,Staff,25,21,4,0,0
16073,Wolfson Campus,ENC 1102 - 0316   English Composition 2,0316-LEC Main Sess,Staff,25,23,2,0,0
16074,Wolfson Campus,ENC 1102 - 0317   English Composition 2,0317-LEC Main Sess,Staff,25,22,3,0,0
16197,Wolfson Campus,ENC 1102 - 0318   English Composition 2,0318-LEC Conversion,Staff,25,0,25,0,0
16075,Wolfson Campus,ENC 1102 - 0319   English Composition 2,0319-LEC Main Sess,Staff,25,20,5,0,0
16077,Homestead Campus,ENC 1102 - 0321   English Composition 2,0321-LEC Main Sess,Staff,25,24,1,0,0
16219,Homestead Campus,ENC 1102 - 0322   English Composition 2,0322-LEC Weekend,Staff,25,21,4,0,0
16078,Homestead Campus,ENC 1102 - 0323   English Composition 2,0323-LEC Main Sess,Staff,25,22,3,0,0
16079,Homestead Campus,ENC 1102 - 0324   English Composition 2,0324-LEC Main Sess,Staff,25,24,1,0,0
16080,Homestead Campus,ENC 1102 - 0325   English Composition 2,0325-LEC Main Sess,Staff,25,22,3,0,0
16082,Homestead Campus,ENC 1102 - 0327   English Composition 2,0327-LEC Main Sess,Staff,25,24,1,0,0
16178,Homestead Campus,ENC 1102 - 0332   English Composition 2,0332-LEC Eight Wk 2,Staff,25,24,1,0,0
16085,Homestead Campus,ENC 1102 - 0334   English Composition 2,0334-LEC Main Sess,Staff,25,0,25,0,0
16086,Homestead Campus,ENC 1102 - 0335   English Composition 2,0335-LEC Main Sess,Staff,25,24,1,0,0
16180,Homestead Campus,ENC 1102 - 0337   English Composition 2,0337-LEC Eight Wk 2,Staff,25,0,25,0,0
16088,InterAmerican Campus,ENC 1102 - 0340   English Composition 2,0340-LEC Main Sess,Staff,25,0,25,0,0
16089,InterAmerican Campus,ENC 1102 - 0341   English Composition 2,0341-LEC Main Sess,Staff,16,15,1,0,0
16090,InterAmerican Campus,ENC 1102 - 0342   English Composition 2,0342-LEC Main Sess,Staff,16,10,6,0,0
16172,InterAmerican Campus,ENC 1102 - 0343   English Composition 2,0343-LEC Eight Wk 1,Staff,25,21,4,0,0
16181,InterAmerican Campus,ENC 1102 - 0344   English Composition 2,0344-LEC Eight Wk 2,Staff,25,0,25,0,0
16091,InterAmerican Campus,ENC 1102 - 0345   English Composition 2,0345-LEC Main Sess,Staff,25,19,6,0,0
16092,InterAmerican Campus,ENC 1102 - 0346   English Composition 2,0346-LEC Main Sess,Staff,25,21,4,0,0
16182,InterAmerican Campus,ENC 1102 - 0347   English Composition 2,0347-LEC Eight Wk 2,Staff,25,22,3,0,0
16094,InterAmerican Campus,ENC 1102 - 0349   English Composition 2,0349-LEC Main Sess,Staff,25,0,25,0,0
16095,InterAmerican Campus,ENC 1102 - 0350   English Composition 2,0350-LEC Main Sess,Staff,25,19,6,0,0
16096,InterAmerican Campus,ENC 1102 - 0351   English Composition 2,0351-LEC Main Sess,Staff,25,16,9,0,0
16097,InterAmerican Campus,ENC 1102 - 0352   English Composition 2,0352-LEC Main Sess,Staff,25,24,1,0,0
16152,InterAmerican Campus,ENC 1102 - 0354   English Composition 2,0354-LEC Main Sess,Staff,25,23,2,0,0
16099,InterAmerican Campus,ENC 1102 - 0355   English Composition 2,0355-LEC Main Sess,Staff,25,0,25,0,0
16100,InterAmerican Campus,ENC 1102 - 0356   English Composition 2,0356-LEC Main Sess,Staff,30,19,11,0,0
16101,InterAmerican Campus,ENC 1102 - 0357   English Composition 2,0357-LEC Main Sess,Staff,25,15,10,0,0
16102,InterAmerican Campus,ENC 1102 - 0358   English Composition 2,0358-LEC Main Sess,Staff,25,6,19,0,0
16103,InterAmerican Campus,ENC 1102 - 0360   English Composition 2,0360-LEC Main Sess,Staff,22,21,1,0,0
16188,InterAmerican Campus,ENC 1102 - 0361   English Composition 2,0361-LEC Conversion,Staff,25,15,10,0,0
16104,InterAmerican Campus,ENC 1102 - 0362   English Composition 2,0362-LEC Main Sess,Staff,25,11,14,0,0
16107,InterAmerican Campus,ENC 1102 - 0365   English Composition 2,0365-LEC Main Sess,Staff,25,22,3,0,0
16183,InterAmerican Campus,ENC 1102 - 0366   English Composition 2,0366-LEC Eight Wk 2,Staff,25,21,4,0,0
16108,InterAmerican Campus,ENC 1102 - 0367   English Composition 2,0367-LEC Main Sess,Staff,25,18,7,0,0
16109,InterAmerican Campus,ENC 1102 - 0368   English Composition 2,0368-LEC Main Sess,Staff,25,18,7,0,0
16110,Hialeah Campus,ENC 1102 - 0369   English Composition 2,0369-LEC Main Sess,Staff,25,21,4,0,0
16111,Hialeah Campus,ENC 1102 - 0370   English Composition 2,0370-LEC Main Sess,Staff,25,24,1,0,0
16154,Hialeah Campus,ENC 1102 - 0373   English Composition 2,0373-LEC Main Sess,Staff,25,0,25,0,0
16113,Hialeah Campus,ENC 1102 - 0374   English Composition 2,0374-LEC Main Sess,Staff,25,0,25,0,0
16114,Hialeah Campus,ENC 1102 - 0375   English Composition 2,0375-LEC Main Sess,Staff,25,23,2,0,0
16211,Hialeah Campus,ENC 1102 - 0376   English Composition 2,0376-LEC 1st Mon Sp,Staff,25,23,2,0,0
16115,Hialeah Campus,ENC 1102 - 0377   English Composition 2,0377-LEC Main Sess,Staff,25,13,12,0,0
16116,Hialeah Campus,ENC 1102 - 0378   English Composition 2,0378-LEC Main Sess,Staff,25,0,25,0,0
16117,Hialeah Campus,ENC 1102 - 0379   English Composition 2,0379-LEC Main Sess,Staff,25,18,7,0,0
16118,Hialeah Campus,ENC 1102 - 0380   English Composition 2,0380-LEC Main Sess,Staff,25,21,4,0,0
16120,Hialeah Campus,ENC 1102 - 0382   English Composition 2,0382-LEC Main Sess,Staff,25,23,2,0,0
16121,Hialeah Campus,ENC 1102 - 0383   English Composition 2,0383-LEC Main Sess,Staff,25,24,1,0,0
16122,Hialeah Campus,ENC 1102 - 0384   English Composition 2,0384-LEC Main Sess,Staff,25,23,2,0,0
16123,Hialeah Campus,ENC 1102 - 0385   English Composition 2,0385-LEC Main Sess,Staff,25,24,1,0,0
16124,Hialeah Campus,ENC 1102 - 0386   English Composition 2,0386-LEC Main Sess,Staff,25,23,2,0,0
16125,Hialeah Campus,ENC 1102 - 0387   English Composition 2,0387-LEC Main Sess,Staff,25,23,2,0,0
16127,Hialeah Campus,ENC 1102 - 0389   English Composition 2,0389-LEC Main Sess,Staff,25,24,1,0,0
16128,Hialeah Campus,ENC 1102 - 0390   English Composition 2,0390-LEC Main Sess,Staff,25,18,7,0,0
16202,Hialeah Campus,ENC 1102 - 0391   English Composition 2,0391-LEC Conversion,Staff,25,21,4,0,0
16169,Hialeah Campus,ENC 1102 - 0392   English Composition 2,0392-LEC Twelve Wk,Staff,25,24,1,0,0
16129,Hialeah Campus,ENC 1102 - 0393   English Composition 2,0393-LEC Main Sess,Staff,25,24,1,0,0
16130,Hialeah Campus,ENC 1102 - 0394   English Composition 2,0394-LEC Main Sess,Staff,25,22,3,0,0
16131,Hialeah Campus,ENC 1102 - 0395   English Composition 2,0395-LEC Main Sess,Staff,25,20,5,0,0
16132,Hialeah Campus,ENC 1102 - 0396   English Composition 2,0396-LEC Main Sess,Staff,25,15,10,0,0
16220,Hialeah Campus,ENC 1102 - 0398   English Composition 2,0398-LEC Weekend,Staff,25,0,25,0,0
16156,Hialeah Campus,ENC 1102 - 0399   English Composition 2,0399-LEC Twelve Wk,Staff,25,0,25,0,0
16135,Hialeah Campus,ENC 1102 - 0402   English Composition 2,0402-LEC Main Sess,Staff,25,24,1,0,0
16136,Hialeah Campus,ENC 1102 - 0403   English Composition 2,0403-LEC Main Sess,Staff,25,23,2,0,0
16137,Hialeah Campus,ENC 1102 - 0404   English Composition 2,0404-LEC Main Sess,Staff,25,19,6,0,0
16138,West Campus,ENC 1102 - 0405   English Composition 2,0405-LEC Main Sess,Staff,25,24,1,0,0
16139,West Campus,ENC 1102 - 0406   English Composition 2,0406-LEC Main Sess,Staff,25,24,1,0,0
16140,West Campus,ENC 1102 - 0407   English Composition 2,0407-LEC Main Sess,Staff,25,20,5,0,0
16209,West Campus,ENC 1102 - 0408   English Composition 2,0408-LEC 1st Mon Sp,Staff,25,22,3,0,0
16142,West Campus,ENC 1102 - 0410   English Composition 2,0410-LEC Main Sess,Staff,25,0,25,0,0
16203,West Campus,ENC 1102 - 0411   English Composition 2,0411-LEC Conversion,Staff,25,24,1,0,0
16204,West Campus,ENC 1102 - 0412   English Composition 2,0412-LEC Conversion,Staff,25,24,1,0,0
16144,West Campus,ENC 1102 - 0414   English Composition 2,0414-LEC Main Sess,Staff,25,14,11,0,0
16145,West Campus,ENC 1102 - 0415   English Composition 2,0415-LEC Main Sess,Staff,25,21,4,0,0
16146,West Campus,ENC 1102 - 0416   English Composition 2,0416-LEC Main Sess,Staff,25,21,4,0,0
16147,West Campus,ENC 1102 - 0417   English Composition 2,0417-LEC Main Sess,Staff,25,24,1,0,0
16151,West Campus,ENC 1102 - 0421   English Composition 2,0421-LEC Main Sess,Staff,25,23,2,0,0
16176,West Campus,ENC 1102 - 0422   English Composition 2,0422-LEC Eight Wk 2,Staff,25,21,4,0,0
6888,Homestead Campus,ATT 1101 - 0001   Private Pilot Applications,0001-LEC Main Sess,Staff,30,17,13,0,0
14918,North Campus,ENC 1101 - 0001   English Composition 1,0001-LEC Main Sess,Staff,25,18,7,0,0
14919,North Campus,ENC 1101 - 0002   English Composition 1,0002-LEC Main Sess,Staff,25,20,5,0,0
14920,North Campus,ENC 1101 - 0003   English Composition 1,0003-LEC Main Sess,Staff,25,15,10,0,0
14921,North Campus,ENC 1101 - 0004   English Composition 1,0004-LEC Main Sess,Staff,24,23,1,0,0
14922,North Campus,ENC 1101 - 0005   English Composition 1,0005-LEC Main Sess,Staff,25,17,8,0,0
14923,North Campus,ENC 1101 - 0006   English Composition 1,0006-LEC Main Sess,Staff,24,22,2,0,0
14924,North Campus,ENC 1101 - 0007   English Composition 1,0007-LEC Main Sess,Staff,25,0,25,0,0
14925,North Campus,ENC 1101 - 0008   English Composition 1,0008-LEC Main Sess,Staff,25,13,12,0,0
15217,North Campus,ENC 1101 - 0009   English Composition 1,0009-LEC Eight Wk 2,Staff,25,0,25,0,0
15216,North Campus,ENC 1101 - 0010   English Composition 1,0010-LEC Eight Wk 2,Staff,25,0,25,0,0
15215,North Campus,ENC 1101 - 0011   English Composition 1,0011-LEC Eight Wk 2,Staff,25,0,25,0,0
14926,North Campus,ENC 1101 - 0012   English Composition 1,0012-LEC Main Sess,Staff,24,21,3,0,0
14927,North Campus,ENC 1101 - 0013   English Composition 1,0013-LEC Main Sess,Staff,19,18,1,0,0
14928,North Campus,ENC 1101 - 0014   English Composition 1,0014-LEC Main Sess,Staff,16,14,2,0,0
14929,North Campus,ENC 1101 - 0015   English Composition 1,0015-LEC Main Sess,Staff,25,11,14,0,0
14930,North Campus,ENC 1101 - 0016   English Composition 1,0016-LEC Main Sess,Staff,20,16,4,0,0
14931,North Campus,ENC 1101 - 0017   English Composition 1,0017-LEC Main Sess,Staff,17,13,4,0,0
14932,North Campus,ENC 1101 - 0018   English Composition 1,0018-LEC Main Sess,Staff,21,20,1,0,0
14933,North Campus,ENC 1101 - 0019   English Composition 1,0019-LEC Main Sess,Staff,25,12,13,0,0
14934,North Campus,ENC 1101 - 0020   English Composition 1,0020-LEC Main Sess,Staff,25,13,12,0,0
14935,North Campus,ENC 1101 - 0021   English Composition 1,0021-LEC Main Sess,Staff,25,24,1,0,0
15158,North Campus,ENC 1101 - 0022   English Composition 1,0022-LEC Twelve Wk,Staff,24,23,1,0,0
14936,North Campus,ENC 1101 - 0023   English Composition 1,0023-LEC Main Sess,Staff,1,0,1,0,0
15214,North Campus,ENC 1101 - 0024   English Composition 1,0024-LEC Eight Wk 2,Staff,25,0,25,0,0
14937,North Campus,ENC 1101 - 0025   English Composition 1,0025-LEC Main Sess,Staff,25,19,6,0,0
15185,North Campus,ENC 1101 - 0026   English Composition 1,0026-LEC Twelve Wk,Staff,25,21,4,0,0
14938,North Campus,ENC 1101 - 0027   English Composition 1,0027-LEC Main Sess,Staff,25,23,2,0,0
14939,North Campus,ENC 1101 - 0028   English Composition 1,0028-LEC Main Sess,Staff,25,14,11,0,0
14940,North Campus,ENC 1101 - 0029   English Composition 1,0029-LEC Main Sess,Staff,21,19,2,0,0
14941,North Campus,ENC 1101 - 0030   English Composition 1,0030-LEC Main Sess,Staff,18,17,1,0,0
14942,North Campus,ENC 1101 - 0031   English Composition 1,0031-LEC Main Sess,Staff,24,22,2,0,0
14943,North Campus,ENC 1101 - 0032   English Composition 1,0032-LEC Main Sess,Staff,25,0,25,0,0
14944,North Campus,ENC 1101 - 0033   English Composition 1,0033-LEC Main Sess,Staff,19,17,2,0,0
14945,North Campus,ENC 1101 - 0034   English Composition 1,0034-LEC Main Sess,Staff,25,0,25,0,0
14946,North Campus,ENC 1101 - 0035   English Composition 1,0035-LEC Main Sess,Staff,25,22,3,0,0
14947,North Campus,ENC 1101 - 0036   English Composition 1,0036-LEC Main Sess,Staff,25,20,5,0,0
14948,North Campus,ENC 1101 - 0037   English Composition 1,0037-LEC Main Sess,Staff,21,15,6,0,0
14949,North Campus,ENC 1101 - 0038   English Composition 1,0038-LEC Main Sess,Staff,25,16,9,0,0
14950,North Campus,ENC 1101 - 0039   English Composition 1,0039-LEC Main Sess,Staff,25,0,25,0,0
14951,North Campus,ENC 1101 - 0040   English Composition 1,0040-LEC Main Sess,Staff,25,0,25,0,0
14952,North Campus,ENC 1101 - 0041   English Composition 1,0041-LEC Main Sess,Staff,21,15,6,0,0
14953,North Campus,ENC 1101 - 0042   English Composition 1,0042-LEC Main Sess,Staff,25,0,25,0,0
15160,North Campus,ENC 1101 - 0043   English Composition 1,0043-LEC Twelve Wk,Staff,25,23,2,0,0
15162,North Campus,ENC 1101 - 0045   English Composition 1,0045-LEC Twelve Wk,Staff,25,22,3,0,0
14954,North Campus,ENC 1101 - 0046   English Composition 1,0046-LEC Main Sess,Staff,25,19,6,0,0
14955,North Campus,ENC 1101 - 0047   English Composition 1,0047-LEC Main Sess,Staff,25,22,3,0,0
14956,North Campus,ENC 1101 - 0048   English Composition 1,0048-LEC Main Sess,Staff,25,22,3,0,0
15195,North Campus,ENC 1101 - 0049   English Composition 1,0049-LEC Eight Wk 1,Staff,25,13,12,0,0
14957,North Campus,ENC 1101 - 0050   English Composition 1,0050-LEC Main Sess,Staff,25,23,2,0,0
14958,North Campus,ENC 1101 - 0051   English Composition 1,0051-LEC Main Sess,Staff,25,23,2,0,0
14959,North Campus,ENC 1101 - 0052   English Composition 1,0052-LEC Main Sess,Staff,18,16,2,0,0
14960,North Campus,ENC 1101 - 0053   English Composition 1,0053-LEC Main Sess,Staff,21,18,3,0,0
14961,North Campus,ENC 1101 - 0054   English Composition 1,0054-LEC Main Sess,Staff,25,17,8,0,0
14962,North Campus,ENC 1101 - 0055   English Composition 1,0055-LEC Main Sess,Staff,19,13,6,0,0
14963,North Campus,ENC 1101 - 0056   English Composition 1,0056-LEC Main Sess,Staff,24,23,1,0,0
14964,North Campus,ENC 1101 - 0057   English Composition 1,0057-LEC Main Sess,Staff,25,24,1,0,0
14965,North Campus,ENC 1101 - 0058   English Composition 1,0058-LEC Main Sess,Staff,25,21,4,0,0
14966,North Campus,ENC 1101 - 0059   English Composition 1,0059-LEC Main Sess,Staff,25,0,25,0,0
15246,North Campus,ENC 1101 - 0060   English Composition 1,0060-LEC Weekend,Staff,25,0,25,0,0
15163,North Campus,ENC 1101 - 0061   English Composition 1,0061-LEC Twelve Wk,Staff,25,23,2,0,0
15164,North Campus,ENC 1101 - 0062   English Composition 1,0062-LEC Twelve Wk,Staff,25,24,1,0,0
15194,North Campus,ENC 1101 - 0063   English Composition 1,0063-LEC Eight Wk 1,Staff,25,0,25,0,0
15165,North Campus,ENC 1101 - 0064   English Composition 1,0064-LEC Twelve Wk,Staff,25,0,25,0,0
15166,North Campus,ENC 1101 - 0065   English Composition 1,0065-LEC Twelve Wk,Staff,25,18,7,0,0
14967,North Campus,ENC 1101 - 0066   English Composition 1,0066-LEC Main Sess,Staff,25,21,4,0,0
15213,North Campus,ENC 1101 - 0067   English Composition 1,0067-LEC Eight Wk 2,Staff,25,0,25,0,0
15167,North Campus,ENC 1101 - 0068   English Composition 1,0068-LEC Twelve Wk,Staff,4,0,4,0,0
14968,North Campus,ENC 1101 - 0069   English Composition 1,0069-LEC Main Sess,Staff,25,15,10,0,0
15218,North Campus,ENC 1101 - 0070   English Composition 1,0070-LEC Eight Wk 2,Staff,25,0,25,0,0
14969,North Campus,ENC 1101 - 0071   English Composition 1,0071-LEC Main Sess,Staff,25,14,11,0,0
15168,North Campus,ENC 1101 - 0072   English Composition 1,0072-LEC Twelve Wk,Staff,25,22,3,0,0
14970,North Campus,ENC 1101 - 0073   English Composition 1,0073-LEC Main Sess,Staff,25,10,15,0,0
14971,North Campus,ENC 1101 - 0074   English Composition 1,0074-LEC Main Sess,Staff,25,0,25,0,0
15247,North Campus,ENC 1101 - 0075   English Composition 1,0075-LEC Weekend,Staff,25,0,25,0,0
14972,Kendall Campus,ENC 1101 - 0077   English Composition 1,0077-LEC Main Sess,Staff,1,0,1,0,0
14974,Kendall Campus,ENC 1101 - 0079   English Composition 1,0079-LEC Main Sess,Staff,25,20,5,0,0
14975,Kendall Campus,ENC 1101 - 0080   English Composition 1,0080-LEC Main Sess,Staff,25,19,6,0,0
14977,Kendall Campus,ENC 1101 - 0082   English Composition 1,0082-LEC Main Sess,Staff,25,24,1,0,0
14978,Kendall Campus,ENC 1101 - 0083   English Composition 1,0083-LEC Main Sess,Staff,1,0,1,0,0
14979,Kendall Campus,ENC 1101 - 0084   English Composition 1,0084-LEC Main Sess,Staff,25,17,8,0,0
14980,Kendall Campus,ENC 1101 - 0085   English Composition 1,0085-LEC Main Sess,Staff,1,0,1,0,0
14981,Kendall Campus,ENC 1101 - 0086   English Composition 1,0086-LEC Main Sess,Staff,25,24,1,0,0
14983,Kendall Campus,ENC 1101 - 0088   English Composition 1,0088-LEC Main Sess,Staff,25,24,1,0,0
14984,Kendall Campus,ENC 1101 - 0089   English Composition 1,0089-LEC Main Sess,Staff,25,21,4,0,0
14985,Kendall Campus,ENC 1101 - 0090   English Composition 1,0090-LEC Main Sess,Staff,25,23,2,0,0
14987,Kendall Campus,ENC 1101 - 0092   English Composition 1,0092-LEC Main Sess,Staff,25,22,3,0,0
14989,Kendall Campus,ENC 1101 - 0094   English Composition 1,0094-LEC Main Sess,Staff,25,22,3,0,0
14990,Kendall Campus,ENC 1101 - 0095   English Composition 1,0095-LEC Main Sess,Staff,25,23,2,0,0
15248,Kendall Campus,ENC 1101 - 0096   English Composition 1,0096-LEC Weekend,Staff,25,19,6,0,0
15169,Kendall Campus,ENC 1101 - 0097   English Composition 1,0097-LEC Twelve Wk,Staff,25,24,1,0,0
14991,Kendall Campus,ENC 1101 - 0098   English Composition 1,0098-LEC Main Sess,Staff,25,14,11,0,0
15170,Kendall Campus,ENC 1101 - 0099   English Composition 1,0099-LEC Twelve Wk,Staff,25,22,3,0,0
14992,Kendall Campus,ENC 1101 - 0101   English Composition 1,0101-LEC Main Sess,Staff,25,23,2,0,0
14993,Kendall Campus,ENC 1101 - 0102   English Composition 1,0102-LEC Main Sess,Staff,1,0,1,0,0
14994,Kendall Campus,ENC 1101 - 0103   English Composition 1,0103-LEC Main Sess,Staff,25,23,2,0,0
15193,Kendall Campus,ENC 1101 - 0104   English Composition 1,0104-LEC Eight Wk 1,Staff,25,22,3,0,0
15211,Kendall Campus,ENC 1101 - 0106   English Composition 1,0106-LEC Eight Wk 2,Staff,25,24,1,0,0
15240,Kendall Campus,ENC 1101 - 0107   English Composition 1,0107-LEC Conversion,Staff,25,22,3,0,0
15210,Kendall Campus,ENC 1101 - 0108   English Composition 1,0108-LEC Eight Wk 2,Staff,25,23,2,0,0
14995,Kendall Campus,ENC 1101 - 0109   English Composition 1,0109-LEC Main Sess,Staff,25,24,1,0,0
14998,Kendall Campus,ENC 1101 - 0112   English Composition 1,0112-LEC Main Sess,Staff,25,23,2,0,0
15000,Kendall Campus,ENC 1101 - 0114   English Composition 1,0114-LEC Main Sess,Staff,25,21,4,0,0
15004,Kendall Campus,ENC 1101 - 0118   English Composition 1,0118-LEC Main Sess,Staff,1,0,1,0,0
15005,Kendall Campus,ENC 1101 - 0119   English Composition 1,0119-LEC Main Sess,Staff,25,23,2,0,0
15008,Kendall Campus,ENC 1101 - 0122   English Composition 1,0122-LEC Main Sess,Staff,25,24,1,0,0
15009,Kendall Campus,ENC 1101 - 0123   English Composition 1,0123-LEC Main Sess,Staff,25,22,3,0,0
15010,Kendall Campus,ENC 1101 - 0124   English Composition 1,0124-LEC Main Sess,Staff,25,17,8,0,0
15011,Kendall Campus,ENC 1101 - 0125   English Composition 1,0125-LEC Main Sess,Staff,25,20,5,0,0
15012,Kendall Campus,ENC 1101 - 0126   English Composition 1,0126-LEC Main Sess,Staff,8,0,8,0,0
15013,Kendall Campus,ENC 1101 - 0127   English Composition 1,0127-LEC Main Sess,Staff,25,18,7,0,0
15238,Kendall Campus,ENC 1101 - 0128   English Composition 1,0128-LEC Conversion,Staff,25,18,7,0,0
15253,Kendall Campus,ENC 1101 - 0129   English Composition 1,0129-LEC Weekend,Staff,25,0,25,0,0
15173,Kendall Campus,ENC 1101 - 0130   English Composition 1,0130-LEC Twelve Wk,Staff,1,0,1,0,0
15250,Kendall Campus,ENC 1101 - 0132   English Composition 1,0132-LEC Weekend,Staff,4,0,4,0,0
15014,Kendall Campus,ENC 1101 - 0133   English Composition 1,0133-LEC Main Sess,Staff,25,23,2,0,0
15176,Kendall Campus,ENC 1101 - 0135   English Composition 1,0135-LEC Twelve Wk,Staff,1,0,1,0,0
15017,Kendall Campus,ENC 1101 - 0138   English Composition 1,0138-LEC Main Sess,Staff,25,24,1,0,0
15018,Kendall Campus,ENC 1101 - 0139   English Composition 1,0139-LEC Main Sess,Staff,25,23,2,0,0
15021,Kendall Campus,ENC 1101 - 0142   English Composition 1,0142-LEC Main Sess,Staff,25,22,3,0,0
15022,Kendall Campus,ENC 1101 - 0143   English Composition 1,0143-LEC Main Sess,Staff,25,24,1,0,0
15023,Kendall Campus,ENC 1101 - 0144   English Composition 1,0144-LEC Main Sess,Staff,25,0,25,0,0
15024,Kendall Campus,ENC 1101 - 0145   English Composition 1,0145-LEC Main Sess,Staff,25,22,3,0,0
15025,Kendall Campus,ENC 1101 - 0146   English Composition 1,0146-LEC Main Sess,Staff,25,14,11,0,0
15026,Kendall Campus,ENC 1101 - 0147   English Composition 1,0147-LEC Main Sess,Staff,25,20,5,0,0
15027,Kendall Campus,ENC 1101 - 0148   English Composition 1,0148-LEC Main Sess,Staff,25,24,1,0,0
15028,Kendall Campus,ENC 1101 - 0149   English Composition 1,0149-LEC Main Sess,Staff,4,0,4,0,0
15030,Kendall Campus,ENC 1101 - 0151   English Composition 1,0151-LEC Main Sess,Staff,25,24,1,0,0
15177,Kendall Campus,ENC 1101 - 0152   English Composition 1,0152-LEC Twelve Wk,Staff,25,23,2,0,0
15178,Kendall Campus,ENC 1101 - 0153   English Composition 1,0153-LEC Twelve Wk,Staff,25,23,2,0,0
15031,Kendall Campus,ENC 1101 - 0154   English Composition 1,0154-LEC Main Sess,Staff,25,22,3,0,0
15032,Kendall Campus,ENC 1101 - 0155   English Composition 1,0155-LEC Main Sess,Staff,1,0,1,0,0
15033,Kendall Campus,ENC 1101 - 0156   English Composition 1,0156-LEC Main Sess,Staff,25,24,1,0,0
15034,Kendall Campus,ENC 1101 - 0157   English Composition 1,0157-LEC Main Sess,Staff,25,15,10,0,0
15035,Kendall Campus,ENC 1101 - 0158   English Composition 1,0158-LEC Main Sess,Staff,25,22,3,0,0
15036,Kendall Campus,ENC 1101 - 0159   English Composition 1,0159-LEC Main Sess,Staff,25,22,3,0,0
15037,Kendall Campus,ENC 1101 - 0160   English Composition 1,0160-LEC Main Sess,Staff,25,24,1,0,0
15038,Kendall Campus,ENC 1101 - 0161   English Composition 1,0161-LEC Main Sess,Staff,25,24,1,0,0
15039,Kendall Campus,ENC 1101 - 0162   English Composition 1,0162-LEC Main Sess,Staff,25,22,3,0,0
15040,Kendall Campus,ENC 1101 - 0163   English Composition 1,0163-LEC Main Sess,Staff,5,0,5,0,0
15041,Kendall Campus,ENC 1101 - 0164   English Composition 1,0164-LEC Main Sess,Staff,1,0,1,0,0
15043,Kendall Campus,ENC 1101 - 0166   English Composition 1,0166-LEC Main Sess,Staff,25,24,1,0,0
15044,Kendall Campus,ENC 1101 - 0167   English Composition 1,0167-LEC Main Sess,Staff,25,22,3,0,0
15045,Kendall Campus,ENC 1101 - 0168   English Composition 1,0168-LEC Main Sess,Staff,25,23,2,0,0
15046,Kendall Campus,ENC 1101 - 0169   English Composition 1,0169-LEC Main Sess,Staff,1,0,1,0,0
15047,Kendall Campus,ENC 1101 - 0171   English Composition 1,0171-LEC Main Sess,Staff,25,22,3,0,0
15048,Kendall Campus,ENC 1101 - 0172   English Composition 1,0172-LEC Main Sess,Staff,25,22,3,0,0
15049,Kendall Campus,ENC 1101 - 0173   English Composition 1,0173-LEC Main Sess,Staff,25,20,5,0,0
15050,Kendall Campus,ENC 1101 - 0174   English Composition 1,0174-LEC Main Sess,Staff,25,18,7,0,0
15052,Wolfson Campus,ENC 1101 - 0176   English Composition 1,0176-LEC Main Sess,Staff,25,23,2,0,0
15053,Wolfson Campus,ENC 1101 - 0177   English Composition 1,0177-LEC Main Sess,Staff,25,21,4,0,0
15054,Wolfson Campus,ENC 1101 - 0178   English Composition 1,0178-LEC Main Sess,Staff,25,23,2,0,0
15056,Wolfson Campus,ENC 1101 - 0180   English Composition 1,0180-LEC Main Sess,Staff,25,23,2,0,0
15057,Wolfson Campus,ENC 1101 - 0181   English Composition 1,0181-LEC Main Sess,Staff,25,23,2,0,0
15059,Wolfson Campus,ENC 1101 - 0183   English Composition 1,0183-LEC Main Sess,Staff,25,18,7,0,0
15060,Wolfson Campus,ENC 1101 - 0184   English Composition 1,0184-LEC Main Sess,Staff,25,21,4,0,0
15061,Wolfson Campus,ENC 1101 - 0185   English Composition 1,0185-LEC Main Sess,Staff,25,0,25,0,0
15251,Wolfson Campus,ENC 1101 - 0186   English Composition 1,0186-LEC Weekend,Staff,25,24,1,0,0
15062,Wolfson Campus,ENC 1101 - 0187   English Composition 1,0187-LEC Main Sess,Staff,25,23,2,0,0
15064,Wolfson Campus,ENC 1101 - 0189   English Composition 1,0189-LEC Main Sess,Staff,25,24,1,0,0
15065,Wolfson Campus,ENC 1101 - 0190   English Composition 1,0190-LEC Main Sess,Staff,25,23,2,0,0
15066,Wolfson Campus,ENC 1101 - 0191   English Composition 1,0191-LEC Main Sess,Staff,25,22,3,0,0
15067,Wolfson Campus,ENC 1101 - 0192   English Composition 1,0192-LEC Main Sess,Staff,25,22,3,0,0
15068,Wolfson Campus,ENC 1101 - 0193   English Composition 1,0193-LEC Main Sess,Staff,25,20,5,0,0
15069,Wolfson Campus,ENC 1101 - 0194   English Composition 1,0194-LEC Main Sess,Staff,25,0,25,0,0
15070,Wolfson Campus,ENC 1101 - 0195   English Composition 1,0195-LEC Main Sess,Staff,25,19,6,0,0
15071,Wolfson Campus,ENC 1101 - 0196   English Composition 1,0196-LEC Main Sess,Staff,25,0,25,0,0
15209,Wolfson Campus,ENC 1101 - 0197   English Composition 1,0197-LEC Eight Wk 2,Staff,25,23,2,0,0
15242,Wolfson Campus,ENC 1101 - 0198   English Composition 1,0198-LEC 1st Mon Sp,Staff,25,22,3,0,0
15074,Wolfson Campus,ENC 1101 - 0201   English Composition 1,0201-LEC Main Sess,Staff,25,24,1,0,0
15075,Wolfson Campus,ENC 1101 - 0202   English Composition 1,0202-LEC Main Sess,Staff,25,22,3,0,0
15076,Wolfson Campus,ENC 1101 - 0203   English Composition 1,0203-LEC Main Sess,Staff,25,23,2,0,0
15077,Wolfson Campus,ENC 1101 - 0205   English Composition 1,0205-LEC Main Sess,Staff,25,20,5,0,0
15078,Wolfson Campus,ENC 1101 - 0206   English Composition 1,0206-LEC Main Sess,Staff,25,24,1,0,0
15079,Wolfson Campus,ENC 1101 - 0207   English Composition 1,0207-LEC Main Sess,Staff,25,22,3,0,0
15080,Wolfson Campus,ENC 1101 - 0208   English Composition 1,0208-LEC Main Sess,Staff,25,17,8,0,0
15081,Wolfson Campus,ENC 1101 - 0209   English Composition 1,0209-LEC Main Sess,Staff,25,17,8,0,0
15207,Wolfson Campus,ENC 1101 - 0210   English Composition 1,0210-LEC Eight Wk 2,Staff,25,24,1,0,0
15192,Wolfson Campus,ENC 1101 - 0212   English Composition 1,0212-LEC Eight Wk 1,Staff,25,16,9,0,0
15082,Wolfson Campus,ENC 1101 - 0214   English Composition 1,0214-LEC Main Sess,Staff,25,22,3,0,0
15083,Wolfson Campus,ENC 1101 - 0215   English Composition 1,0215-LEC Main Sess,Staff,25,19,6,0,0
15084,Wolfson Campus,ENC 1101 - 0216   English Composition 1,0216-LEC Main Sess,Staff,25,21,4,0,0
15085,Wolfson Campus,ENC 1101 - 0217   English Composition 1,0217-LEC Main Sess,Staff,25,16,9,0,0
15087,Wolfson Campus,ENC 1101 - 0219   English Composition 1,0219-LEC Main Sess,Staff,25,19,6,0,0
15089,Wolfson Campus,ENC 1101 - 0221   English Composition 1,0221-LEC Main Sess,Staff,25,19,6,0,0
15090,Wolfson Campus,ENC 1101 - 0222   English Composition 1,0222-LEC Main Sess,Staff,25,20,5,0,0
15245,Wolfson Campus,ENC 1101 - 0223   English Composition 1,0223-LEC 1st Mon Sp,Staff,25,20,5,0,0
15091,Wolfson Campus,ENC 1101 - 0224   English Composition 1,0224-LEC Main Sess,Staff,25,0,25,0,0
15199,Wolfson Campus,ENC 1101 - 0225   English Composition 1,0225-LEC Eight Wk 2,Staff,25,24,1,0,0
15092,Wolfson Campus,ENC 1101 - 0226   English Composition 1,0226-LEC Main Sess,Staff,25,22,3,0,0
15093,Wolfson Campus,ENC 1101 - 0227   English Composition 1,0227-LEC Main Sess,Staff,25,21,4,0,0
15094,Wolfson Campus,ENC 1101 - 0228   English Composition 1,0228-LEC Main Sess,Staff,25,23,2,0,0
15095,Wolfson Campus,ENC 1101 - 0229   English Composition 1,0229-LEC Main Sess,Staff,25,21,4,0,0
15097,Wolfson Campus,ENC 1101 - 0231   English Composition 1,0231-LEC Main Sess,Staff,25,23,2,0,0
15098,Wolfson Campus,ENC 1101 - 0232   English Composition 1,0232-LEC Main Sess,Staff,25,23,2,0,0
15224,Wolfson Campus,ENC 1101 - 0233   English Composition 1,0233-LEC Conversion,Staff,25,18,7,0,0
15225,Wolfson Campus,ENC 1101 - 0234   English Composition 1,0234-LEC Conversion,Staff,25,23,2,0,0
15226,Wolfson Campus,ENC 1101 - 0235   English Composition 1,0235-LEC Conversion,Staff,25,21,4,0,0
15099,Wolfson Campus,ENC 1101 - 0236   English Composition 1,0236-LEC Main Sess,Staff,25,21,4,0,0
15101,Wolfson Campus,ENC 1101 - 0238   English Composition 1,0238-LEC Main Sess,Staff,25,24,1,0,0
15102,Wolfson Campus,ENC 1101 - 0239   English Composition 1,0239-LEC Main Sess,Staff,25,22,3,0,0
15103,Wolfson Campus,ENC 1101 - 0240   English Composition 1,0240-LEC Main Sess,Staff,25,21,4,0,0
15227,Wolfson Campus,ENC 1101 - 0241   English Composition 1,0241-LEC Conversion,Staff,25,23,2,0,0
15228,Wolfson Campus,ENC 1101 - 0242   English Composition 1,0242-LEC Conversion,Staff,25,18,7,0,0
15229,Wolfson Campus,ENC 1101 - 0243   English Composition 1,0243-LEC Conversion,Staff,25,0,25,0,0
15104,Wolfson Campus,ENC 1101 - 0244   English Composition 1,0244-LEC Main Sess,Staff,25,19,6,0,0
15105,Wolfson Campus,ENC 1101 - 0246   English Composition 1,0246-LEC Main Sess,Staff,25,0,25,0,0
15231,Wolfson Campus,ENC 1101 - 0247   English Composition 1,0247-LEC Conversion,Staff,25,24,1,0,0
15232,Wolfson Campus,ENC 1101 - 0248   English Composition 1,0248-LEC Conversion,Staff,25,0,25,0,0
15233,Wolfson Campus,ENC 1101 - 0249   English Composition 1,0249-LEC Conversion,Staff,25,0,25,0,0
15234,Wolfson Campus,ENC 1101 - 0250   English Composition 1,0250-LEC Conversion,Staff,25,0,25,0,0
15107,Homestead Campus,ENC 1101 - 0252   English Composition 1,0252-LEC Main Sess,Staff,25,23,2,0,0
15200,Homestead Campus,ENC 1101 - 0254   English Composition 1,0254-LEC Eight Wk 2,Staff,25,0,25,0,0
15190,Homestead Campus,ENC 1101 - 0255   English Composition 1,0255-LEC Eight Wk 1,Staff,25,23,2,0,0
15189,Homestead Campus,ENC 1101 - 0256   English Composition 1,0256-LEC Eight Wk 1,Staff,25,23,2,0,0
15108,Homestead Campus,ENC 1101 - 0257   English Composition 1,0257-LEC Main Sess,Staff,25,24,1,0,0
15235,Homestead Campus,ENC 1101 - 0259   English Composition 1,0259-LEC Conversion,Staff,25,0,25,0,0
15188,Homestead Campus,ENC 1101 - 0260   English Composition 1,0260-LEC Eight Wk 1,Staff,25,24,1,0,0
15110,Homestead Campus,ENC 1101 - 0261   English Composition 1,0261-LEC Main Sess,Staff,25,0,25,0,0
15111,Homestead Campus,ENC 1101 - 0262   English Composition 1,0262-LEC Main Sess,Staff,25,24,1,0,0
15252,Homestead Campus,ENC 1101 - 0263   English Composition 1,0263-LEC Weekend,Staff,25,0,25,0,0
15112,Homestead Campus,ENC 1101 - 0264   English Composition 1,0264-LEC Main Sess,Staff,25,0,25,0,0
15223,Homestead Campus,ENC 1101 - 0266   English Composition 1,0266-LEC Conversion,Staff,25,23,2,0,0
15114,InterAmerican Campus,ENC 1101 - 0267   English Composition 1,0267-LEC Main Sess,Staff,25,23,2,0,0
15115,InterAmerican Campus,ENC 1101 - 0268   English Composition 1,0268-LEC Main Sess,Staff,25,14,11,0,0
15116,InterAmerican Campus,ENC 1101 - 0269   English Composition 1,0269-LEC Main Sess,Staff,25,23,2,0,0
15201,InterAmerican Campus,ENC 1101 - 0270   English Composition 1,0270-LEC Eight Wk 2,Staff,25,24,1,0,0
15117,InterAmerican Campus,ENC 1101 - 0271   English Composition 1,0271-LEC Main Sess,Staff,25,22,3,0,0
15118,InterAmerican Campus,ENC 1101 - 0272   English Composition 1,0272-LEC Main Sess,Staff,25,0,25,0,0
15119,InterAmerican Campus,ENC 1101 - 0273   English Composition 1,0273-LEC Main Sess,Staff,25,20,5,0,0
15120,InterAmerican Campus,ENC 1101 - 0274   English Composition 1,0274-LEC Main Sess,Staff,25,0,25,0,0
15202,InterAmerican Campus,ENC 1101 - 0275   English Composition 1,0275-LEC Eight Wk 2,Staff,25,21,4,0,0
15203,InterAmerican Campus,ENC 1101 - 0276   English Composition 1,0276-LEC Eight Wk 2,Staff,29,0,29,0,0
15121,InterAmerican Campus,ENC 1101 - 0277   English Composition 1,0277-LEC Main Sess,Staff,23,22,1,0,0
15244,InterAmerican Campus,ENC 1101 - 0278   English Composition 1,0278-LEC 1st Mon Sp,Staff,25,20,5,0,0
15122,InterAmerican Campus,ENC 1101 - 0279   English Composition 1,0279-LEC Main Sess,Staff,25,21,4,0,0
15123,InterAmerican Campus,ENC 1101 - 0280   English Composition 1,0280-LEC Main Sess,Staff,25,17,8,0,0
15124,InterAmerican Campus,ENC 1101 - 0281   English Composition 1,0281-LEC Main Sess,Staff,25,18,7,0,0
15125,InterAmerican Campus,ENC 1101 - 0282   English Composition 1,0282-LEC Main Sess,Staff,22,21,1,0,0
15204,InterAmerican Campus,ENC 1101 - 0283   English Composition 1,0283-LEC Eight Wk 2,Staff,29,0,29,0,0
15241,InterAmerican Campus,ENC 1101 - 0284   English Composition 1,0284-LEC Conversion,Staff,25,0,25,0,0
15219,InterAmerican Campus,ENC 1101 - 0285   English Composition 1,0285-LEC Conversion,Staff,25,0,25,0,0
15187,InterAmerican Campus,ENC 1101 - 0286   English Composition 1,0286-LEC Eight Wk 1,Staff,25,0,25,0,0
15205,InterAmerican Campus,ENC 1101 - 0287   English Composition 1,0287-LEC Eight Wk 2,Staff,25,24,1,0,0
15126,InterAmerican Campus,ENC 1101 - 0288   English Composition 1,0288-LEC Main Sess,Staff,25,0,25,0,0
15127,InterAmerican Campus,ENC 1101 - 0289   English Composition 1,0289-LEC Main Sess,Staff,25,0,25,0,0
15128,InterAmerican Campus,ENC 1101 - 0290   English Composition 1,0290-LEC Main Sess,Staff,25,23,2,0,0
15186,InterAmerican Campus,ENC 1101 - 0291   English Composition 1,0291-LEC Eight Wk 1,Staff,25,20,5,0,0
15131,Hialeah Campus,ENC 1101 - 0294   English Composition 1,0294-LEC Main Sess,Staff,25,0,25,0,0
15133,Hialeah Campus,ENC 1101 - 0296   English Composition 1,0296-LEC Main Sess,Staff,25,24,1,0,0
15134,Hialeah Campus,ENC 1101 - 0297   English Composition 1,0297-LEC Main Sess,Staff,25,24,1,0,0
15135,Hialeah Campus,ENC 1101 - 0298   English Composition 1,0298-LEC Main Sess,Staff,25,21,4,0,0
15136,Hialeah Campus,ENC 1101 - 0299   English Composition 1,0299-LEC Main Sess,Staff,25,23,2,0,0
15180,Hialeah Campus,ENC 1101 - 0300   English Composition 1,0300-LEC Twelve Wk,Staff,25,21,4,0,0
15249,Hialeah Campus,ENC 1101 - 0301   English Composition 1,0301-LEC Weekend,Staff,25,24,1,0,0
15137,Hialeah Campus,ENC 1101 - 0302   English Composition 1,0302-LEC Main Sess,Staff,25,22,3,0,0
15140,Hialeah Campus,ENC 1101 - 0305   English Composition 1,0305-LEC Main Sess,Staff,25,0,25,0,0
15181,Hialeah Campus,ENC 1101 - 0306   English Composition 1,0306-LEC Twelve Wk,Staff,25,15,10,0,0
15182,Hialeah Campus,ENC 1101 - 0309   English Composition 1,0309-LEC Twelve Wk,Staff,25,21,4,0,0
15157,Hialeah Campus,ENC 1101 - 0310   English Composition 1,0310-LEC Main Sess,Staff,25,0,25,0,0
15142,Hialeah Campus,ENC 1101 - 0311   English Composition 1,0311-LEC Main Sess,Staff,25,0,25,0,0
15143,Hialeah Campus,ENC 1101 - 0312   English Composition 1,0312-LEC Main Sess,Staff,25,22,3,0,0
15144,Hialeah Campus,ENC 1101 - 0313   English Composition 1,0313-LEC Main Sess,Staff,25,0,25,0,0
15145,Hialeah Campus,ENC 1101 - 0314   English Composition 1,0314-LEC Main Sess,Staff,25,22,3,0,0
15146,Hialeah Campus,ENC 1101 - 0315   English Composition 1,0315-LEC Main Sess,Staff,25,23,2,0,0
15147,Hialeah Campus,ENC 1101 - 0316   English Composition 1,0316-LEC Main Sess,Staff,25,23,2,0,0
15148,Hialeah Campus,ENC 1101 - 0317   English Composition 1,0317-LEC Main Sess,Staff,25,24,1,0,0
15149,West Campus,ENC 1101 - 0318   English Composition 1,0318-LEC Main Sess,Staff,26,25,1,0,0
15150,West Campus,ENC 1101 - 0319   English Composition 1,0319-LEC Main Sess,Staff,25,14,11,0,0
15183,West Campus,ENC 1101 - 0320   English Composition 1,0320-LEC Twelve Wk,Staff,25,8,17,0,0
15206,West Campus,ENC 1101 - 0321   English Composition 1,0321-LEC Eight Wk 2,Staff,25,18,7,0,0
15221,West Campus,ENC 1101 - 0322   English Composition 1,0322-LEC Conversion,Staff,25,15,10,0,0
15222,West Campus,ENC 1101 - 0323   English Composition 1,0323-LEC Conversion,Staff,25,24,1,0,0
15212,West Campus,ENC 1101 - 0324   English Composition 1,0324-LEC Eight Wk 2,Staff,25,13,12,0,0
15191,West Campus,ENC 1101 - 0325   English Composition 1,0325-LEC Eight Wk 1,Staff,25,0,25,0,0
15151,West Campus,ENC 1101 - 0326   English Composition 1,0326-LEC Main Sess,Staff,25,23,2,0,0
15152,West Campus,ENC 1101 - 0327   English Composition 1,0327-LEC Main Sess,Staff,26,25,1,0,0
15153,West Campus,ENC 1101 - 0328   English Composition 1,0328-LEC Main Sess,Staff,25,19,6,0,0
15236,West Campus,ENC 1101 - 0329   English Composition 1,0329-LEC Conversion,Staff,25,23,2,0,0
15237,West Campus,ENC 1101 - 0330   English Composition 1,0330-LEC Conversion,Staff,25,17,8,0,0
15184,West Campus,ENC 1101 - 0331   English Composition 1,0331-LEC Twelve Wk,Staff,25,18,7,0,0
15154,West Campus,ENC 1101 - 0332   English Composition 1,0332-LEC Main Sess,Staff,25,22,3,0,0
15155,West Campus,ENC 1101 - 0333   English Composition 1,0333-LEC Main Sess,Staff,25,22,3,0,0
15239,West Campus,ENC 1101 - 0334   English Composition 1,0334-LEC Conversion,Staff,25,22,3,0,0
15159,West Campus,ENC 1101 - 0335   English Composition 1,0335-LEC Twelve Wk,Staff,25,24,1,0,0
15156,West Campus,ENC 1101 - 0336   English Composition 1,0336-LEC Main Sess,Staff,30,0,30,0,0
6887,Homestead Campus,ATF 1100 - 0001   Private Pilot Flight,0001-LEC Conversion,Staff,24,6,18,0,0
6886,Homestead Campus,ATF 1100 - 0002   Private Pilot Flight,0002-LEC Conversion,Staff,30,9,21,0,0
6038,Homestead Campus,ATT 1100 - 0001   Private Pilot Theory,0001-LEC Main Sess,Staff,30,8,22,0,0
6040,Homestead Campus,ATT 1100 - 0002   Private Pilot Theory,0002-LEC Main Sess,Staff,40,0,40,0,0
6039,Homestead Campus,ATT 1100 - 0003   Private Pilot Theory,0003-LEC Main Sess,Staff,30,20,10,0,0
5938,North Campus,CJL 1100 - 0001   Criminal Law,0001-LEC Main Sess,Staff,40,35,5,0,0
5945,North Campus,CJL 1100 - 0003   Criminal Law,0003-LEC Conversion,Staff,40,17,23,0,0
5940,North Campus,CJL 1100 - 0004   Criminal Law,0004-LEC Main Sess,Staff,40,0,40,0,0
5941,Wolfson Campus,CJL 1100 - 0005   Criminal Law,0005-LEC Main Sess,Staff,40,0,40,0,0
5942,Wolfson Campus,CJL 1100 - 0006   Criminal Law,0006-LEC Main Sess,Staff,30,27,3,0,0
5943,Wolfson Campus,CJL 1100 - 0007   Criminal Law,0007-LEC Main Sess,Staff,30,27,3,0,0
5944,Homestead Campus,CJL 1100 - 0008   Criminal Law,0008-LEC Main Sess,Staff,39,0,39,0,0
13893,North Campus,DAA 1100 - 0001   Modern Dance 1,0001-LEC Main Sess,Staff,15,0,15,0,0
13892,Kendall Campus,DAA 1100 - 0002   Modern Dance 1,0002-LEC Main Sess,Staff,25,16,9,0,0
14557,North Campus,FIL 1100 - 0001   Screenwriting 1: Introduction To Story Structure,0001-LEC Main Sess,Staff,25,22,3,0,0
14559,Kendall Campus,FIL 1100 - 0003   Screenwriting 1: Introduction To Story Structure,0003-LEC Main Sess,Staff,20,17,3,0,0
14560,West Campus,FIL 1100 - 0004   Screenwriting 1: Introduction To Story Structure,0004-LEC 1st Mon Sp,Staff,25,23,2,0,0
16248,North Campus,FSS 1100 - 0001   Foodservice Purchasing,0001-LEC Main Sess,Staff,32,0,32,0,0
16249,Wolfson Campus,FSS 1100 - 0003   Foodservice Purchasing,0003-LEC Main Sess,Staff,30,0,30,0,0
11389,Kendall Campus,IND 1100 - 0001   History Of Interiors 1,0001-LEC Main Sess,Staff,37,15,22,0,0
11390,Wolfson Campus,IND 1100 - 0002   History Of Interiors 1,0002-LEC Main Sess,Staff,30,14,16,0,0
11391,Wolfson Campus,IND 1100 - 0003   History Of Interiors 1,0003-LEC Main Sess,Staff,30,19,11,0,0
8935,North Campus,JOU 1100 - 0001   Basic Reporting,0001-LEC Conversion,Staff,25,8,17,0,0
8930,North Campus,JOU 1100 - 0002   Basic Reporting,0002-LEC Main Sess,Staff,25,0,25,0,0
8932,Wolfson Campus,JOU 1100 - 0004   Basic Reporting,0004-LEC Main Sess,Staff,24,16,8,0,0
8934,West Campus,JOU 1100 - 0005   Basic Reporting,0005-LEC Twelve Wk,Staff,30,8,22,0,0
8933,West Campus,JOU 1100 - 0006   Basic Reporting,0006-LEC Main Sess,Staff,35,0,35,0,0
10808,Kendall Campus,PHI 1100 - 0001   Introduction To Logic,0001-LEC Main Sess,Staff,38,34,4,0,0
10807,Homestead Campus,PHI 1100 - 0002   Introduction To Logic,0002-LEC Main Sess,Staff,30,0,30,0,0
14002,North Campus,RTV 1100 - 0001   Writing For Electronics Media,0001-LEC Main Sess,Staff,23,13,10,0,0
14003,North Campus,RTV 1100 - 0002   Writing For Electronics Media,0002-LEC 1st Mon Sp,Staff,21,0,21,0,0
12641,North Campus,TPP 1100 - 0001   Acting 1,0001-LEC Main Sess,Staff,15,14,1,0,0
12642,North Campus,TPP 1100 - 0002   Acting 1,0002-LEC Main Sess,Staff,15,0,15,0,0
12644,Kendall Campus,TPP 1100 - 0004   Acting 1,0004-LEC Main Sess,Staff,20,0,20,0,0
12646,Homestead Campus,TPP 1100 - 0006   Acting 1,0006-LEC Eight Wk 1,Staff,25,0,25,0,0
5398,North Campus,BSC 1084 - 0001   Functional Human Anatomy,0001-LEC Main Sess,Staff,45,40,5,0,0
5399,North Campus,BSC 1084 - 0002   Functional Human Anatomy,0002-LEC Main Sess,Staff,43,36,7,0,0
5401,North Campus,BSC 1084 - 0003   Functional Human Anatomy,0003-LEC Main Sess,Staff,40,0,40,0,0
5400,Wolfson Campus,BSC 1084 - 0004   Functional Human Anatomy,0004-LEC Main Sess,Staff,40,37,3,0,0
14636,Wolfson Campus,HLP 1083 - 0001   Weight Management,0001-LEC Main Sess,Staff,30,12,18,0,0
11278,North Campus,EET 1082 - 0001   Introduction To Electronics,0001-LEC Main Sess,Staff,24,14,10,0,0
11262,North Campus,HLP 1081 - 0001   Fitness & Wellness For Life,0001-LEC Main Sess,Staff,30,0,30,0,0
11276,North Campus,HLP 1081 - 0003   Fitness & Wellness For Life,0003-LEC Twelve Wk,Staff,30,12,18,0,0
11265,Kendall Campus,HLP 1081 - 0004   Fitness & Wellness For Life,0004-LEC Main Sess,Staff,30,15,15,0,0
11266,Kendall Campus,HLP 1081 - 0005   Fitness & Wellness For Life,0005-LEC Main Sess,Staff,30,17,13,0,0
11267,Kendall Campus,HLP 1081 - 0006   Fitness & Wellness For Life,0006-LEC Main Sess,Staff,30,17,13,0,0
11268,Kendall Campus,HLP 1081 - 0007   Fitness & Wellness For Life,0007-LEC Main Sess,Staff,30,16,14,0,0
11269,Kendall Campus,HLP 1081 - 0008   Fitness & Wellness For Life,0008-LEC Main Sess,Staff,30,12,18,0,0
11270,Kendall Campus,HLP 1081 - 0009   Fitness & Wellness For Life,0009-LEC Main Sess,Staff,30,16,14,0,0
11271,Kendall Campus,HLP 1081 - 0010   Fitness & Wellness For Life,0010-LEC Main Sess,Staff,30,27,3,0,0
11272,Kendall Campus,HLP 1081 - 0011   Fitness & Wellness For Life,0011-LEC Main Sess,Staff,30,13,17,0,0
11273,Wolfson Campus,HLP 1081 - 0012   Fitness & Wellness For Life,0012-LEC Main Sess,Staff,30,25,5,0,0
11274,Wolfson Campus,HLP 1081 - 0013   Fitness & Wellness For Life,0013-LEC Main Sess,Staff,30,14,16,0,0
11275,Wolfson Campus,HLP 1081 - 0014   Fitness & Wellness For Life,0014-LEC Main Sess,Staff,30,24,6,0,0
11264,Wolfson Campus,HLP 1081 - 0015   Fitness & Wellness For Life,0015-LEC Main Sess,Staff,30,29,1,0,0
11277,Wolfson Campus,HLP 1081 - 0016   Fitness & Wellness For Life,0016-LEC Conversion,Staff,34,29,5,0,0
10392,North Campus,FSE 1080 - 0001   Funeral Law,0001-LEC Main Sess,Staff,30,24,6,0,0
10391,North Campus,FSE 1080 - 0002   Funeral Law,0002-LEC Main Sess,Staff,24,23,1,0,0
15287,Kendall Campus,HLP 1080 - 0001   Wellness,0001-LEC Main Sess,Staff,30,19,11,0,0
8776,Homestead Campus,AVM 1062 - 0001   Aviation Career Planning,0001-LEC Main Sess,Staff,30,0,30,0,0
8775,Homestead Campus,AVM 1062 - 0002   Aviation Career Planning,0002-LEC Main Sess,Staff,30,7,23,0,0
13509,North Campus,CGS 1060 - 0001   Introduction To Microcomputer Usage,0001-LEC Main Sess,Staff,40,35,5,0,0
13510,North Campus,CGS 1060 - 0002   Introduction To Microcomputer Usage,0002-LEC Main Sess,Staff,38,33,5,0,0
13511,North Campus,CGS 1060 - 0003   Introduction To Microcomputer Usage,0003-LEC Main Sess,Staff,38,32,6,0,0
13512,North Campus,CGS 1060 - 0004   Introduction To Microcomputer Usage,0004-LEC Main Sess,Staff,38,35,3,0,0
13513,North Campus,CGS 1060 - 0005   Introduction To Microcomputer Usage,0005-LEC Main Sess,Staff,5,0,5,0,0
13514,North Campus,CGS 1060 - 0006   Introduction To Microcomputer Usage,0006-LEC Main Sess,Staff,30,25,5,0,0
13516,North Campus,CGS 1060 - 0008   Introduction To Microcomputer Usage,0008-LEC Main Sess,Staff,30,27,3,0,0
13517,North Campus,CGS 1060 - 0009   Introduction To Microcomputer Usage,0009-LEC Main Sess,Staff,38,20,18,0,0
13518,North Campus,CGS 1060 - 0010   Introduction To Microcomputer Usage,0010-LEC Main Sess,Staff,40,36,4,0,0
13519,North Campus,CGS 1060 - 0011   Introduction To Microcomputer Usage,0011-LEC Main Sess,Staff,24,22,2,0,0
13520,North Campus,CGS 1060 - 0012   Introduction To Microcomputer Usage,0012-LEC Main Sess,Staff,24,19,5,0,0
13521,North Campus,CGS 1060 - 0013   Introduction To Microcomputer Usage,0013-LEC Main Sess,Staff,30,27,3,0,0
13522,North Campus,CGS 1060 - 0014   Introduction To Microcomputer Usage,0014-LEC Main Sess,Staff,1,0,1,0,0
13691,North Campus,CGS 1060 - 0015   Introduction To Microcomputer Usage,0015-LEC Main Sess,Staff,38,19,19,0,0
13523,North Campus,CGS 1060 - 0016   Introduction To Microcomputer Usage,0016-LEC Main Sess,Staff,38,33,5,0,0
13524,North Campus,CGS 1060 - 0017   Introduction To Microcomputer Usage,0017-LEC Main Sess,Staff,40,38,2,0,0
13525,North Campus,CGS 1060 - 0018   Introduction To Microcomputer Usage,0018-LEC Main Sess,Staff,38,30,8,0,0
13526,North Campus,CGS 1060 - 0019   Introduction To Microcomputer Usage,0019-LEC Main Sess,Staff,38,28,10,0,0
13527,North Campus,CGS 1060 - 0020   Introduction To Microcomputer Usage,0020-LEC Main Sess,Staff,40,37,3,0,0
13528,North Campus,CGS 1060 - 0021   Introduction To Microcomputer Usage,0021-LEC Main Sess,Staff,38,15,23,0,0
13529,North Campus,CGS 1060 - 0022   Introduction To Microcomputer Usage,0022-LEC Main Sess,Staff,40,38,2,0,0
13692,North Campus,CGS 1060 - 0023   Introduction To Microcomputer Usage,0023-LEC Main Sess,Staff,38,12,26,0,0
13786,North Campus,CGS 1060 - 0024   Introduction To Microcomputer Usage,0024-LEC Weekend,Staff,38,17,21,0,0
13783,North Campus,CGS 1060 - 0025   Introduction To Microcomputer Usage,0025-LEC 1st Mon Sp,Staff,38,29,9,0,0
13787,North Campus,CGS 1060 - 0026   Introduction To Microcomputer Usage,0026-LEC Weekend,Staff,30,0,30,0,0
13530,North Campus,CGS 1060 - 0027   Introduction To Microcomputer Usage,0027-LEC Main Sess,Staff,38,37,1,0,0
13531,North Campus,CGS 1060 - 0028   Introduction To Microcomputer Usage,0028-LEC Main Sess,Staff,38,36,2,0,0
13532,North Campus,CGS 1060 - 0029   Introduction To Microcomputer Usage,0029-LEC Main Sess,Staff,38,0,38,0,0
13533,North Campus,CGS 1060 - 0030   Introduction To Microcomputer Usage,0030-LEC Main Sess,Staff,40,0,40,0,0
13534,North Campus,CGS 1060 - 0031   Introduction To Microcomputer Usage,0031-LEC Main Sess,Staff,37,35,2,0,0
13535,North Campus,CGS 1060 - 0032   Introduction To Microcomputer Usage,0032-LEC Main Sess,Staff,40,32,8,0,0
13702,North Campus,CGS 1060 - 0034   Introduction To Microcomputer Usage,0034-LEC Twelve Wk,Staff,40,20,20,0,0
13745,North Campus,CGS 1060 - 0035   Introduction To Microcomputer Usage,0035-LEC Twelve Wk,Staff,25,24,1,0,0
13781,North Campus,CGS 1060 - 0036   Introduction To Microcomputer Usage,0036-LEC Conversion,Staff,40,36,4,0,0
13537,North Campus,CGS 1060 - 0037   Introduction To Microcomputer Usage,0037-LEC Main Sess,Staff,38,33,5,0,0
13538,North Campus,CGS 1060 - 0038   Introduction To Microcomputer Usage,0038-LEC Main Sess,Staff,38,33,5,0,0
13539,North Campus,CGS 1060 - 0039   Introduction To Microcomputer Usage,0039-LEC Main Sess,Staff,40,32,8,0,0
13704,North Campus,CGS 1060 - 0040   Introduction To Microcomputer Usage,0040-LEC Twelve Wk,Staff,40,34,6,0,0
13705,North Campus,CGS 1060 - 0041   Introduction To Microcomputer Usage,0041-LEC Twelve Wk,Staff,25,23,2,0,0
13706,North Campus,CGS 1060 - 0042   Introduction To Microcomputer Usage,0042-LEC Twelve Wk,Staff,30,16,14,0,0
13707,North Campus,CGS 1060 - 0043   Introduction To Microcomputer Usage,0043-LEC Twelve Wk,Staff,25,23,2,0,0
13708,North Campus,CGS 1060 - 0044   Introduction To Microcomputer Usage,0044-LEC Twelve Wk,Staff,24,23,1,0,0
13541,North Campus,CGS 1060 - 0046   Introduction To Microcomputer Usage,0046-LEC Main Sess,Staff,30,15,15,0,0
13709,North Campus,CGS 1060 - 0049   Introduction To Microcomputer Usage,0049-LEC Twelve Wk,Staff,30,23,7,0,0
13542,North Campus,CGS 1060 - 0050   Introduction To Microcomputer Usage,0050-LEC Main Sess,Staff,30,0,30,0,0
13710,North Campus,CGS 1060 - 0051   Introduction To Microcomputer Usage,0051-LEC Twelve Wk,Staff,30,12,18,0,0
13543,Kendall Campus,CGS 1060 - 0052   Introduction To Microcomputer Usage,0052-LEC Main Sess,Staff,48,47,1,0,0
13544,Kendall Campus,CGS 1060 - 0053   Introduction To Microcomputer Usage,0053-LEC Main Sess,Staff,48,43,5,0,0
13545,Kendall Campus,CGS 1060 - 0054   Introduction To Microcomputer Usage,0054-LEC Main Sess,Staff,40,16,24,0,0
13546,Kendall Campus,CGS 1060 - 0055   Introduction To Microcomputer Usage,0055-LEC Main Sess,Staff,48,36,12,0,0
13547,Kendall Campus,CGS 1060 - 0056   Introduction To Microcomputer Usage,0056-LEC Main Sess,Staff,40,39,1,0,0
13549,Kendall Campus,CGS 1060 - 0058   Introduction To Microcomputer Usage,0058-LEC Main Sess,Staff,48,37,11,0,0
13550,Kendall Campus,CGS 1060 - 0059   Introduction To Microcomputer Usage,0059-LEC Main Sess,Staff,20,19,1,0,0
13694,Kendall Campus,CGS 1060 - 0060   Introduction To Microcomputer Usage,0060-LEC Main Sess,Staff,40,39,1,0,0
13711,Kendall Campus,CGS 1060 - 0061   Introduction To Microcomputer Usage,0061-LEC Twelve Wk,Staff,21,17,4,0,0
13712,Kendall Campus,CGS 1060 - 0062   Introduction To Microcomputer Usage,0062-LEC Twelve Wk,Staff,40,17,23,0,0
13714,Kendall Campus,CGS 1060 - 0064   Introduction To Microcomputer Usage,0064-LEC Twelve Wk,Staff,40,37,3,0,0
13746,Kendall Campus,CGS 1060 - 0065   Introduction To Microcomputer Usage,0065-LEC Eight Wk 1,Staff,40,15,25,0,0
13552,Kendall Campus,CGS 1060 - 0067   Introduction To Microcomputer Usage,0067-LEC Main Sess,Staff,21,20,1,0,0
13747,Kendall Campus,CGS 1060 - 0068   Introduction To Microcomputer Usage,0068-LEC Eight Wk 1,Staff,40,0,40,0,0
13553,Kendall Campus,CGS 1060 - 0069   Introduction To Microcomputer Usage,0069-LEC Main Sess,Staff,40,0,40,0,0
13554,Kendall Campus,CGS 1060 - 0070   Introduction To Microcomputer Usage,0070-LEC Main Sess,Staff,48,47,1,0,0
13556,Kendall Campus,CGS 1060 - 0072   Introduction To Microcomputer Usage,0072-LEC Main Sess,Staff,48,42,6,0,0
13557,Kendall Campus,CGS 1060 - 0073   Introduction To Microcomputer Usage,0073-LEC Main Sess,Staff,48,28,20,0,0
13558,Kendall Campus,CGS 1060 - 0074   Introduction To Microcomputer Usage,0074-LEC Main Sess,Staff,40,39,1,0,0
13559,Kendall Campus,CGS 1060 - 0075   Introduction To Microcomputer Usage,0075-LEC Main Sess,Staff,40,37,3,0,0
13560,Kendall Campus,CGS 1060 - 0076   Introduction To Microcomputer Usage,0076-LEC Main Sess,Staff,48,32,16,0,0
13562,Kendall Campus,CGS 1060 - 0078   Introduction To Microcomputer Usage,0078-LEC Main Sess,Staff,40,35,5,0,0
13563,Kendall Campus,CGS 1060 - 0079   Introduction To Microcomputer Usage,0079-LEC Main Sess,Staff,21,19,2,0,0
13564,Kendall Campus,CGS 1060 - 0080   Introduction To Microcomputer Usage,0080-LEC Main Sess,Staff,40,18,22,0,0
13695,Kendall Campus,CGS 1060 - 0081   Introduction To Microcomputer Usage,0081-LEC Main Sess,Staff,48,38,10,0,0
13696,Kendall Campus,CGS 1060 - 0082   Introduction To Microcomputer Usage,0082-LEC Main Sess,Staff,40,0,40,0,0
13789,Kendall Campus,CGS 1060 - 0083   Introduction To Microcomputer Usage,0083-LEC Weekend,Staff,48,30,18,0,0
13795,Kendall Campus,CGS 1060 - 0084   Introduction To Microcomputer Usage,0084-LEC Weekend,Staff,48,9,39,0,0
13791,Kendall Campus,CGS 1060 - 0085   Introduction To Microcomputer Usage,0085-LEC Weekend,Staff,40,15,25,0,0
13715,Kendall Campus,CGS 1060 - 0086   Introduction To Microcomputer Usage,0086-LEC Twelve Wk,Staff,40,16,24,0,0
13716,Kendall Campus,CGS 1060 - 0087   Introduction To Microcomputer Usage,0087-LEC Twelve Wk,Staff,21,19,2,0,0
13717,Kendall Campus,CGS 1060 - 0088   Introduction To Microcomputer Usage,0088-LEC Twelve Wk,Staff,21,18,3,0,0
13718,Kendall Campus,CGS 1060 - 0089   Introduction To Microcomputer Usage,0089-LEC Twelve Wk,Staff,40,35,5,0,0
13767,Kendall Campus,CGS 1060 - 0090   Introduction To Microcomputer Usage,0090-LEC Eight Wk 2,Staff,40,35,5,0,0
13565,Kendall Campus,CGS 1060 - 0091   Introduction To Microcomputer Usage,0091-LEC Main Sess,Staff,21,0,21,0,0
13566,Kendall Campus,CGS 1060 - 0092   Introduction To Microcomputer Usage,0092-LEC Main Sess,Staff,21,0,21,0,0
13567,Kendall Campus,CGS 1060 - 0093   Introduction To Microcomputer Usage,0093-LEC Main Sess,Staff,40,36,4,0,0
13568,Kendall Campus,CGS 1060 - 0094   Introduction To Microcomputer Usage,0094-LEC Main Sess,Staff,40,17,23,0,0
13569,Kendall Campus,CGS 1060 - 0095   Introduction To Microcomputer Usage,0095-LEC Main Sess,Staff,40,39,1,0,0
13571,Kendall Campus,CGS 1060 - 0097   Introduction To Microcomputer Usage,0097-LEC Main Sess,Staff,40,39,1,0,0
13572,Kendall Campus,CGS 1060 - 0098   Introduction To Microcomputer Usage,0098-LEC Main Sess,Staff,40,38,2,0,0
13573,Kendall Campus,CGS 1060 - 0099   Introduction To Microcomputer Usage,0099-LEC Main Sess,Staff,21,20,1,0,0
13574,Kendall Campus,CGS 1060 - 0100   Introduction To Microcomputer Usage,0100-LEC Main Sess,Staff,40,37,3,0,0
13575,Kendall Campus,CGS 1060 - 0101   Introduction To Microcomputer Usage,0101-LEC Main Sess,Staff,40,35,5,0,0
13576,Kendall Campus,CGS 1060 - 0102   Introduction To Microcomputer Usage,0102-LEC Main Sess,Staff,20,0,20,0,0
13577,Kendall Campus,CGS 1060 - 0103   Introduction To Microcomputer Usage,0103-LEC Main Sess,Staff,20,17,3,0,0
13578,Kendall Campus,CGS 1060 - 0104   Introduction To Microcomputer Usage,0104-LEC Main Sess,Staff,20,0,20,0,0
13697,Kendall Campus,CGS 1060 - 0105   Introduction To Microcomputer Usage,0105-LEC Main Sess,Staff,48,46,2,0,0
13719,Kendall Campus,CGS 1060 - 0106   Introduction To Microcomputer Usage,0106-LEC Twelve Wk,Staff,21,19,2,0,0
13720,Kendall Campus,CGS 1060 - 0107   Introduction To Microcomputer Usage,0107-LEC Twelve Wk,Staff,20,17,3,0,0
13721,Kendall Campus,CGS 1060 - 0108   Introduction To Microcomputer Usage,0108-LEC Twelve Wk,Staff,26,0,26,0,0
13758,Kendall Campus,CGS 1060 - 0109   Introduction To Microcomputer Usage,0109-LEC Eight Wk 1,Staff,21,19,2,0,0
13757,Kendall Campus,CGS 1060 - 0110   Introduction To Microcomputer Usage,0110-LEC Eight Wk 1,Staff,40,0,40,0,0
13579,Kendall Campus,CGS 1060 - 0111   Introduction To Microcomputer Usage,0111-LEC Main Sess,Staff,21,8,13,0,0
13580,Kendall Campus,CGS 1060 - 0112   Introduction To Microcomputer Usage,0112-LEC Main Sess,Staff,40,39,1,0,0
13582,Kendall Campus,CGS 1060 - 0114   Introduction To Microcomputer Usage,0114-LEC Main Sess,Staff,48,46,2,0,0
13583,Kendall Campus,CGS 1060 - 0115   Introduction To Microcomputer Usage,0115-LEC Main Sess,Staff,40,36,4,0,0
13584,Kendall Campus,CGS 1060 - 0116   Introduction To Microcomputer Usage,0116-LEC Main Sess,Staff,40,39,1,0,0
13585,Kendall Campus,CGS 1060 - 0117   Introduction To Microcomputer Usage,0117-LEC Main Sess,Staff,40,16,24,0,0
13586,Kendall Campus,CGS 1060 - 0118   Introduction To Microcomputer Usage,0118-LEC Main Sess,Staff,22,21,1,0,0
13587,Kendall Campus,CGS 1060 - 0119   Introduction To Microcomputer Usage,0119-LEC Main Sess,Staff,40,0,40,0,0
13588,Kendall Campus,CGS 1060 - 0120   Introduction To Microcomputer Usage,0120-LEC Main Sess,Staff,22,19,3,0,0
13589,Kendall Campus,CGS 1060 - 0121   Introduction To Microcomputer Usage,0121-LEC Main Sess,Staff,40,38,2,0,0
13590,Kendall Campus,CGS 1060 - 0122   Introduction To Microcomputer Usage,0122-LEC Main Sess,Staff,21,19,2,0,0
13592,Kendall Campus,CGS 1060 - 0124   Introduction To Microcomputer Usage,0124-LEC Main Sess,Staff,40,29,11,0,0
13722,Kendall Campus,CGS 1060 - 0125   Introduction To Microcomputer Usage,0125-LEC Twelve Wk,Staff,20,19,1,0,0
13724,Kendall Campus,CGS 1060 - 0127   Introduction To Microcomputer Usage,0127-LEC Twelve Wk,Staff,20,0,20,0,0
13756,Kendall Campus,CGS 1060 - 0128   Introduction To Microcomputer Usage,0128-LEC Eight Wk 1,Staff,21,19,2,0,0
13766,Kendall Campus,CGS 1060 - 0129   Introduction To Microcomputer Usage,0129-LEC Eight Wk 2,Staff,40,0,40,0,0
13765,Kendall Campus,CGS 1060 - 0130   Introduction To Microcomputer Usage,0130-LEC Eight Wk 2,Staff,40,38,2,0,0
13769,Kendall Campus,CGS 1060 - 0131   Introduction To Microcomputer Usage,0131-LEC Eight Wk 2,Staff,21,19,2,0,0
13763,Kendall Campus,CGS 1060 - 0132   Introduction To Microcomputer Usage,0132-LEC Eight Wk 2,Staff,21,19,2,0,0
13593,Kendall Campus,CGS 1060 - 0133   Introduction To Microcomputer Usage,0133-LEC Main Sess,Staff,40,35,5,0,0
13594,Kendall Campus,CGS 1060 - 0134   Introduction To Microcomputer Usage,0134-LEC Main Sess,Staff,40,20,20,0,0
13596,Wolfson Campus,CGS 1060 - 0136   Introduction To Microcomputer Usage,0136-LEC Main Sess,Staff,35,34,1,0,0
13597,Wolfson Campus,CGS 1060 - 0137   Introduction To Microcomputer Usage,0137-LEC Main Sess,Staff,30,28,2,0,0
13598,Wolfson Campus,CGS 1060 - 0138   Introduction To Microcomputer Usage,0138-LEC Main Sess,Staff,28,26,2,0,0
13599,Wolfson Campus,CGS 1060 - 0139   Introduction To Microcomputer Usage,0139-LEC Main Sess,Staff,35,31,4,0,0
13600,Wolfson Campus,CGS 1060 - 0140   Introduction To Microcomputer Usage,0140-LEC Main Sess,Staff,35,34,1,0,0
13725,Wolfson Campus,CGS 1060 - 0141   Introduction To Microcomputer Usage,0141-LEC Twelve Wk,Staff,22,19,3,0,0
13601,Wolfson Campus,CGS 1060 - 0142   Introduction To Microcomputer Usage,0142-LEC Main Sess,Staff,22,21,1,0,0
13602,Wolfson Campus,CGS 1060 - 0143   Introduction To Microcomputer Usage,0143-LEC Main Sess,Staff,5,1,4,0,0
13726,Wolfson Campus,CGS 1060 - 0144   Introduction To Microcomputer Usage,0144-LEC Twelve Wk,Staff,33,30,3,0,0
13727,Wolfson Campus,CGS 1060 - 0145   Introduction To Microcomputer Usage,0145-LEC Twelve Wk,Staff,24,22,2,0,0
13603,Wolfson Campus,CGS 1060 - 0146   Introduction To Microcomputer Usage,0146-LEC Main Sess,Staff,30,29,1,0,0
13604,Wolfson Campus,CGS 1060 - 0147   Introduction To Microcomputer Usage,0147-LEC Main Sess,Staff,22,19,3,0,0
13755,Wolfson Campus,CGS 1060 - 0148   Introduction To Microcomputer Usage,0148-LEC Eight Wk 1,Staff,22,0,22,0,0
13728,Wolfson Campus,CGS 1060 - 0149   Introduction To Microcomputer Usage,0149-LEC Twelve Wk,Staff,25,23,2,0,0
13729,Wolfson Campus,CGS 1060 - 0150   Introduction To Microcomputer Usage,0150-LEC Twelve Wk,Staff,30,26,4,0,0
13605,Wolfson Campus,CGS 1060 - 0151   Introduction To Microcomputer Usage,0151-LEC Main Sess,Staff,33,30,3,0,0
13606,Wolfson Campus,CGS 1060 - 0152   Introduction To Microcomputer Usage,0152-LEC Main Sess,Staff,33,28,5,0,0
13609,Wolfson Campus,CGS 1060 - 0155   Introduction To Microcomputer Usage,0155-LEC Main Sess,Staff,24,23,1,0,0
13610,Wolfson Campus,CGS 1060 - 0156   Introduction To Microcomputer Usage,0156-LEC Main Sess,Staff,35,28,7,0,0
13792,Wolfson Campus,CGS 1060 - 0159   Introduction To Microcomputer Usage,0159-LEC Weekend,Staff,33,19,14,0,0
13730,Wolfson Campus,CGS 1060 - 0160   Introduction To Microcomputer Usage,0160-LEC Twelve Wk,Staff,30,29,1,0,0
13731,Wolfson Campus,CGS 1060 - 0161   Introduction To Microcomputer Usage,0161-LEC Twelve Wk,Staff,22,21,1,0,0
13732,Wolfson Campus,CGS 1060 - 0162   Introduction To Microcomputer Usage,0162-LEC Twelve Wk,Staff,30,26,4,0,0
13780,Wolfson Campus,CGS 1060 - 0163   Introduction To Microcomputer Usage,0163-LEC Conversion,Staff,22,20,2,0,0
13613,Wolfson Campus,CGS 1060 - 0164   Introduction To Microcomputer Usage,0164-LEC Main Sess,Staff,28,26,2,0,0
13733,Wolfson Campus,CGS 1060 - 0165   Introduction To Microcomputer Usage,0165-LEC Twelve Wk,Staff,28,27,1,0,0
13614,Wolfson Campus,CGS 1060 - 0166   Introduction To Microcomputer Usage,0166-LEC Main Sess,Staff,30,9,21,0,0
13776,Wolfson Campus,CGS 1060 - 0167   Introduction To Microcomputer Usage,0167-LEC Conversion,Staff,22,19,3,0,0
13773,Wolfson Campus,CGS 1060 - 0168   Introduction To Microcomputer Usage,0168-LEC Conversion,Staff,33,31,2,0,0
13615,Wolfson Campus,CGS 1060 - 0169   Introduction To Microcomputer Usage,0169-LEC Main Sess,Staff,30,27,3,0,0
13734,Wolfson Campus,CGS 1060 - 0171   Introduction To Microcomputer Usage,0171-LEC Twelve Wk,Staff,30,20,10,0,0
13617,Wolfson Campus,CGS 1060 - 0172   Introduction To Microcomputer Usage,0172-LEC Main Sess,Staff,35,31,4,0,0
13618,Wolfson Campus,CGS 1060 - 0173   Introduction To Microcomputer Usage,0173-LEC Main Sess,Staff,28,19,9,0,0
13793,Wolfson Campus,CGS 1060 - 0174   Introduction To Microcomputer Usage,0174-LEC Weekend,Staff,28,18,10,0,0
13619,Wolfson Campus,CGS 1060 - 0175   Introduction To Microcomputer Usage,0175-LEC Main Sess,Staff,28,25,3,0,0
13735,Wolfson Campus,CGS 1060 - 0177   Introduction To Microcomputer Usage,0177-LEC Twelve Wk,Staff,28,26,2,0,0
13621,Wolfson Campus,CGS 1060 - 0179   Introduction To Microcomputer Usage,0179-LEC Main Sess,Staff,30,24,6,0,0
13622,Wolfson Campus,CGS 1060 - 0180   Introduction To Microcomputer Usage,0180-LEC Main Sess,Staff,33,0,33,0,0
13794,Wolfson Campus,CGS 1060 - 0181   Introduction To Microcomputer Usage,0181-LEC Weekend,Staff,28,17,11,0,0
13623,Wolfson Campus,CGS 1060 - 0182   Introduction To Microcomputer Usage,0182-LEC Main Sess,Staff,16,0,16,0,0
13698,Wolfson Campus,CGS 1060 - 0183   Introduction To Microcomputer Usage,0183-LEC Main Sess,Staff,24,0,24,0,0
13624,Wolfson Campus,CGS 1060 - 0184   Introduction To Microcomputer Usage,0184-LEC Main Sess,Staff,30,23,7,0,0
13625,Wolfson Campus,CGS 1060 - 0185   Introduction To Microcomputer Usage,0185-LEC Main Sess,Staff,30,23,7,0,0
13626,Wolfson Campus,CGS 1060 - 0186   Introduction To Microcomputer Usage,0186-LEC Main Sess,Staff,30,19,11,0,0
13627,Wolfson Campus,CGS 1060 - 0187   Introduction To Microcomputer Usage,0187-LEC Main Sess,Staff,30,21,9,0,0
13774,Wolfson Campus,CGS 1060 - 0188   Introduction To Microcomputer Usage,0188-LEC Conversion,Staff,30,26,4,0,0
13775,Wolfson Campus,CGS 1060 - 0189   Introduction To Microcomputer Usage,0189-LEC Conversion,Staff,30,28,2,0,0
13628,Wolfson Campus,CGS 1060 - 0190   Introduction To Microcomputer Usage,0190-LEC Main Sess,Staff,30,25,5,0,0
13629,Wolfson Campus,CGS 1060 - 0191   Introduction To Microcomputer Usage,0191-LEC Main Sess,Staff,30,26,4,0,0
13630,Wolfson Campus,CGS 1060 - 0192   Introduction To Microcomputer Usage,0192-LEC Main Sess,Staff,30,27,3,0,0
13632,Wolfson Campus,CGS 1060 - 0194   Introduction To Microcomputer Usage,0194-LEC Main Sess,Staff,30,24,6,0,0
13633,Wolfson Campus,CGS 1060 - 0195   Introduction To Microcomputer Usage,0195-LEC Main Sess,Staff,30,21,9,0,0
13634,Wolfson Campus,CGS 1060 - 0196   Introduction To Microcomputer Usage,0196-LEC Main Sess,Staff,30,29,1,0,0
13635,Wolfson Campus,CGS 1060 - 0197   Introduction To Microcomputer Usage,0197-LEC Main Sess,Staff,30,25,5,0,0
13636,Wolfson Campus,CGS 1060 - 0198   Introduction To Microcomputer Usage,0198-LEC Main Sess,Staff,30,27,3,0,0
13637,Wolfson Campus,CGS 1060 - 0199   Introduction To Microcomputer Usage,0199-LEC Main Sess,Staff,30,28,2,0,0
13638,Wolfson Campus,CGS 1060 - 0200   Introduction To Microcomputer Usage,0200-LEC Main Sess,Staff,30,23,7,0,0
13639,Wolfson Campus,CGS 1060 - 0201   Introduction To Microcomputer Usage,0201-LEC Main Sess,Staff,30,26,4,0,0
13640,Wolfson Campus,CGS 1060 - 0202   Introduction To Microcomputer Usage,0202-LEC Main Sess,Staff,30,27,3,0,0
13641,Wolfson Campus,CGS 1060 - 0203   Introduction To Microcomputer Usage,0203-LEC Main Sess,Staff,30,27,3,0,0
13642,Wolfson Campus,CGS 1060 - 0204   Introduction To Microcomputer Usage,0204-LEC Main Sess,Staff,30,27,3,0,0
13643,Wolfson Campus,CGS 1060 - 0205   Introduction To Microcomputer Usage,0205-LEC Main Sess,Staff,30,22,8,0,0
13782,Wolfson Campus,CGS 1060 - 0206   Introduction To Microcomputer Usage,0206-LEC Conversion,Staff,30,28,2,0,0
13644,Wolfson Campus,CGS 1060 - 0207   Introduction To Microcomputer Usage,0207-LEC Main Sess,Staff,30,8,22,0,0
13645,Wolfson Campus,CGS 1060 - 0208   Introduction To Microcomputer Usage,0208-LEC Main Sess,Staff,30,26,4,0,0
13646,Wolfson Campus,CGS 1060 - 0209   Introduction To Microcomputer Usage,0209-LEC Main Sess,Staff,30,27,3,0,0
13647,Wolfson Campus,CGS 1060 - 0210   Introduction To Microcomputer Usage,0210-LEC Main Sess,Staff,30,25,5,0,0
13777,Wolfson Campus,CGS 1060 - 0211   Introduction To Microcomputer Usage,0211-LEC Conversion,Staff,30,23,7,0,0
13778,Wolfson Campus,CGS 1060 - 0212   Introduction To Microcomputer Usage,0212-LEC Conversion,Staff,30,25,5,0,0
13648,Wolfson Campus,CGS 1060 - 0213   Introduction To Microcomputer Usage,0213-LEC Main Sess,Staff,30,10,20,0,0
13649,Wolfson Campus,CGS 1060 - 0214   Introduction To Microcomputer Usage,0214-LEC Main Sess,Staff,30,28,2,0,0
13650,Homestead Campus,CGS 1060 - 0215   Introduction To Microcomputer Usage,0215-LEC Main Sess,Staff,37,21,16,0,0
13737,Homestead Campus,CGS 1060 - 0216   Introduction To Microcomputer Usage,0216-LEC Twelve Wk,Staff,37,31,6,0,0
13754,Homestead Campus,CGS 1060 - 0217   Introduction To Microcomputer Usage,0217-LEC Eight Wk 1,Staff,37,18,19,0,0
13651,Homestead Campus,CGS 1060 - 0218   Introduction To Microcomputer Usage,0218-LEC Main Sess,Staff,37,30,7,0,0
13652,Homestead Campus,CGS 1060 - 0219   Introduction To Microcomputer Usage,0219-LEC Main Sess,Staff,37,34,3,0,0
13653,Homestead Campus,CGS 1060 - 0220   Introduction To Microcomputer Usage,0220-LEC Main Sess,Staff,35,21,14,0,0
13654,Homestead Campus,CGS 1060 - 0221   Introduction To Microcomputer Usage,0221-LEC Main Sess,Staff,37,35,2,0,0
13655,Homestead Campus,CGS 1060 - 0222   Introduction To Microcomputer Usage,0222-LEC Main Sess,Staff,35,11,24,0,0
13762,Homestead Campus,CGS 1060 - 0223   Introduction To Microcomputer Usage,0223-LEC Eight Wk 2,Staff,32,26,6,0,0
13753,Homestead Campus,CGS 1060 - 0224   Introduction To Microcomputer Usage,0224-LEC Eight Wk 1,Staff,20,0,20,0,0
13779,Homestead Campus,CGS 1060 - 0225   Introduction To Microcomputer Usage,0225-LEC Conversion,Staff,37,34,3,0,0
13771,Homestead Campus,CGS 1060 - 0226   Introduction To Microcomputer Usage,0226-LEC Conversion,Staff,35,17,18,0,0
13738,Homestead Campus,CGS 1060 - 0227   Introduction To Microcomputer Usage,0227-LEC Twelve Wk,Staff,35,22,13,0,0
13739,Homestead Campus,CGS 1060 - 0228   Introduction To Microcomputer Usage,0228-LEC Twelve Wk,Staff,21,0,21,0,0
13656,Homestead Campus,CGS 1060 - 0229   Introduction To Microcomputer Usage,0229-LEC Main Sess,Staff,35,13,22,0,0
13657,Homestead Campus,CGS 1060 - 0230   Introduction To Microcomputer Usage,0230-LEC Main Sess,Staff,37,19,18,0,0
13658,Homestead Campus,CGS 1060 - 0231   Introduction To Microcomputer Usage,0231-LEC Main Sess,Staff,37,32,5,0,0
13740,Homestead Campus,CGS 1060 - 0232   Introduction To Microcomputer Usage,0232-LEC Twelve Wk,Staff,20,16,4,0,0
13659,InterAmerican Campus,CGS 1060 - 0233   Introduction To Microcomputer Usage,0233-LEC Main Sess,Staff,35,28,7,0,0
13660,InterAmerican Campus,CGS 1060 - 0234   Introduction To Microcomputer Usage,0234-LEC Main Sess,Staff,35,34,1,0,0
13741,InterAmerican Campus,CGS 1060 - 0235   Introduction To Microcomputer Usage,0235-LEC Twelve Wk,Staff,35,0,35,0,0
13742,InterAmerican Campus,CGS 1060 - 0236   Introduction To Microcomputer Usage,0236-LEC Twelve Wk,Staff,3,0,3,0,0
13785,InterAmerican Campus,CGS 1060 - 0237   Introduction To Microcomputer Usage,0237-LEC 1st Mon Sp,Staff,35,19,16,0,0
13770,InterAmerican Campus,CGS 1060 - 0238   Introduction To Microcomputer Usage,0238-LEC Conversion,Staff,35,24,11,0,0
13661,InterAmerican Campus,CGS 1060 - 0239   Introduction To Microcomputer Usage,0239-LEC Main Sess,Staff,35,26,9,0,0
13662,InterAmerican Campus,CGS 1060 - 0240   Introduction To Microcomputer Usage,0240-LEC Main Sess,Staff,35,33,2,0,0
13663,InterAmerican Campus,CGS 1060 - 0241   Introduction To Microcomputer Usage,0241-LEC Main Sess,Staff,35,31,4,0,0
13784,InterAmerican Campus,CGS 1060 - 0242   Introduction To Microcomputer Usage,0242-LEC 1st Mon Sp,Staff,35,31,4,0,0
13743,InterAmerican Campus,CGS 1060 - 0243   Introduction To Microcomputer Usage,0243-LEC Twelve Wk,Staff,35,17,18,0,0
13664,InterAmerican Campus,CGS 1060 - 0244   Introduction To Microcomputer Usage,0244-LEC Main Sess,Staff,35,34,1,0,0
13665,InterAmerican Campus,CGS 1060 - 0245   Introduction To Microcomputer Usage,0245-LEC Main Sess,Staff,35,30,5,0,0
13744,InterAmerican Campus,CGS 1060 - 0246   Introduction To Microcomputer Usage,0246-LEC Twelve Wk,Staff,35,16,19,0,0
13666,InterAmerican Campus,CGS 1060 - 0248   Introduction To Microcomputer Usage,0248-LEC Main Sess,Staff,20,10,10,0,0
13667,InterAmerican Campus,CGS 1060 - 0249   Introduction To Microcomputer Usage,0249-LEC Main Sess,Staff,33,31,2,0,0
13668,InterAmerican Campus,CGS 1060 - 0250   Introduction To Microcomputer Usage,0250-LEC Main Sess,Staff,35,31,4,0,0
13669,InterAmerican Campus,CGS 1060 - 0251   Introduction To Microcomputer Usage,0251-LEC Main Sess,Staff,15,4,11,0,0
13699,InterAmerican Campus,CGS 1060 - 0252   Introduction To Microcomputer Usage,0252-LEC Main Sess,Staff,35,0,35,0,0
13700,Hialeah Campus,CGS 1060 - 0253   Introduction To Microcomputer Usage,0253-LEC Main Sess,Staff,34,33,1,0,0
13760,Hialeah Campus,CGS 1060 - 0254   Introduction To Microcomputer Usage,0254-LEC Eight Wk 2,Staff,34,27,7,0,0
13752,Hialeah Campus,CGS 1060 - 0255   Introduction To Microcomputer Usage,0255-LEC Eight Wk 1,Staff,30,22,8,0,0
13670,Hialeah Campus,CGS 1060 - 0256   Introduction To Microcomputer Usage,0256-LEC Main Sess,Staff,37,35,2,0,0
13772,Hialeah Campus,CGS 1060 - 0257   Introduction To Microcomputer Usage,0257-LEC Conversion,Staff,37,33,4,0,0
13759,Hialeah Campus,CGS 1060 - 0258   Introduction To Microcomputer Usage,0258-LEC Eight Wk 2,Staff,30,22,8,0,0
13751,Hialeah Campus,CGS 1060 - 0259   Introduction To Microcomputer Usage,0259-LEC Eight Wk 1,Staff,34,0,34,0,0
13768,Hialeah Campus,CGS 1060 - 0260   Introduction To Microcomputer Usage,0260-LEC Eight Wk 2,Staff,32,25,7,0,0
13671,Hialeah Campus,CGS 1060 - 0261   Introduction To Microcomputer Usage,0261-LEC Main Sess,Staff,32,26,6,0,0
13672,Hialeah Campus,CGS 1060 - 0262   Introduction To Microcomputer Usage,0262-LEC Main Sess,Staff,34,31,3,0,0
13764,Hialeah Campus,CGS 1060 - 0263   Introduction To Microcomputer Usage,0263-LEC Eight Wk 2,Staff,34,31,3,0,0
13673,Hialeah Campus,CGS 1060 - 0264   Introduction To Microcomputer Usage,0264-LEC Main Sess,Staff,34,31,3,0,0
13703,Hialeah Campus,CGS 1060 - 0265   Introduction To Microcomputer Usage,0265-LEC Twelve Wk,Staff,34,30,4,0,0
13750,Hialeah Campus,CGS 1060 - 0266   Introduction To Microcomputer Usage,0266-LEC Eight Wk 1,Staff,34,29,5,0,0
13674,Hialeah Campus,CGS 1060 - 0267   Introduction To Microcomputer Usage,0267-LEC Main Sess,Staff,30,29,1,0,0
13675,Hialeah Campus,CGS 1060 - 0268   Introduction To Microcomputer Usage,0268-LEC Main Sess,Staff,37,36,1,0,0
13749,Hialeah Campus,CGS 1060 - 0269   Introduction To Microcomputer Usage,0269-LEC Eight Wk 1,Staff,34,0,34,0,0
13748,Hialeah Campus,CGS 1060 - 0270   Introduction To Microcomputer Usage,0270-LEC Eight Wk 1,Staff,34,25,9,0,0
13676,West Campus,CGS 1060 - 0271   Introduction To Microcomputer Usage,0271-LEC Main Sess,Staff,35,10,25,0,0
13677,West Campus,CGS 1060 - 0272   Introduction To Microcomputer Usage,0272-LEC Main Sess,Staff,30,0,30,0,0
13678,West Campus,CGS 1060 - 0273   Introduction To Microcomputer Usage,0273-LEC Main Sess,Staff,30,0,30,0,0
13679,West Campus,CGS 1060 - 0274   Introduction To Microcomputer Usage,0274-LEC Main Sess,Staff,35,24,11,0,0
13680,West Campus,CGS 1060 - 0275   Introduction To Microcomputer Usage,0275-LEC Main Sess,Staff,35,0,35,0,0
13681,West Campus,CGS 1060 - 0276   Introduction To Microcomputer Usage,0276-LEC Main Sess,Staff,25,0,25,0,0
13682,West Campus,CGS 1060 - 0277   Introduction To Microcomputer Usage,0277-LEC Main Sess,Staff,35,15,20,0,0
13701,West Campus,CGS 1060 - 0278   Introduction To Microcomputer Usage,0278-LEC Main Sess,Staff,35,0,35,0,0
13790,West Campus,CGS 1060 - 0279   Introduction To Microcomputer Usage,0279-LEC Weekend,Staff,35,0,35,0,0
13683,West Campus,CGS 1060 - 0280   Introduction To Microcomputer Usage,0280-LEC Main Sess,Staff,35,29,6,0,0
13684,West Campus,CGS 1060 - 0281   Introduction To Microcomputer Usage,0281-LEC Main Sess,Staff,35,32,3,0,0
13685,West Campus,CGS 1060 - 0282   Introduction To Microcomputer Usage,0282-LEC Main Sess,Staff,35,33,2,0,0
13686,West Campus,CGS 1060 - 0283   Introduction To Microcomputer Usage,0283-LEC Main Sess,Staff,35,28,7,0,0
13687,West Campus,CGS 1060 - 0284   Introduction To Microcomputer Usage,0284-LEC Main Sess,Staff,35,24,11,0,0
13690,West Campus,CGS 1060 - 0287   Introduction To Microcomputer Usage,0287-LEC Main Sess,Staff,35,18,17,0,0
14514,Medical Campus,EMS 1059 - 0001   1St Responder Emergency Care,0001-LEC Conversion,Staff,36,35,1,0,0
14513,Medical Campus,EMS 1059 - 0002   1St Responder Emergency Care,0002-LEC Conversion,Staff,36,34,2,0,0
10106,Medical Campus,EMS 1059L - 0002   1St Responder Emergency Care Laboratory,0002-LAB Conversion,Staff,6,5,1,0,0
10107,Medical Campus,EMS 1059L - 0004   1St Responder Emergency Care Laboratory,0004-LAB Conversion,Staff,6,5,1,0,0
10109,Medical Campus,EMS 1059L - 0006   1St Responder Emergency Care Laboratory,0006-LAB Conversion,Staff,6,5,1,0,0
10122,Medical Campus,EMS 1059L - 0007   1St Responder Emergency Care Laboratory,0007-LAB Conversion,Staff,6,5,1,0,0
10114,Medical Campus,EMS 1059L - 0008   1St Responder Emergency Care Laboratory,0008-LAB Conversion,Staff,6,5,1,0,0
10115,Medical Campus,EMS 1059L - 0009   1St Responder Emergency Care Laboratory,0009-LAB Conversion,Staff,6,5,1,0,0
10117,Medical Campus,EMS 1059L - 0011   1St Responder Emergency Care Laboratory,0011-LAB Conversion,Staff,6,3,3,0,0
10123,Medical Campus,EMS 1059L - 0013   1St Responder Emergency Care Laboratory,0013-LAB Conversion,Staff,6,5,1,0,0
10119,Medical Campus,EMS 1059L - 0014   1St Responder Emergency Care Laboratory,0014-LAB Conversion,Staff,6,5,1,0,0
10124,Medical Campus,EMS 1059L - 0016   1St Responder Emergency Care Laboratory,0016-LAB Conversion,Staff,6,1,5,0,0
10111,Medical Campus,EMS 1059L - 0019   1St Responder Emergency Care Laboratory,0019-LAB Conversion,Staff,6,4,2,0,0
10112,Medical Campus,EMS 1059L - 0020   1St Responder Emergency Care Laboratory,0020-LAB Conversion,Staff,6,5,1,0,0
10103,Homestead Campus,EMS 1059L - 0021   1St Responder Emergency Care Laboratory,0021-LAB Conversion,Staff,6,5,1,0,0
15256,North Campus,FIL 1055 - 0001   American Independent Film,0001-LEC Main Sess,Staff,80,44,36,0,0
7802,North Campus,BSC 1050 - 0001   Biology & Environment,0001-LEC Main Sess,Staff,40,0,40,0,0
7803,Wolfson Campus,BSC 1050 - 0002   Biology & Environment,0002-LEC Main Sess,Staff,45,18,27,0,0
7805,Wolfson Campus,BSC 1050 - 0004   Biology & Environment,0004-LEC Main Sess,Staff,30,26,4,0,0
7806,Wolfson Campus,BSC 1050 - 0005   Biology & Environment,0005-LEC Main Sess,Staff,30,27,3,0,0
7804,Wolfson Campus,BSC 1050 - 0006   Biology & Environment,0006-LEC Main Sess,Staff,30,29,1,0,0
7001,North Campus,CHM 1046 - 0002   General Chemistry And Qualitative Analysis,0002-LEC Main Sess,Staff,40,26,14,0,0
7003,North Campus,CHM 1046 - 0003   General Chemistry And Qualitative Analysis,0003-LEC Main Sess,Staff,20,8,12,0,0
7004,North Campus,CHM 1046 - 0004   General Chemistry And Qualitative Analysis,0004-LEC Main Sess,Staff,40,33,7,0,0
7016,North Campus,CHM 1046 - 0005   General Chemistry And Qualitative Analysis,0005-LEC Weekend,Staff,40,30,10,0,0
7006,Kendall Campus,CHM 1046 - 0007   General Chemistry And Qualitative Analysis,0007-LEC Main Sess,Staff,110,60,50,0,0
7007,Wolfson Campus,CHM 1046 - 0008   General Chemistry And Qualitative Analysis,0008-LEC Main Sess,Staff,45,36,9,0,0
7008,Wolfson Campus,CHM 1046 - 0009   General Chemistry And Qualitative Analysis,0009-LEC Main Sess,Staff,45,30,15,0,0
7009,Wolfson Campus,CHM 1046 - 0010   General Chemistry And Qualitative Analysis,0010-LEC Main Sess,Staff,10,0,10,0,0
7010,Wolfson Campus,CHM 1046 - 0011   General Chemistry And Qualitative Analysis,0011-LEC Main Sess,Staff,20,0,20,0,0
7015,Wolfson Campus,CHM 1046 - 0012   General Chemistry And Qualitative Analysis,0012-LEC 1st Mon Sp,Staff,45,39,6,0,0
7011,Homestead Campus,CHM 1046 - 0013   General Chemistry And Qualitative Analysis,0013-LEC Main Sess,Staff,39,26,13,0,0
7012,InterAmerican Campus,CHM 1046 - 0014   General Chemistry And Qualitative Analysis,0014-LEC Main Sess,Staff,37,36,1,0,0
7013,InterAmerican Campus,CHM 1046 - 0015   General Chemistry And Qualitative Analysis,0015-LEC Main Sess,Staff,40,24,16,0,0
7002,InterAmerican Campus,CHM 1046 - 0016   General Chemistry And Qualitative Analysis,0016-LEC Main Sess,Staff,37,14,23,0,0
7014,Hialeah Campus,CHM 1046 - 0017   General Chemistry And Qualitative Analysis,0017-LEC Main Sess,Staff,30,23,7,0,0
8452,North Campus,CHM 1046L - 0001   General Chemistry & Qualitative Analysis Lab,0001-LAB Main Sess,Staff,24,20,4,0,0
8480,North Campus,CHM 1046L - 0002   General Chemistry & Qualitative Analysis Lab,0002-LAB Twelve Wk,Staff,24,0,24,0,0
8453,North Campus,CHM 1046L - 0003   General Chemistry & Qualitative Analysis Lab,0003-LAB Main Sess,Staff,24,20,4,0,0
8455,North Campus,CHM 1046L - 0004   General Chemistry & Qualitative Analysis Lab,0004-LAB Main Sess,Staff,24,23,1,0,0
8454,North Campus,CHM 1046L - 0005   General Chemistry & Qualitative Analysis Lab,0005-LAB Main Sess,Staff,24,20,4,0,0
8459,North Campus,CHM 1046L - 0006   General Chemistry & Qualitative Analysis Lab,0006-LAB Main Sess,Staff,24,23,1,0,0
8485,North Campus,CHM 1046L - 0007   General Chemistry & Qualitative Analysis Lab,0007-LAB Weekend,Staff,24,22,2,0,0
8481,North Campus,CHM 1046L - 0008   General Chemistry & Qualitative Analysis Lab,0008-LAB Twelve Wk,Staff,24,0,24,0,0
8460,North Campus,CHM 1046L - 0009   General Chemistry & Qualitative Analysis Lab,0009-LAB Main Sess,Staff,24,19,5,0,0
8461,North Campus,CHM 1046L - 0010   General Chemistry & Qualitative Analysis Lab,0010-LAB Main Sess,Staff,24,0,24,0,0
8462,Kendall Campus,CHM 1046L - 0011   General Chemistry & Qualitative Analysis Lab,0011-LAB Main Sess,Staff,18,10,8,0,0
8464,Kendall Campus,CHM 1046L - 0013   General Chemistry & Qualitative Analysis Lab,0013-LAB Main Sess,Staff,16,11,5,0,0
8484,Kendall Campus,CHM 1046L - 0014   General Chemistry & Qualitative Analysis Lab,0014-LAB Weekend,Staff,18,9,9,0,0
8465,Kendall Campus,CHM 1046L - 0015   General Chemistry & Qualitative Analysis Lab,0015-LAB Main Sess,Staff,16,12,4,0,0
8466,Kendall Campus,CHM 1046L - 0016   General Chemistry & Qualitative Analysis Lab,0016-LAB Main Sess,Staff,16,14,2,0,0
8467,Kendall Campus,CHM 1046L - 0017   General Chemistry & Qualitative Analysis Lab,0017-LAB Main Sess,Staff,18,11,7,0,0
8468,Kendall Campus,CHM 1046L - 0018   General Chemistry & Qualitative Analysis Lab,0018-LAB Main Sess,Staff,18,15,3,0,0
8470,Kendall Campus,CHM 1046L - 0020   General Chemistry & Qualitative Analysis Lab,0020-LAB Main Sess,Staff,18,14,4,0,0
8471,Kendall Campus,CHM 1046L - 0021   General Chemistry & Qualitative Analysis Lab,0021-LAB Main Sess,Staff,16,8,8,0,0
8472,Kendall Campus,CHM 1046L - 0022   General Chemistry & Qualitative Analysis Lab,0022-LAB Main Sess,Staff,16,13,3,0,0
8475,Wolfson Campus,CHM 1046L - 0025   General Chemistry & Qualitative Analysis Lab,0025-LAB Main Sess,Staff,20,16,4,0,0
8477,Homestead Campus,CHM 1046L - 0027   General Chemistry & Qualitative Analysis Lab,0027-LAB Main Sess,Staff,24,0,24,0,0
8478,Homestead Campus,CHM 1046L - 0028   General Chemistry & Qualitative Analysis Lab,0028-LAB Main Sess,Staff,24,0,24,0,0
8482,Homestead Campus,CHM 1046L - 0029   General Chemistry & Qualitative Analysis Lab,0029-LAB Conversion,Staff,24,14,10,0,0
8479,InterAmerican Campus,CHM 1046L - 0030   General Chemistry & Qualitative Analysis Lab,0030-LAB Main Sess,Staff,20,12,8,0,0
8458,InterAmerican Campus,CHM 1046L - 0031   General Chemistry & Qualitative Analysis Lab,0031-LAB Main Sess,Staff,20,13,7,0,0
8457,InterAmerican Campus,CHM 1046L - 0033   General Chemistry & Qualitative Analysis Lab,0033-LAB Main Sess,Staff,20,18,2,0,0
8456,Hialeah Campus,CHM 1046L - 0034   General Chemistry & Qualitative Analysis Lab,0034-LAB Main Sess,Staff,24,17,7,0,0
5863,North Campus,CHM 1045 - 0001   General Chemistry And Qualitative Analysis,0001-LEC Main Sess,Staff,40,30,10,0,0
5864,North Campus,CHM 1045 - 0002   General Chemistry And Qualitative Analysis,0002-LEC Main Sess,Staff,45,43,2,0,0
5869,North Campus,CHM 1045 - 0004   General Chemistry And Qualitative Analysis,0004-LEC Main Sess,Staff,40,38,2,0,0
5891,North Campus,CHM 1045 - 0005   General Chemistry And Qualitative Analysis,0005-LEC Twelve Wk,Staff,48,42,6,0,0
5893,North Campus,CHM 1045 - 0006   General Chemistry And Qualitative Analysis,0006-LEC Twelve Wk,Staff,40,0,40,0,0
5870,North Campus,CHM 1045 - 0007   General Chemistry And Qualitative Analysis,0007-LEC Main Sess,Staff,40,38,2,0,0
5871,North Campus,CHM 1045 - 0008   General Chemistry And Qualitative Analysis,0008-LEC Main Sess,Staff,40,31,9,0,0
5872,Kendall Campus,CHM 1045 - 0010   General Chemistry And Qualitative Analysis,0010-LEC Main Sess,Staff,110,93,17,0,0
5873,Kendall Campus,CHM 1045 - 0011   General Chemistry And Qualitative Analysis,0011-LEC Main Sess,Staff,110,80,30,0,0
5875,Kendall Campus,CHM 1045 - 0013   General Chemistry And Qualitative Analysis,0013-LEC Main Sess,Staff,110,108,2,0,0
5876,Kendall Campus,CHM 1045 - 0014   General Chemistry And Qualitative Analysis,0014-LEC Main Sess,Staff,45,16,29,0,0
5877,Kendall Campus,CHM 1045 - 0015   General Chemistry And Qualitative Analysis,0015-LEC Main Sess,Staff,40,0,40,0,0
5878,Wolfson Campus,CHM 1045 - 0016   General Chemistry And Qualitative Analysis,0016-LEC Main Sess,Staff,45,38,7,0,0
5879,Wolfson Campus,CHM 1045 - 0017   General Chemistry And Qualitative Analysis,0017-LEC Main Sess,Staff,45,25,20,0,0
5880,Wolfson Campus,CHM 1045 - 0018   General Chemistry And Qualitative Analysis,0018-LEC Main Sess,Staff,45,41,4,0,0
5882,Wolfson Campus,CHM 1045 - 0020   General Chemistry And Qualitative Analysis,0020-LEC Main Sess,Staff,32,29,3,0,0
5883,Wolfson Campus,CHM 1045 - 0021   General Chemistry And Qualitative Analysis,0021-LEC Main Sess,Staff,45,40,5,0,0
5884,Homestead Campus,CHM 1045 - 0022   General Chemistry And Qualitative Analysis,0022-LEC Main Sess,Staff,39,0,39,0,0
5886,InterAmerican Campus,CHM 1045 - 0024   General Chemistry And Qualitative Analysis,0024-LEC Main Sess,Staff,40,28,12,0,0
5887,InterAmerican Campus,CHM 1045 - 0025   General Chemistry And Qualitative Analysis,0025-LEC Main Sess,Staff,40,37,3,0,0
5888,InterAmerican Campus,CHM 1045 - 0026   General Chemistry And Qualitative Analysis,0026-LEC Main Sess,Staff,25,18,7,0,0
5889,InterAmerican Campus,CHM 1045 - 0027   General Chemistry And Qualitative Analysis,0027-LEC Main Sess,Staff,35,32,3,0,0
5867,Hialeah Campus,CHM 1045 - 0029   General Chemistry And Qualitative Analysis,0029-LEC Main Sess,Staff,30,0,30,0,0
5866,Hialeah Campus,CHM 1045 - 0030   General Chemistry And Qualitative Analysis,0030-LEC Main Sess,Staff,38,34,4,0,0
5865,Hialeah Campus,CHM 1045 - 0032   General Chemistry And Qualitative Analysis,0032-LEC Main Sess,Staff,44,43,1,0,0
5434,North Campus,CHM 1045L - 0002   General Chemistry And Qualitative Analysis Lab,0002-LAB Main Sess,Staff,24,0,24,0,0
5481,North Campus,CHM 1045L - 0003   General Chemistry And Qualitative Analysis Lab,0003-LAB Twelve Wk,Staff,24,22,2,0,0
5452,North Campus,CHM 1045L - 0004   General Chemistry And Qualitative Analysis Lab,0004-LAB Main Sess,Staff,24,23,1,0,0
5455,North Campus,CHM 1045L - 0007   General Chemistry And Qualitative Analysis Lab,0007-LAB Main Sess,Staff,24,21,3,0,0
5442,North Campus,CHM 1045L - 0008   General Chemistry And Qualitative Analysis Lab,0008-LAB Main Sess,Staff,24,21,3,0,0
5477,North Campus,CHM 1045L - 0009   General Chemistry And Qualitative Analysis Lab,0009-LAB Twelve Wk,Staff,24,21,3,0,0
5480,North Campus,CHM 1045L - 0010   General Chemistry And Qualitative Analysis Lab,0010-LAB Twelve Wk,Staff,24,0,24,0,0
5456,North Campus,CHM 1045L - 0011   General Chemistry And Qualitative Analysis Lab,0011-LAB Main Sess,Staff,24,18,6,0,0
5441,North Campus,CHM 1045L - 0012   General Chemistry And Qualitative Analysis Lab,0012-LAB Main Sess,Staff,24,20,4,0,0
5457,North Campus,CHM 1045L - 0013   General Chemistry And Qualitative Analysis Lab,0013-LAB Main Sess,Staff,24,23,1,0,0
5478,North Campus,CHM 1045L - 0015   General Chemistry And Qualitative Analysis Lab,0015-LAB Twelve Wk,Staff,24,0,24,0,0
5458,Kendall Campus,CHM 1045L - 0016   General Chemistry And Qualitative Analysis Lab,0016-LAB Main Sess,Staff,24,19,5,0,0
5460,Kendall Campus,CHM 1045L - 0018   General Chemistry And Qualitative Analysis Lab,0018-LAB Main Sess,Staff,24,20,4,0,0
5439,Kendall Campus,CHM 1045L - 0020   General Chemistry And Qualitative Analysis Lab,0020-LAB Main Sess,Staff,18,15,3,0,0
5492,Kendall Campus,CHM 1045L - 0021   General Chemistry And Qualitative Analysis Lab,0021-LAB Weekend,Staff,18,14,4,0,0
5483,Kendall Campus,CHM 1045L - 0022   General Chemistry And Qualitative Analysis Lab,0022-LAB Conversion,Staff,24,0,24,0,0
5461,Kendall Campus,CHM 1045L - 0023   General Chemistry And Qualitative Analysis Lab,0023-LAB Main Sess,Staff,18,17,1,0,0
5462,Kendall Campus,CHM 1045L - 0024   General Chemistry And Qualitative Analysis Lab,0024-LAB Main Sess,Staff,24,12,12,0,0
5463,Kendall Campus,CHM 1045L - 0025   General Chemistry And Qualitative Analysis Lab,0025-LAB Main Sess,Staff,24,14,10,0,0
5484,Kendall Campus,CHM 1045L - 0026   General Chemistry And Qualitative Analysis Lab,0026-LAB Conversion,Staff,18,15,3,0,0
5465,Kendall Campus,CHM 1045L - 0029   General Chemistry And Qualitative Analysis Lab,0029-LAB Main Sess,Staff,18,11,7,0,0
5466,Kendall Campus,CHM 1045L - 0030   General Chemistry And Qualitative Analysis Lab,0030-LAB Main Sess,Staff,18,17,1,0,0
5467,Kendall Campus,CHM 1045L - 0031   General Chemistry And Qualitative Analysis Lab,0031-LAB Main Sess,Staff,18,14,4,0,0
5469,Kendall Campus,CHM 1045L - 0033   General Chemistry And Qualitative Analysis Lab,0033-LAB Main Sess,Staff,18,15,3,0,0
5470,Kendall Campus,CHM 1045L - 0034   General Chemistry And Qualitative Analysis Lab,0034-LAB Main Sess,Staff,18,13,5,0,0
5471,Kendall Campus,CHM 1045L - 0035   General Chemistry And Qualitative Analysis Lab,0035-LAB Main Sess,Staff,18,6,12,0,0
5472,Kendall Campus,CHM 1045L - 0036   General Chemistry And Qualitative Analysis Lab,0036-LAB Main Sess,Staff,18,12,6,0,0
5473,Kendall Campus,CHM 1045L - 0037   General Chemistry And Qualitative Analysis Lab,0037-LAB Main Sess,Staff,18,15,3,0,0
5474,Kendall Campus,CHM 1045L - 0038   General Chemistry And Qualitative Analysis Lab,0038-LAB Main Sess,Staff,16,0,16,0,0
5486,Kendall Campus,CHM 1045L - 0040   General Chemistry And Qualitative Analysis Lab,0040-LAB Conversion,Staff,18,16,2,0,0
5475,Kendall Campus,CHM 1045L - 0041   General Chemistry And Qualitative Analysis Lab,0041-LAB Main Sess,Staff,16,10,6,0,0
5476,Wolfson Campus,CHM 1045L - 0042   General Chemistry And Qualitative Analysis Lab,0042-LAB Main Sess,Staff,20,18,2,0,0
5489,Wolfson Campus,CHM 1045L - 0044   General Chemistry And Qualitative Analysis Lab,0044-LAB 1st Mon Sp,Staff,20,19,1,0,0
5488,Wolfson Campus,CHM 1045L - 0045   General Chemistry And Qualitative Analysis Lab,0045-LAB 1st Mon Sp,Staff,20,19,1,0,0
5451,Wolfson Campus,CHM 1045L - 0046   General Chemistry And Qualitative Analysis Lab,0046-LAB Main Sess,Staff,20,18,2,0,0
5437,Wolfson Campus,CHM 1045L - 0047   General Chemistry And Qualitative Analysis Lab,0047-LAB Main Sess,Staff,20,19,1,0,0
5493,Wolfson Campus,CHM 1045L - 0048   General Chemistry And Qualitative Analysis Lab,0048-LAB Weekend,Staff,20,13,7,0,0
5450,Wolfson Campus,CHM 1045L - 0050   General Chemistry And Qualitative Analysis Lab,0050-LAB Main Sess,Staff,20,13,7,0,0
5449,Homestead Campus,CHM 1045L - 0051   General Chemistry And Qualitative Analysis Lab,0051-LAB Main Sess,Staff,24,23,1,0,0
5448,Homestead Campus,CHM 1045L - 0052   General Chemistry And Qualitative Analysis Lab,0052-LAB Main Sess,Staff,24,17,7,0,0
5436,Homestead Campus,CHM 1045L - 0053   General Chemistry And Qualitative Analysis Lab,0053-LAB Main Sess,Staff,24,0,24,0,0
5447,InterAmerican Campus,CHM 1045L - 0054   General Chemistry And Qualitative Analysis Lab,0054-LAB Main Sess,Staff,20,17,3,0,0
5491,InterAmerican Campus,CHM 1045L - 0055   General Chemistry And Qualitative Analysis Lab,0055-LAB 1st Mon Sp,Staff,20,16,4,0,0
5446,InterAmerican Campus,CHM 1045L - 0056   General Chemistry And Qualitative Analysis Lab,0056-LAB Main Sess,Staff,20,15,5,0,0
5445,InterAmerican Campus,CHM 1045L - 0057   General Chemistry And Qualitative Analysis Lab,0057-LAB Main Sess,Staff,20,18,2,0,0
5435,InterAmerican Campus,CHM 1045L - 0058   General Chemistry And Qualitative Analysis Lab,0058-LAB Main Sess,Staff,20,18,2,0,0
5444,Hialeah Campus,CHM 1045L - 0059   General Chemistry And Qualitative Analysis Lab,0059-LAB Main Sess,Staff,24,21,3,0,0
5494,Hialeah Campus,CHM 1045L - 0060   General Chemistry And Qualitative Analysis Lab,0060-LAB Weekend,Staff,24,22,2,0,0
5490,Hialeah Campus,CHM 1045L - 0061   General Chemistry And Qualitative Analysis Lab,0061-LAB 1st Mon Sp,Staff,24,22,2,0,0
11387,North Campus,IDS 1044 - 0001   Leadership Seminar,0001-LEC Twelve Wk,Staff,30,25,5,0,0
11384,Kendall Campus,IDS 1044 - 0002   Leadership Seminar,0002-LEC Main Sess,Staff,150,0,150,0,0
11385,Kendall Campus,IDS 1044 - 0003   Leadership Seminar,0003-LEC Main Sess,Staff,150,0,150,0,0
11386,Wolfson Campus,IDS 1044 - 0004   Leadership Seminar,0004-LEC Main Sess,Staff,47,0,47,0,0
16342,Wolfson Campus,MKA 1041 - 0001   Principles Of Retailing,0001-LEC Main Sess,Staff,34,9,25,0,0
8997,Medical Campus,MLT 1040L - 0001   Introduction To Medical Laboratory Technology,0001-LAB Main Sess,Staff,20,19,1,0,0
8996,Medical Campus,MLT 1040L - 0002   Introduction To Medical Laboratory Technology,0002-LAB Main Sess,Staff,15,9,6,0,0
9354,North Campus,CHM 1033 - 0001   Chemistry For Health Sciences,0001-LEC Main Sess,Staff,42,32,10,0,0
9355,North Campus,CHM 1033 - 0002   Chemistry For Health Sciences,0002-LEC Main Sess,Staff,40,30,10,0,0
9364,North Campus,CHM 1033 - 0003   Chemistry For Health Sciences,0003-LEC Main Sess,Staff,45,41,4,0,0
9365,North Campus,CHM 1033 - 0004   Chemistry For Health Sciences,0004-LEC Main Sess,Staff,40,0,40,0,0
9366,North Campus,CHM 1033 - 0005   Chemistry For Health Sciences,0005-LEC Main Sess,Staff,40,0,40,0,0
9399,North Campus,CHM 1033 - 0006   Chemistry For Health Sciences,0006-LEC Weekend,Staff,40,34,6,0,0
9367,North Campus,CHM 1033 - 0007   Chemistry For Health Sciences,0007-LEC Main Sess,Staff,40,0,40,0,0
9368,North Campus,CHM 1033 - 0008   Chemistry For Health Sciences,0008-LEC Main Sess,Staff,40,25,15,0,0
9391,North Campus,CHM 1033 - 0009   Chemistry For Health Sciences,0009-LEC Twelve Wk,Staff,40,29,11,0,0
9392,North Campus,CHM 1033 - 0010   Chemistry For Health Sciences,0010-LEC Twelve Wk,Staff,40,39,1,0,0
9369,North Campus,CHM 1033 - 0011   Chemistry For Health Sciences,0011-LEC Main Sess,Staff,45,26,19,0,0
9370,North Campus,CHM 1033 - 0012   Chemistry For Health Sciences,0012-LEC Main Sess,Staff,115,107,8,0,0
9395,North Campus,CHM 1033 - 0013   Chemistry For Health Sciences,0013-LEC Weekend,Staff,40,0,40,0,0
9393,North Campus,CHM 1033 - 0014   Chemistry For Health Sciences,0014-LEC Conversion,Staff,40,10,30,0,0
9371,Kendall Campus,CHM 1033 - 0015   Chemistry For Health Sciences,0015-LEC Main Sess,Staff,110,103,7,0,0
9372,Kendall Campus,CHM 1033 - 0016   Chemistry For Health Sciences,0016-LEC Main Sess,Staff,110,96,14,0,0
9373,Kendall Campus,CHM 1033 - 0017   Chemistry For Health Sciences,0017-LEC Main Sess,Staff,110,105,5,0,0
9374,Kendall Campus,CHM 1033 - 0018   Chemistry For Health Sciences,0018-LEC Main Sess,Staff,110,74,36,0,0
9375,Kendall Campus,CHM 1033 - 0019   Chemistry For Health Sciences,0019-LEC Main Sess,Staff,110,107,3,0,0
9356,Kendall Campus,CHM 1033 - 0020   Chemistry For Health Sciences,0020-LEC Main Sess,Staff,25,0,25,0,0
9377,Kendall Campus,CHM 1033 - 0022   Chemistry For Health Sciences,0022-LEC Main Sess,Staff,30,0,30,0,0
9378,Wolfson Campus,CHM 1033 - 0023   Chemistry For Health Sciences,0023-LEC Main Sess,Staff,45,37,8,0,0
9379,Wolfson Campus,CHM 1033 - 0024   Chemistry For Health Sciences,0024-LEC Main Sess,Staff,45,43,2,0,0
9380,Wolfson Campus,CHM 1033 - 0025   Chemistry For Health Sciences,0025-LEC Main Sess,Staff,45,21,24,0,0
9396,Wolfson Campus,CHM 1033 - 0026   Chemistry For Health Sciences,0026-LEC Weekend,Staff,45,39,6,0,0
9381,Wolfson Campus,CHM 1033 - 0027   Chemistry For Health Sciences,0027-LEC Main Sess,Staff,45,25,20,0,0
9382,Homestead Campus,CHM 1033 - 0029   Chemistry For Health Sciences,0029-LEC Main Sess,Staff,39,27,12,0,0
9383,Homestead Campus,CHM 1033 - 0030   Chemistry For Health Sciences,0030-LEC Main Sess,Staff,39,0,39,0,0
9384,Homestead Campus,CHM 1033 - 0031   Chemistry For Health Sciences,0031-LEC Main Sess,Staff,39,15,24,0,0
9385,Homestead Campus,CHM 1033 - 0032   Chemistry For Health Sciences,0032-LEC Main Sess,Staff,39,0,39,0,0
9386,InterAmerican Campus,CHM 1033 - 0033   Chemistry For Health Sciences,0033-LEC Main Sess,Staff,40,39,1,0,0
9387,InterAmerican Campus,CHM 1033 - 0034   Chemistry For Health Sciences,0034-LEC Main Sess,Staff,35,33,2,0,0
9388,InterAmerican Campus,CHM 1033 - 0035   Chemistry For Health Sciences,0035-LEC Main Sess,Staff,40,0,40,0,0
9389,InterAmerican Campus,CHM 1033 - 0036   Chemistry For Health Sciences,0036-LEC Main Sess,Staff,40,36,4,0,0
9390,InterAmerican Campus,CHM 1033 - 0037   Chemistry For Health Sciences,0037-LEC Main Sess,Staff,40,36,4,0,0
9398,InterAmerican Campus,CHM 1033 - 0038   Chemistry For Health Sciences,0038-LEC Weekend,Staff,37,36,1,0,0
9394,InterAmerican Campus,CHM 1033 - 0039   Chemistry For Health Sciences,0039-LEC 1st Mon Sp,Staff,25,21,4,0,0
9363,Hialeah Campus,CHM 1033 - 0040   Chemistry For Health Sciences,0040-LEC Main Sess,Staff,30,20,10,0,0
9362,Hialeah Campus,CHM 1033 - 0041   Chemistry For Health Sciences,0041-LEC Main Sess,Staff,30,26,4,0,0
9361,Hialeah Campus,CHM 1033 - 0042   Chemistry For Health Sciences,0042-LEC Main Sess,Staff,30,16,14,0,0
9359,Hialeah Campus,CHM 1033 - 0044   Chemistry For Health Sciences,0044-LEC Main Sess,Staff,30,16,14,0,0
9358,Hialeah Campus,CHM 1033 - 0045   Chemistry For Health Sciences,0045-LEC Main Sess,Staff,30,25,5,0,0
9357,Hialeah Campus,CHM 1033 - 0046   Chemistry For Health Sciences,0046-LEC Main Sess,Staff,30,27,3,0,0
16473,North Campus,MAT 1033 - 0001   Intermediate Algebra,0001-LEC Main Sess,Staff,40,34,6,0,0
16474,North Campus,MAT 1033 - 0002   Intermediate Algebra,0002-LEC Main Sess,Staff,40,0,40,0,0
16475,North Campus,MAT 1033 - 0003   Intermediate Algebra,0003-LEC Main Sess,Staff,40,0,40,0,0
16476,North Campus,MAT 1033 - 0004   Intermediate Algebra,0004-LEC Main Sess,Staff,40,34,6,0,0
16477,North Campus,MAT 1033 - 0005   Intermediate Algebra,0005-LEC Main Sess,Staff,40,30,10,0,0
16478,North Campus,MAT 1033 - 0006   Intermediate Algebra,0006-LEC Main Sess,Staff,40,0,40,0,0
16479,North Campus,MAT 1033 - 0007   Intermediate Algebra,0007-LEC Main Sess,Staff,40,34,6,0,0
16672,North Campus,MAT 1033 - 0008   Intermediate Algebra,0008-LEC Eight Wk 1,Staff,40,20,20,0,0
16676,North Campus,MAT 1033 - 0009   Intermediate Algebra,0009-LEC Eight Wk 1,Staff,35,33,2,0,0
16727,North Campus,MAT 1033 - 0010   Intermediate Algebra,0010-LEC Eight Wk 2,Staff,25,0,25,0,0
16726,North Campus,MAT 1033 - 0011   Intermediate Algebra,0011-LEC Eight Wk 2,Staff,30,27,3,0,0
16725,North Campus,MAT 1033 - 0012   Intermediate Algebra,0012-LEC Eight Wk 2,Staff,30,0,30,0,0
16675,North Campus,MAT 1033 - 0013   Intermediate Algebra,0013-LEC Eight Wk 1,Staff,35,33,2,0,0
16724,North Campus,MAT 1033 - 0014   Intermediate Algebra,0014-LEC Eight Wk 2,Staff,25,10,15,0,0
16480,North Campus,MAT 1033 - 0015   Intermediate Algebra,0015-LEC Main Sess,Staff,36,0,36,0,0
16481,North Campus,MAT 1033 - 0016   Intermediate Algebra,0016-LEC Main Sess,Staff,40,37,3,0,0
16482,North Campus,MAT 1033 - 0017   Intermediate Algebra,0017-LEC Main Sess,Staff,40,34,6,0,0
16483,North Campus,MAT 1033 - 0018   Intermediate Algebra,0018-LEC Main Sess,Staff,35,17,18,0,0
16484,North Campus,MAT 1033 - 0019   Intermediate Algebra,0019-LEC Main Sess,Staff,40,37,3,0,0
16485,North Campus,MAT 1033 - 0020   Intermediate Algebra,0020-LEC Main Sess,Staff,30,24,6,0,0
16644,North Campus,MAT 1033 - 0021   Intermediate Algebra,0021-LEC Twelve Wk,Staff,15,0,15,0,0
16667,North Campus,MAT 1033 - 0022   Intermediate Algebra,0022-LEC Twelve Wk,Staff,15,0,15,0,0
16646,North Campus,MAT 1033 - 0023   Intermediate Algebra,0023-LEC Twelve Wk,Staff,30,29,1,0,0
16674,North Campus,MAT 1033 - 0024   Intermediate Algebra,0024-LEC Eight Wk 1,Staff,30,11,19,0,0
16723,North Campus,MAT 1033 - 0025   Intermediate Algebra,0025-LEC Eight Wk 2,Staff,30,23,7,0,0
16722,North Campus,MAT 1033 - 0026   Intermediate Algebra,0026-LEC Eight Wk 2,Staff,30,0,30,0,0
16721,North Campus,MAT 1033 - 0027   Intermediate Algebra,0027-LEC Eight Wk 2,Staff,30,12,18,0,0
16720,North Campus,MAT 1033 - 0028   Intermediate Algebra,0028-LEC Eight Wk 2,Staff,30,0,30,0,0
16719,North Campus,MAT 1033 - 0029   Intermediate Algebra,0029-LEC Eight Wk 2,Staff,30,21,9,0,0
16718,North Campus,MAT 1033 - 0030   Intermediate Algebra,0030-LEC Eight Wk 2,Staff,25,0,25,0,0
16678,North Campus,MAT 1033 - 0031   Intermediate Algebra,0031-LEC Eight Wk 2,Staff,25,0,25,0,0
16679,North Campus,MAT 1033 - 0032   Intermediate Algebra,0032-LEC Eight Wk 2,Staff,30,17,13,0,0
16486,North Campus,MAT 1033 - 0033   Intermediate Algebra,0033-LEC Main Sess,Staff,40,31,9,0,0
16487,North Campus,MAT 1033 - 0034   Intermediate Algebra,0034-LEC Main Sess,Staff,40,19,21,0,0
16488,North Campus,MAT 1033 - 0035   Intermediate Algebra,0035-LEC Main Sess,Staff,40,36,4,0,0
16489,North Campus,MAT 1033 - 0036   Intermediate Algebra,0036-LEC Main Sess,Staff,40,29,11,0,0
16490,North Campus,MAT 1033 - 0037   Intermediate Algebra,0037-LEC Main Sess,Staff,40,28,12,0,0
16491,North Campus,MAT 1033 - 0038   Intermediate Algebra,0038-LEC Main Sess,Staff,40,32,8,0,0
16492,North Campus,MAT 1033 - 0039   Intermediate Algebra,0039-LEC Main Sess,Staff,40,0,40,0,0
16493,North Campus,MAT 1033 - 0040   Intermediate Algebra,0040-LEC Main Sess,Staff,40,12,28,0,0
16673,North Campus,MAT 1033 - 0041   Intermediate Algebra,0041-LEC Eight Wk 1,Staff,40,16,24,0,0
16680,North Campus,MAT 1033 - 0042   Intermediate Algebra,0042-LEC Eight Wk 2,Staff,1,0,1,0,0
16681,North Campus,MAT 1033 - 0043   Intermediate Algebra,0043-LEC Eight Wk 2,Staff,25,13,12,0,0
16682,North Campus,MAT 1033 - 0044   Intermediate Algebra,0044-LEC Eight Wk 2,Staff,30,25,5,0,0
16683,North Campus,MAT 1033 - 0046   Intermediate Algebra,0046-LEC Eight Wk 2,Staff,25,0,25,0,0
16494,North Campus,MAT 1033 - 0047   Intermediate Algebra,0047-LEC Main Sess,Staff,40,37,3,0,0
16495,North Campus,MAT 1033 - 0048   Intermediate Algebra,0048-LEC Main Sess,Staff,40,0,40,0,0
16496,North Campus,MAT 1033 - 0049   Intermediate Algebra,0049-LEC Main Sess,Staff,40,0,40,0,0
16497,North Campus,MAT 1033 - 0050   Intermediate Algebra,0050-LEC Main Sess,Staff,40,38,2,0,0
16498,North Campus,MAT 1033 - 0051   Intermediate Algebra,0051-LEC Main Sess,Staff,40,22,18,0,0
16499,North Campus,MAT 1033 - 0052   Intermediate Algebra,0052-LEC Main Sess,Staff,40,36,4,0,0
16500,North Campus,MAT 1033 - 0053   Intermediate Algebra,0053-LEC Main Sess,Staff,30,28,2,0,0
16738,North Campus,MAT 1033 - 0054   Intermediate Algebra,0054-LEC Weekend,Staff,40,0,40,0,0
16647,North Campus,MAT 1033 - 0055   Intermediate Algebra,0055-LEC Twelve Wk,Staff,30,28,2,0,0
16648,North Campus,MAT 1033 - 0056   Intermediate Algebra,0056-LEC Twelve Wk,Staff,30,28,2,0,0
16684,North Campus,MAT 1033 - 0057   Intermediate Algebra,0057-LEC Eight Wk 2,Staff,30,9,21,0,0
16685,North Campus,MAT 1033 - 0058   Intermediate Algebra,0058-LEC Eight Wk 2,Staff,30,15,15,0,0
16501,North Campus,MAT 1033 - 0059   Intermediate Algebra,0059-LEC Main Sess,Staff,40,0,40,0,0
16649,North Campus,MAT 1033 - 0060   Intermediate Algebra,0060-LEC Twelve Wk,Staff,30,0,30,0,0
16686,North Campus,MAT 1033 - 0061   Intermediate Algebra,0061-LEC Eight Wk 2,Staff,25,0,25,0,0
16502,North Campus,MAT 1033 - 0062   Intermediate Algebra,0062-LEC Main Sess,Staff,40,0,40,0,0
16730,North Campus,MAT 1033 - 0063   Intermediate Algebra,0063-LEC Conversion,Staff,30,0,30,0,0
16687,North Campus,MAT 1033 - 0064   Intermediate Algebra,0064-LEC Eight Wk 2,Staff,30,6,24,0,0
16728,North Campus,MAT 1033 - 0065   Intermediate Algebra,0065-LEC Eight Wk 2,Staff,30,0,30,0,0
16729,North Campus,MAT 1033 - 0067   Intermediate Algebra,0067-LEC Conversion,Staff,40,28,12,0,0
16689,North Campus,MAT 1033 - 0068   Intermediate Algebra,0068-LEC Eight Wk 2,Staff,40,0,40,0,0
16504,Kendall Campus,MAT 1033 - 0069   Intermediate Algebra,0069-LEC Main Sess,Staff,38,35,3,0,0
16505,Kendall Campus,MAT 1033 - 0070   Intermediate Algebra,0070-LEC Main Sess,Staff,40,0,40,0,0
16506,Kendall Campus,MAT 1033 - 0071   Intermediate Algebra,0071-LEC Main Sess,Staff,42,39,3,0,0
16507,Kendall Campus,MAT 1033 - 0072   Intermediate Algebra,0072-LEC Main Sess,Staff,40,29,11,0,0
16508,Kendall Campus,MAT 1033 - 0073   Intermediate Algebra,0073-LEC Main Sess,Staff,40,0,40,0,0
16509,Kendall Campus,MAT 1033 - 0074   Intermediate Algebra,0074-LEC Main Sess,Staff,40,37,3,0,0
16510,Kendall Campus,MAT 1033 - 0075   Intermediate Algebra,0075-LEC Main Sess,Staff,49,38,11,0,0
16511,Kendall Campus,MAT 1033 - 0076   Intermediate Algebra,0076-LEC Main Sess,Staff,110,97,13,0,0
16650,Kendall Campus,MAT 1033 - 0077   Intermediate Algebra,0077-LEC Twelve Wk,Staff,36,0,36,0,0
16651,Kendall Campus,MAT 1033 - 0078   Intermediate Algebra,0078-LEC Twelve Wk,Staff,36,0,36,0,0
16690,Kendall Campus,MAT 1033 - 0079   Intermediate Algebra,0079-LEC Eight Wk 2,Staff,30,20,10,0,0
16691,Kendall Campus,MAT 1033 - 0080   Intermediate Algebra,0080-LEC Eight Wk 2,Staff,36,16,20,0,0
16512,Kendall Campus,MAT 1033 - 0081   Intermediate Algebra,0081-LEC Main Sess,Staff,110,0,110,0,0
16513,Kendall Campus,MAT 1033 - 0082   Intermediate Algebra,0082-LEC Main Sess,Staff,30,28,2,0,0
16514,Kendall Campus,MAT 1033 - 0083   Intermediate Algebra,0083-LEC Main Sess,Staff,39,30,9,0,0
16515,Kendall Campus,MAT 1033 - 0084   Intermediate Algebra,0084-LEC Main Sess,Staff,49,46,3,0,0
16516,Kendall Campus,MAT 1033 - 0085   Intermediate Algebra,0085-LEC Main Sess,Staff,39,36,3,0,0
16517,Kendall Campus,MAT 1033 - 0086   Intermediate Algebra,0086-LEC Main Sess,Staff,110,104,6,0,0
16518,Kendall Campus,MAT 1033 - 0087   Intermediate Algebra,0087-LEC Main Sess,Staff,45,35,10,0,0
16519,Kendall Campus,MAT 1033 - 0088   Intermediate Algebra,0088-LEC Main Sess,Staff,39,34,5,0,0
16520,Kendall Campus,MAT 1033 - 0089   Intermediate Algebra,0089-LEC Main Sess,Staff,42,35,7,0,0
16521,Kendall Campus,MAT 1033 - 0090   Intermediate Algebra,0090-LEC Main Sess,Staff,40,36,4,0,0
16739,Kendall Campus,MAT 1033 - 0091   Intermediate Algebra,0091-LEC Weekend,Staff,45,20,25,0,0
16743,Kendall Campus,MAT 1033 - 0092   Intermediate Algebra,0092-LEC Weekend,Staff,40,36,4,0,0
16692,Kendall Campus,MAT 1033 - 0093   Intermediate Algebra,0093-LEC Eight Wk 2,Staff,36,24,12,0,0
16522,Kendall Campus,MAT 1033 - 0094   Intermediate Algebra,0094-LEC Main Sess,Staff,39,35,4,0,0
16523,Kendall Campus,MAT 1033 - 0095   Intermediate Algebra,0095-LEC Main Sess,Staff,45,44,1,0,0
16524,Kendall Campus,MAT 1033 - 0096   Intermediate Algebra,0096-LEC Main Sess,Staff,45,38,7,0,0
16525,Kendall Campus,MAT 1033 - 0097   Intermediate Algebra,0097-LEC Main Sess,Staff,40,38,2,0,0
16526,Kendall Campus,MAT 1033 - 0098   Intermediate Algebra,0098-LEC Main Sess,Staff,39,33,6,0,0
16527,Kendall Campus,MAT 1033 - 0099   Intermediate Algebra,0099-LEC Main Sess,Staff,39,35,4,0,0
16528,Kendall Campus,MAT 1033 - 0100   Intermediate Algebra,0100-LEC Main Sess,Staff,40,0,40,0,0
16530,Kendall Campus,MAT 1033 - 0102   Intermediate Algebra,0102-LEC Main Sess,Staff,49,40,9,0,0
16531,Kendall Campus,MAT 1033 - 0103   Intermediate Algebra,0103-LEC Main Sess,Staff,49,19,30,0,0
16532,Kendall Campus,MAT 1033 - 0104   Intermediate Algebra,0104-LEC Main Sess,Staff,49,45,4,0,0
16533,Kendall Campus,MAT 1033 - 0105   Intermediate Algebra,0105-LEC Main Sess,Staff,35,30,5,0,0
16534,Kendall Campus,MAT 1033 - 0106   Intermediate Algebra,0106-LEC Main Sess,Staff,49,41,8,0,0
16652,Kendall Campus,MAT 1033 - 0107   Intermediate Algebra,0107-LEC Twelve Wk,Staff,45,44,1,0,0
16653,Kendall Campus,MAT 1033 - 0108   Intermediate Algebra,0108-LEC Twelve Wk,Staff,36,33,3,0,0
16654,Kendall Campus,MAT 1033 - 0109   Intermediate Algebra,0109-LEC Twelve Wk,Staff,39,0,39,0,0
16693,Kendall Campus,MAT 1033 - 0110   Intermediate Algebra,0110-LEC Eight Wk 2,Staff,45,39,6,0,0
16694,Kendall Campus,MAT 1033 - 0111   Intermediate Algebra,0111-LEC Eight Wk 2,Staff,30,11,19,0,0
16695,Kendall Campus,MAT 1033 - 0112   Intermediate Algebra,0112-LEC Eight Wk 2,Staff,20,0,20,0,0
16696,Kendall Campus,MAT 1033 - 0113   Intermediate Algebra,0113-LEC Eight Wk 2,Staff,36,27,9,0,0
16697,Kendall Campus,MAT 1033 - 0114   Intermediate Algebra,0114-LEC Eight Wk 2,Staff,29,20,9,0,0
16737,Kendall Campus,MAT 1033 - 0115   Intermediate Algebra,0115-LEC 1st Mon Sp,Staff,30,29,1,0,0
16698,Kendall Campus,MAT 1033 - 0116   Intermediate Algebra,0116-LEC Eight Wk 2,Staff,40,26,14,0,0
16535,Kendall Campus,MAT 1033 - 0117   Intermediate Algebra,0117-LEC Main Sess,Staff,49,47,2,0,0
16536,Kendall Campus,MAT 1033 - 0118   Intermediate Algebra,0118-LEC Main Sess,Staff,39,36,3,0,0
16537,Kendall Campus,MAT 1033 - 0119   Intermediate Algebra,0119-LEC Main Sess,Staff,49,45,4,0,0
16538,Kendall Campus,MAT 1033 - 0120   Intermediate Algebra,0120-LEC Main Sess,Staff,40,39,1,0,0
16539,Kendall Campus,MAT 1033 - 0121   Intermediate Algebra,0121-LEC Main Sess,Staff,40,0,40,0,0
16540,Kendall Campus,MAT 1033 - 0122   Intermediate Algebra,0122-LEC Main Sess,Staff,34,31,3,0,0
16541,Kendall Campus,MAT 1033 - 0123   Intermediate Algebra,0123-LEC Main Sess,Staff,40,37,3,0,0
16542,Kendall Campus,MAT 1033 - 0124   Intermediate Algebra,0124-LEC Main Sess,Staff,30,0,30,0,0
16655,Kendall Campus,MAT 1033 - 0125   Intermediate Algebra,0125-LEC Twelve Wk,Staff,40,0,40,0,0
16656,Kendall Campus,MAT 1033 - 0126   Intermediate Algebra,0126-LEC Twelve Wk,Staff,38,0,38,0,0
16657,Kendall Campus,MAT 1033 - 0127   Intermediate Algebra,0127-LEC Twelve Wk,Staff,49,47,2,0,0
16658,Kendall Campus,MAT 1033 - 0128   Intermediate Algebra,0128-LEC Twelve Wk,Staff,36,29,7,0,0
16543,Kendall Campus,MAT 1033 - 0129   Intermediate Algebra,0129-LEC Main Sess,Staff,30,0,30,0,0
16544,Kendall Campus,MAT 1033 - 0130   Intermediate Algebra,0130-LEC Main Sess,Staff,45,37,8,0,0
16677,Kendall Campus,MAT 1033 - 0131   Intermediate Algebra,0131-LEC Eight Wk 1,Staff,30,29,1,0,0
16545,Wolfson Campus,MAT 1033 - 0132   Intermediate Algebra,0132-LEC Main Sess,Staff,38,28,10,0,0
16546,Wolfson Campus,MAT 1033 - 0133   Intermediate Algebra,0133-LEC Main Sess,Staff,30,0,30,0,0
16547,Wolfson Campus,MAT 1033 - 0134   Intermediate Algebra,0134-LEC Main Sess,Staff,38,23,15,0,0
16549,Wolfson Campus,MAT 1033 - 0136   Intermediate Algebra,0136-LEC Main Sess,Staff,30,28,2,0,0
16550,Wolfson Campus,MAT 1033 - 0137   Intermediate Algebra,0137-LEC Main Sess,Staff,38,34,4,0,0
16551,Wolfson Campus,MAT 1033 - 0138   Intermediate Algebra,0138-LEC Main Sess,Staff,38,37,1,0,0
16552,Wolfson Campus,MAT 1033 - 0139   Intermediate Algebra,0139-LEC Main Sess,Staff,30,0,30,0,0
16553,Wolfson Campus,MAT 1033 - 0140   Intermediate Algebra,0140-LEC Main Sess,Staff,38,33,5,0,0
16554,Wolfson Campus,MAT 1033 - 0141   Intermediate Algebra,0141-LEC Main Sess,Staff,38,0,38,0,0
16741,Wolfson Campus,MAT 1033 - 0142   Intermediate Algebra,0142-LEC Weekend,Staff,35,0,35,0,0
16734,Wolfson Campus,MAT 1033 - 0143   Intermediate Algebra,0143-LEC Conversion,Staff,38,22,16,0,0
16659,Wolfson Campus,MAT 1033 - 0144   Intermediate Algebra,0144-LEC Twelve Wk,Staff,38,34,4,0,0
16660,Wolfson Campus,MAT 1033 - 0145   Intermediate Algebra,0145-LEC Twelve Wk,Staff,38,31,7,0,0
16555,Wolfson Campus,MAT 1033 - 0146   Intermediate Algebra,0146-LEC Main Sess,Staff,38,35,3,0,0
16556,Wolfson Campus,MAT 1033 - 0147   Intermediate Algebra,0147-LEC Main Sess,Staff,38,33,5,0,0
16557,Wolfson Campus,MAT 1033 - 0148   Intermediate Algebra,0148-LEC Main Sess,Staff,38,26,12,0,0
16558,Wolfson Campus,MAT 1033 - 0149   Intermediate Algebra,0149-LEC Main Sess,Staff,38,33,5,0,0
16559,Wolfson Campus,MAT 1033 - 0150   Intermediate Algebra,0150-LEC Main Sess,Staff,38,35,3,0,0
16560,Wolfson Campus,MAT 1033 - 0151   Intermediate Algebra,0151-LEC Main Sess,Staff,38,0,38,0,0
16562,Wolfson Campus,MAT 1033 - 0153   Intermediate Algebra,0153-LEC Main Sess,Staff,38,34,4,0,0
16732,Wolfson Campus,MAT 1033 - 0154   Intermediate Algebra,0154-LEC Conversion,Staff,35,20,15,0,0
16661,Wolfson Campus,MAT 1033 - 0155   Intermediate Algebra,0155-LEC Twelve Wk,Staff,38,37,1,0,0
16662,Wolfson Campus,MAT 1033 - 0156   Intermediate Algebra,0156-LEC Twelve Wk,Staff,30,28,2,0,0
16699,Wolfson Campus,MAT 1033 - 0157   Intermediate Algebra,0157-LEC Eight Wk 2,Staff,38,23,15,0,0
16700,Wolfson Campus,MAT 1033 - 0158   Intermediate Algebra,0158-LEC Eight Wk 2,Staff,41,31,10,0,0
16671,Wolfson Campus,MAT 1033 - 0159   Intermediate Algebra,0159-LEC Eight Wk 1,Staff,25,0,25,0,0
16563,Wolfson Campus,MAT 1033 - 0160   Intermediate Algebra,0160-LEC Main Sess,Staff,38,28,10,0,0
16564,Wolfson Campus,MAT 1033 - 0161   Intermediate Algebra,0161-LEC Main Sess,Staff,38,36,2,0,0
16565,Wolfson Campus,MAT 1033 - 0162   Intermediate Algebra,0162-LEC Main Sess,Staff,42,26,16,0,0
16566,Wolfson Campus,MAT 1033 - 0163   Intermediate Algebra,0163-LEC Main Sess,Staff,38,0,38,0,0
16567,Wolfson Campus,MAT 1033 - 0164   Intermediate Algebra,0164-LEC Main Sess,Staff,38,34,4,0,0
16568,Wolfson Campus,MAT 1033 - 0165   Intermediate Algebra,0165-LEC Main Sess,Staff,35,0,35,0,0
16733,Wolfson Campus,MAT 1033 - 0166   Intermediate Algebra,0166-LEC Conversion,Staff,38,12,26,0,0
16569,Wolfson Campus,MAT 1033 - 0167   Intermediate Algebra,0167-LEC Main Sess,Staff,30,0,30,0,0
16570,Wolfson Campus,MAT 1033 - 0168   Intermediate Algebra,0168-LEC Main Sess,Staff,38,29,9,0,0
16571,Wolfson Campus,MAT 1033 - 0169   Intermediate Algebra,0169-LEC Main Sess,Staff,32,0,32,0,0
16572,Wolfson Campus,MAT 1033 - 0170   Intermediate Algebra,0170-LEC Main Sess,Staff,38,24,14,0,0
16573,Wolfson Campus,MAT 1033 - 0171   Intermediate Algebra,0171-LEC Main Sess,Staff,38,0,38,0,0
16574,Wolfson Campus,MAT 1033 - 0172   Intermediate Algebra,0172-LEC Main Sess,Staff,38,35,3,0,0
16575,Wolfson Campus,MAT 1033 - 0173   Intermediate Algebra,0173-LEC Main Sess,Staff,38,29,9,0,0
16663,Wolfson Campus,MAT 1033 - 0174   Intermediate Algebra,0174-LEC Twelve Wk,Staff,41,39,2,0,0
16664,Wolfson Campus,MAT 1033 - 0175   Intermediate Algebra,0175-LEC Twelve Wk,Staff,35,25,10,0,0
16701,Wolfson Campus,MAT 1033 - 0176   Intermediate Algebra,0176-LEC Eight Wk 2,Staff,38,25,13,0,0
16731,Wolfson Campus,MAT 1033 - 0177   Intermediate Algebra,0177-LEC Conversion,Staff,41,34,7,0,0
16576,Wolfson Campus,MAT 1033 - 0178   Intermediate Algebra,0178-LEC Main Sess,Staff,35,32,3,0,0
16577,Wolfson Campus,MAT 1033 - 0179   Intermediate Algebra,0179-LEC Main Sess,Staff,30,29,1,0,0
16578,Wolfson Campus,MAT 1033 - 0180   Intermediate Algebra,0180-LEC Main Sess,Staff,30,25,5,0,0
16579,Wolfson Campus,MAT 1033 - 0181   Intermediate Algebra,0181-LEC Main Sess,Staff,30,26,4,0,0
16580,Wolfson Campus,MAT 1033 - 0182   Intermediate Algebra,0182-LEC Main Sess,Staff,30,26,4,0,0
16581,Wolfson Campus,MAT 1033 - 0183   Intermediate Algebra,0183-LEC Main Sess,Staff,30,26,4,0,0
16582,Wolfson Campus,MAT 1033 - 0184   Intermediate Algebra,0184-LEC Main Sess,Staff,30,24,6,0,0
16583,Wolfson Campus,MAT 1033 - 0185   Intermediate Algebra,0185-LEC Main Sess,Staff,30,26,4,0,0
16702,Wolfson Campus,MAT 1033 - 0186   Intermediate Algebra,0186-LEC Eight Wk 2,Staff,30,21,9,0,0
16584,Wolfson Campus,MAT 1033 - 0187   Intermediate Algebra,0187-LEC Main Sess,Staff,30,29,1,0,0
16585,Wolfson Campus,MAT 1033 - 0188   Intermediate Algebra,0188-LEC Main Sess,Staff,30,24,6,0,0
16586,Wolfson Campus,MAT 1033 - 0189   Intermediate Algebra,0189-LEC Main Sess,Staff,30,13,17,0,0
16703,Wolfson Campus,MAT 1033 - 0190   Intermediate Algebra,0190-LEC Eight Wk 2,Staff,30,28,2,0,0
16587,Wolfson Campus,MAT 1033 - 0191   Intermediate Algebra,0191-LEC Main Sess,Staff,30,28,2,0,0
16588,Wolfson Campus,MAT 1033 - 0192   Intermediate Algebra,0192-LEC Main Sess,Staff,30,21,9,0,0
16589,Wolfson Campus,MAT 1033 - 0193   Intermediate Algebra,0193-LEC Main Sess,Staff,30,24,6,0,0
16670,Homestead Campus,MAT 1033 - 0194   Intermediate Algebra,0194-LEC Eight Wk 1,Staff,28,26,2,0,0
16590,Homestead Campus,MAT 1033 - 0195   Intermediate Algebra,0195-LEC Main Sess,Staff,28,24,4,0,0
16669,Homestead Campus,MAT 1033 - 0196   Intermediate Algebra,0196-LEC Eight Wk 1,Staff,28,0,28,0,0
16591,Homestead Campus,MAT 1033 - 0197   Intermediate Algebra,0197-LEC Main Sess,Staff,25,0,25,0,0
16592,Homestead Campus,MAT 1033 - 0198   Intermediate Algebra,0198-LEC Main Sess,Staff,25,0,25,0,0
16595,Homestead Campus,MAT 1033 - 0201   Intermediate Algebra,0201-LEC Main Sess,Staff,28,26,2,0,0
16596,Homestead Campus,MAT 1033 - 0202   Intermediate Algebra,0202-LEC Main Sess,Staff,25,0,25,0,0
16597,Homestead Campus,MAT 1033 - 0203   Intermediate Algebra,0203-LEC Main Sess,Staff,30,0,30,0,0
16598,Homestead Campus,MAT 1033 - 0204   Intermediate Algebra,0204-LEC Main Sess,Staff,28,26,2,0,0
16599,Homestead Campus,MAT 1033 - 0205   Intermediate Algebra,0205-LEC Main Sess,Staff,25,0,25,0,0
16600,Homestead Campus,MAT 1033 - 0206   Intermediate Algebra,0206-LEC Main Sess,Staff,23,21,2,0,0
16601,Homestead Campus,MAT 1033 - 0207   Intermediate Algebra,0207-LEC Main Sess,Staff,21,15,6,0,0
16602,Homestead Campus,MAT 1033 - 0208   Intermediate Algebra,0208-LEC Main Sess,Staff,25,19,6,0,0
16603,Homestead Campus,MAT 1033 - 0209   Intermediate Algebra,0209-LEC Main Sess,Staff,28,25,3,0,0
16604,Homestead Campus,MAT 1033 - 0210   Intermediate Algebra,0210-LEC Main Sess,Staff,28,0,28,0,0
16605,Homestead Campus,MAT 1033 - 0211   Intermediate Algebra,0211-LEC Main Sess,Staff,25,21,4,0,0
16606,Homestead Campus,MAT 1033 - 0212   Intermediate Algebra,0212-LEC Main Sess,Staff,28,0,28,0,0
16607,Homestead Campus,MAT 1033 - 0213   Intermediate Algebra,0213-LEC Main Sess,Staff,28,12,16,0,0
16704,Homestead Campus,MAT 1033 - 0214   Intermediate Algebra,0214-LEC Eight Wk 2,Staff,28,17,11,0,0
16608,Homestead Campus,MAT 1033 - 0215   Intermediate Algebra,0215-LEC Main Sess,Staff,25,0,25,0,0
16609,InterAmerican Campus,MAT 1033 - 0216   Intermediate Algebra,0216-LEC Main Sess,Staff,37,23,14,0,0
16610,InterAmerican Campus,MAT 1033 - 0217   Intermediate Algebra,0217-LEC Main Sess,Staff,37,33,4,0,0
16611,InterAmerican Campus,MAT 1033 - 0218   Intermediate Algebra,0218-LEC Main Sess,Staff,37,15,22,0,0
16705,InterAmerican Campus,MAT 1033 - 0219   Intermediate Algebra,0219-LEC Eight Wk 2,Staff,30,13,17,0,0
16706,InterAmerican Campus,MAT 1033 - 0220   Intermediate Algebra,0220-LEC Eight Wk 2,Staff,37,0,37,0,0
16612,InterAmerican Campus,MAT 1033 - 0221   Intermediate Algebra,0221-LEC Main Sess,Staff,37,0,37,0,0
16665,InterAmerican Campus,MAT 1033 - 0222   Intermediate Algebra,0222-LEC Twelve Wk,Staff,37,0,37,0,0
16668,InterAmerican Campus,MAT 1033 - 0223   Intermediate Algebra,0223-LEC Eight Wk 1,Staff,30,10,20,0,0
16613,InterAmerican Campus,MAT 1033 - 0224   Intermediate Algebra,0224-LEC Main Sess,Staff,35,29,6,0,0
16614,InterAmerican Campus,MAT 1033 - 0225   Intermediate Algebra,0225-LEC Main Sess,Staff,35,31,4,0,0
16707,InterAmerican Campus,MAT 1033 - 0226   Intermediate Algebra,0226-LEC Eight Wk 2,Staff,37,22,15,0,0
16742,InterAmerican Campus,MAT 1033 - 0227   Intermediate Algebra,0227-LEC Weekend,Staff,30,14,16,0,0
16708,InterAmerican Campus,MAT 1033 - 0228   Intermediate Algebra,0228-LEC Eight Wk 2,Staff,21,0,21,0,0
16709,InterAmerican Campus,MAT 1033 - 0229   Intermediate Algebra,0229-LEC Eight Wk 2,Staff,21,6,15,0,0
16615,InterAmerican Campus,MAT 1033 - 0230   Intermediate Algebra,0230-LEC Main Sess,Staff,30,24,6,0,0
16710,InterAmerican Campus,MAT 1033 - 0231   Intermediate Algebra,0231-LEC Eight Wk 2,Staff,30,9,21,0,0
16616,InterAmerican Campus,MAT 1033 - 0233   Intermediate Algebra,0233-LEC Main Sess,Staff,30,26,4,0,0
16617,Hialeah Campus,MAT 1033 - 0234   Intermediate Algebra,0234-LEC Main Sess,Staff,30,29,1,0,0
16666,Hialeah Campus,MAT 1033 - 0235   Intermediate Algebra,0235-LEC Twelve Wk,Staff,35,34,1,0,0
16711,Hialeah Campus,MAT 1033 - 0236   Intermediate Algebra,0236-LEC Eight Wk 2,Staff,30,19,11,0,0
16618,Hialeah Campus,MAT 1033 - 0237   Intermediate Algebra,0237-LEC Main Sess,Staff,30,27,3,0,0
16643,Hialeah Campus,MAT 1033 - 0238   Intermediate Algebra,0238-LEC Main Sess,Staff,30,28,2,0,0
16740,Hialeah Campus,MAT 1033 - 0239   Intermediate Algebra,0239-LEC Weekend,Staff,30,0,30,0,0
16620,Hialeah Campus,MAT 1033 - 0241   Intermediate Algebra,0241-LEC Main Sess,Staff,30,0,30,0,0
16621,Hialeah Campus,MAT 1033 - 0242   Intermediate Algebra,0242-LEC Main Sess,Staff,30,27,3,0,0
16622,Hialeah Campus,MAT 1033 - 0243   Intermediate Algebra,0243-LEC Main Sess,Staff,30,0,30,0,0
16623,Hialeah Campus,MAT 1033 - 0244   Intermediate Algebra,0244-LEC Main Sess,Staff,30,24,6,0,0
16624,Hialeah Campus,MAT 1033 - 0245   Intermediate Algebra,0245-LEC Main Sess,Staff,30,26,4,0,0
16712,Hialeah Campus,MAT 1033 - 0246   Intermediate Algebra,0246-LEC Eight Wk 2,Staff,30,28,2,0,0
16625,Hialeah Campus,MAT 1033 - 0247   Intermediate Algebra,0247-LEC Main Sess,Staff,30,26,4,0,0
16626,Hialeah Campus,MAT 1033 - 0248   Intermediate Algebra,0248-LEC Main Sess,Staff,30,0,30,0,0
16627,Hialeah Campus,MAT 1033 - 0249   Intermediate Algebra,0249-LEC Main Sess,Staff,30,28,2,0,0
16628,Hialeah Campus,MAT 1033 - 0250   Intermediate Algebra,0250-LEC Main Sess,Staff,30,26,4,0,0
16629,Hialeah Campus,MAT 1033 - 0251   Intermediate Algebra,0251-LEC Main Sess,Staff,30,28,2,0,0
16630,Hialeah Campus,MAT 1033 - 0252   Intermediate Algebra,0252-LEC Main Sess,Staff,30,26,4,0,0
16631,Hialeah Campus,MAT 1033 - 0253   Intermediate Algebra,0253-LEC Main Sess,Staff,30,18,12,0,0
16632,Hialeah Campus,MAT 1033 - 0254   Intermediate Algebra,0254-LEC Main Sess,Staff,30,27,3,0,0
16633,West Campus,MAT 1033 - 0255   Intermediate Algebra,0255-LEC Main Sess,Staff,35,21,14,0,0
16634,West Campus,MAT 1033 - 0256   Intermediate Algebra,0256-LEC Main Sess,Staff,35,12,23,0,0
16713,West Campus,MAT 1033 - 0257   Intermediate Algebra,0257-LEC Eight Wk 2,Staff,35,9,26,0,0
16714,West Campus,MAT 1033 - 0258   Intermediate Algebra,0258-LEC Eight Wk 2,Staff,30,19,11,0,0
16635,West Campus,MAT 1033 - 0259   Intermediate Algebra,0259-LEC Main Sess,Staff,35,31,4,0,0
16715,West Campus,MAT 1033 - 0260   Intermediate Algebra,0260-LEC Eight Wk 2,Staff,35,0,35,0,0
16716,West Campus,MAT 1033 - 0261   Intermediate Algebra,0261-LEC Eight Wk 2,Staff,35,19,16,0,0
16717,West Campus,MAT 1033 - 0262   Intermediate Algebra,0262-LEC Eight Wk 2,Staff,35,0,35,0,0
16688,West Campus,MAT 1033 - 0263   Intermediate Algebra,0263-LEC Eight Wk 2,Staff,30,0,30,0,0
16636,West Campus,MAT 1033 - 0264   Intermediate Algebra,0264-LEC Main Sess,Staff,35,34,1,0,0
16637,West Campus,MAT 1033 - 0265   Intermediate Algebra,0265-LEC Main Sess,Staff,35,34,1,0,0
16638,West Campus,MAT 1033 - 0266   Intermediate Algebra,0266-LEC Main Sess,Staff,35,16,19,0,0
16639,West Campus,MAT 1033 - 0267   Intermediate Algebra,0267-LEC Main Sess,Staff,35,21,14,0,0
16640,West Campus,MAT 1033 - 0268   Intermediate Algebra,0268-LEC Main Sess,Staff,35,29,6,0,0
16641,West Campus,MAT 1033 - 0269   Intermediate Algebra,0269-LEC Main Sess,Staff,35,17,18,0,0
16642,West Campus,MAT 1033 - 0270   Intermediate Algebra,0270-LEC Main Sess,Staff,32,0,32,0,0
16645,West Campus,MAT 1033 - 0271   Intermediate Algebra,0271-LEC Twelve Wk,Staff,35,25,10,0,0
6424,North Campus,CHM 1033L - 0001   Chemistry For Health Sciences Lab,0001-LAB Main Sess,Staff,24,8,16,0,0
6425,North Campus,CHM 1033L - 0002   Chemistry For Health Sciences Lab,0002-LAB Main Sess,Staff,24,11,13,0,0
6426,North Campus,CHM 1033L - 0003   Chemistry For Health Sciences Lab,0003-LAB Main Sess,Staff,24,21,3,0,0
6427,North Campus,CHM 1033L - 0004   Chemistry For Health Sciences Lab,0004-LAB Main Sess,Staff,24,23,1,0,0
6428,North Campus,CHM 1033L - 0005   Chemistry For Health Sciences Lab,0005-LAB Main Sess,Staff,24,16,8,0,0
6429,North Campus,CHM 1033L - 0007   Chemistry For Health Sciences Lab,0007-LAB Main Sess,Staff,24,11,13,0,0
6430,North Campus,CHM 1033L - 0008   Chemistry For Health Sciences Lab,0008-LAB Main Sess,Staff,24,0,24,0,0
6431,North Campus,CHM 1033L - 0009   Chemistry For Health Sciences Lab,0009-LAB Main Sess,Staff,24,22,2,0,0
6432,North Campus,CHM 1033L - 0010   Chemistry For Health Sciences Lab,0010-LAB Main Sess,Staff,24,0,24,0,0
6433,North Campus,CHM 1033L - 0011   Chemistry For Health Sciences Lab,0011-LAB Main Sess,Staff,24,1,23,0,0
6482,North Campus,CHM 1033L - 0012   Chemistry For Health Sciences Lab,0012-LAB Twelve Wk,Staff,24,22,2,0,0
6476,North Campus,CHM 1033L - 0014   Chemistry For Health Sciences Lab,0014-LAB Main Sess,Staff,24,20,4,0,0
6434,North Campus,CHM 1033L - 0015   Chemistry For Health Sciences Lab,0015-LAB Main Sess,Staff,24,0,24,0,0
6436,North Campus,CHM 1033L - 0017   Chemistry For Health Sciences Lab,0017-LAB Main Sess,Staff,24,20,4,0,0
6437,North Campus,CHM 1033L - 0018   Chemistry For Health Sciences Lab,0018-LAB Main Sess,Staff,24,0,24,0,0
6438,North Campus,CHM 1033L - 0019   Chemistry For Health Sciences Lab,0019-LAB Main Sess,Staff,24,20,4,0,0
6481,North Campus,CHM 1033L - 0020   Chemistry For Health Sciences Lab,0020-LAB Twelve Wk,Staff,24,18,6,0,0
6480,North Campus,CHM 1033L - 0021   Chemistry For Health Sciences Lab,0021-LAB Twelve Wk,Staff,24,17,7,0,0
6491,North Campus,CHM 1033L - 0022   Chemistry For Health Sciences Lab,0022-LAB 1st Mon Sp,Staff,24,23,1,0,0
6439,Kendall Campus,CHM 1033L - 0024   Chemistry For Health Sciences Lab,0024-LAB Main Sess,Staff,24,21,3,0,0
6440,Kendall Campus,CHM 1033L - 0025   Chemistry For Health Sciences Lab,0025-LAB Main Sess,Staff,22,19,3,0,0
6441,Kendall Campus,CHM 1033L - 0027   Chemistry For Health Sciences Lab,0027-LAB Main Sess,Staff,18,17,1,0,0
6499,Kendall Campus,CHM 1033L - 0028   Chemistry For Health Sciences Lab,0028-LAB Weekend,Staff,18,0,18,0,0
6494,Kendall Campus,CHM 1033L - 0029   Chemistry For Health Sciences Lab,0029-LAB 1st Mon Sp,Staff,18,17,1,0,0
6496,Kendall Campus,CHM 1033L - 0031   Chemistry For Health Sciences Lab,0031-LAB 1st Mon Sp,Staff,18,14,4,0,0
6442,Kendall Campus,CHM 1033L - 0032   Chemistry For Health Sciences Lab,0032-LAB Main Sess,Staff,22,20,2,0,0
6477,Kendall Campus,CHM 1033L - 0034   Chemistry For Health Sciences Lab,0034-LAB Main Sess,Staff,18,16,2,0,0
6444,Kendall Campus,CHM 1033L - 0036   Chemistry For Health Sciences Lab,0036-LAB Main Sess,Staff,18,17,1,0,0
6445,Kendall Campus,CHM 1033L - 0037   Chemistry For Health Sciences Lab,0037-LAB Main Sess,Staff,24,20,4,0,0
6446,Kendall Campus,CHM 1033L - 0038   Chemistry For Health Sciences Lab,0038-LAB Main Sess,Staff,18,15,3,0,0
6447,Kendall Campus,CHM 1033L - 0039   Chemistry For Health Sciences Lab,0039-LAB Main Sess,Staff,18,17,1,0,0
6448,Kendall Campus,CHM 1033L - 0040   Chemistry For Health Sciences Lab,0040-LAB Main Sess,Staff,24,23,1,0,0
6449,Kendall Campus,CHM 1033L - 0042   Chemistry For Health Sciences Lab,0042-LAB Main Sess,Staff,24,22,2,0,0
6450,Kendall Campus,CHM 1033L - 0043   Chemistry For Health Sciences Lab,0043-LAB Main Sess,Staff,18,17,1,0,0
6451,Kendall Campus,CHM 1033L - 0044   Chemistry For Health Sciences Lab,0044-LAB Main Sess,Staff,18,13,5,0,0
6488,Kendall Campus,CHM 1033L - 0048   Chemistry For Health Sciences Lab,0048-LAB 1st Mon Sp,Staff,18,17,1,0,0
6478,Kendall Campus,CHM 1033L - 0049   Chemistry For Health Sciences Lab,0049-LAB Main Sess,Staff,22,21,1,0,0
6500,Kendall Campus,CHM 1033L - 0050   Chemistry For Health Sciences Lab,0050-LAB Weekend,Staff,18,11,7,0,0
6487,Kendall Campus,CHM 1033L - 0051   Chemistry For Health Sciences Lab,0051-LAB 1st Mon Sp,Staff,18,17,1,0,0
6486,Kendall Campus,CHM 1033L - 0052   Chemistry For Health Sciences Lab,0052-LAB 1st Mon Sp,Staff,18,16,2,0,0
6453,Wolfson Campus,CHM 1033L - 0053   Chemistry For Health Sciences Lab,0053-LAB Main Sess,Staff,20,17,3,0,0
6454,Wolfson Campus,CHM 1033L - 0054   Chemistry For Health Sciences Lab,0054-LAB Main Sess,Staff,20,18,2,0,0
6501,Wolfson Campus,CHM 1033L - 0055   Chemistry For Health Sciences Lab,0055-LAB Weekend,Staff,1,0,1,0,0
6485,Wolfson Campus,CHM 1033L - 0056   Chemistry For Health Sciences Lab,0056-LAB 1st Mon Sp,Staff,20,19,1,0,0
6502,Wolfson Campus,CHM 1033L - 0058   Chemistry For Health Sciences Lab,0058-LAB Weekend,Staff,20,18,2,0,0
6492,Wolfson Campus,CHM 1033L - 0059   Chemistry For Health Sciences Lab,0059-LAB 1st Mon Sp,Staff,20,18,2,0,0
6456,Wolfson Campus,CHM 1033L - 0060   Chemistry For Health Sciences Lab,0060-LAB Main Sess,Staff,20,17,3,0,0
6457,Wolfson Campus,CHM 1033L - 0061   Chemistry For Health Sciences Lab,0061-LAB Main Sess,Staff,20,16,4,0,0
6505,Wolfson Campus,CHM 1033L - 0063   Chemistry For Health Sciences Lab,0063-LAB Weekend,Staff,1,0,1,0,0
6458,Homestead Campus,CHM 1033L - 0064   Chemistry For Health Sciences Lab,0064-LAB Main Sess,Staff,24,20,4,0,0
6459,Homestead Campus,CHM 1033L - 0066   Chemistry For Health Sciences Lab,0066-LAB Main Sess,Staff,24,23,1,0,0
6460,Homestead Campus,CHM 1033L - 0067   Chemistry For Health Sciences Lab,0067-LAB Main Sess,Staff,24,21,3,0,0
6461,Homestead Campus,CHM 1033L - 0068   Chemistry For Health Sciences Lab,0068-LAB Main Sess,Staff,24,0,24,0,0
6462,InterAmerican Campus,CHM 1033L - 0069   Chemistry For Health Sciences Lab,0069-LAB Main Sess,Staff,20,15,5,0,0
6463,InterAmerican Campus,CHM 1033L - 0070   Chemistry For Health Sciences Lab,0070-LAB Main Sess,Staff,20,19,1,0,0
6466,InterAmerican Campus,CHM 1033L - 0073   Chemistry For Health Sciences Lab,0073-LAB Main Sess,Staff,20,17,3,0,0
6467,Hialeah Campus,CHM 1033L - 0075   Chemistry For Health Sciences Lab,0075-LAB Main Sess,Staff,24,23,1,0,0
6468,Hialeah Campus,CHM 1033L - 0076   Chemistry For Health Sciences Lab,0076-LAB Main Sess,Staff,24,18,6,0,0
6469,Hialeah Campus,CHM 1033L - 0077   Chemistry For Health Sciences Lab,0077-LAB Main Sess,Staff,24,20,4,0,0
6470,Hialeah Campus,CHM 1033L - 0078   Chemistry For Health Sciences Lab,0078-LAB Main Sess,Staff,24,15,9,0,0
6471,Hialeah Campus,CHM 1033L - 0079   Chemistry For Health Sciences Lab,0079-LAB Main Sess,Staff,24,0,24,0,0
6472,Hialeah Campus,CHM 1033L - 0080   Chemistry For Health Sciences Lab,0080-LAB Main Sess,Staff,24,23,1,0,0
6473,Hialeah Campus,CHM 1033L - 0081   Chemistry For Health Sciences Lab,0081-LAB Main Sess,Staff,24,22,2,0,0
6474,Hialeah Campus,CHM 1033L - 0082   Chemistry For Health Sciences Lab,0082-LAB Main Sess,Staff,24,22,2,0,0
14554,North Campus,FIL 1030 - 0001   History Of Film,0001-LEC Main Sess,Staff,80,44,36,0,0
14556,Kendall Campus,FIL 1030 - 0002   History Of Film,0002-LEC Conversion,Staff,55,44,11,0,0
14555,Wolfson Campus,FIL 1030 - 0003   History Of Film,0003-LEC Main Sess,Staff,30,14,16,0,0
8779,North Campus,CHM 1025 - 0001   Introductory Chemistry,0001-LEC Main Sess,Staff,40,36,4,0,0
8826,North Campus,CHM 1025 - 0002   Introductory Chemistry,0002-LEC Conversion,Staff,45,38,7,0,0
8825,North Campus,CHM 1025 - 0003   Introductory Chemistry,0003-LEC Twelve Wk,Staff,40,19,21,0,0
8827,North Campus,CHM 1025 - 0005   Introductory Chemistry,0005-LEC 1st Mon Sp,Staff,45,41,4,0,0
8780,North Campus,CHM 1025 - 0006   Introductory Chemistry,0006-LEC Main Sess,Staff,40,32,8,0,0
8790,North Campus,CHM 1025 - 0007   Introductory Chemistry,0007-LEC Main Sess,Staff,45,37,8,0,0
8822,North Campus,CHM 1025 - 0008   Introductory Chemistry,0008-LEC Twelve Wk,Staff,40,39,1,0,0
8791,North Campus,CHM 1025 - 0009   Introductory Chemistry,0009-LEC Main Sess,Staff,40,38,2,0,0
8821,North Campus,CHM 1025 - 0010   Introductory Chemistry,0010-LEC Twelve Wk,Staff,40,0,40,0,0
8792,North Campus,CHM 1025 - 0011   Introductory Chemistry,0011-LEC Main Sess,Staff,45,40,5,0,0
8820,North Campus,CHM 1025 - 0012   Introductory Chemistry,0012-LEC Twelve Wk,Staff,45,43,2,0,0
8819,North Campus,CHM 1025 - 0013   Introductory Chemistry,0013-LEC Twelve Wk,Staff,40,0,40,0,0
8793,Kendall Campus,CHM 1025 - 0014   Introductory Chemistry,0014-LEC Main Sess,Staff,110,109,1,0,0
8794,Kendall Campus,CHM 1025 - 0015   Introductory Chemistry,0015-LEC Main Sess,Staff,110,102,8,0,0
8796,Kendall Campus,CHM 1025 - 0017   Introductory Chemistry,0017-LEC Main Sess,Staff,110,109,1,0,0
8797,Kendall Campus,CHM 1025 - 0018   Introductory Chemistry,0018-LEC Main Sess,Staff,110,109,1,0,0
8798,Kendall Campus,CHM 1025 - 0019   Introductory Chemistry,0019-LEC Main Sess,Staff,110,108,2,0,0
8800,Kendall Campus,CHM 1025 - 0021   Introductory Chemistry,0021-LEC Main Sess,Staff,110,106,4,0,0
8802,Kendall Campus,CHM 1025 - 0023   Introductory Chemistry,0023-LEC Main Sess,Staff,50,45,5,0,0
8803,Wolfson Campus,CHM 1025 - 0024   Introductory Chemistry,0024-LEC Main Sess,Staff,45,39,6,0,0
8805,Wolfson Campus,CHM 1025 - 0026   Introductory Chemistry,0026-LEC Main Sess,Staff,45,43,2,0,0
8808,Wolfson Campus,CHM 1025 - 0029   Introductory Chemistry,0029-LEC Main Sess,Staff,45,44,1,0,0
8809,Wolfson Campus,CHM 1025 - 0030   Introductory Chemistry,0030-LEC Main Sess,Staff,35,33,2,0,0
8810,Wolfson Campus,CHM 1025 - 0031   Introductory Chemistry,0031-LEC Main Sess,Staff,45,44,1,0,0
8812,Homestead Campus,CHM 1025 - 0033   Introductory Chemistry,0033-LEC Main Sess,Staff,24,0,24,0,0
8818,Homestead Campus,CHM 1025 - 0034   Introductory Chemistry,0034-LEC Twelve Wk,Staff,39,17,22,0,0
8823,InterAmerican Campus,CHM 1025 - 0036   Introductory Chemistry,0036-LEC Twelve Wk,Staff,35,28,7,0,0
8815,InterAmerican Campus,CHM 1025 - 0038   Introductory Chemistry,0038-LEC Main Sess,Staff,40,37,3,0,0
8817,Hialeah Campus,CHM 1025 - 0040   Introductory Chemistry,0040-LEC Main Sess,Staff,45,32,13,0,0
8789,Hialeah Campus,CHM 1025 - 0041   Introductory Chemistry,0041-LEC Main Sess,Staff,45,41,4,0,0
8788,Hialeah Campus,CHM 1025 - 0042   Introductory Chemistry,0042-LEC Main Sess,Staff,38,25,13,0,0
8787,Hialeah Campus,CHM 1025 - 0043   Introductory Chemistry,0043-LEC Main Sess,Staff,38,36,2,0,0
8786,Hialeah Campus,CHM 1025 - 0044   Introductory Chemistry,0044-LEC Main Sess,Staff,38,35,3,0,0
8785,Hialeah Campus,CHM 1025 - 0045   Introductory Chemistry,0045-LEC Main Sess,Staff,45,41,4,0,0
8784,Hialeah Campus,CHM 1025 - 0046   Introductory Chemistry,0046-LEC Main Sess,Staff,38,34,4,0,0
8783,Hialeah Campus,CHM 1025 - 0047   Introductory Chemistry,0047-LEC Main Sess,Staff,44,41,3,0,0
8782,West Campus,CHM 1025 - 0048   Introductory Chemistry,0048-LEC Main Sess,Staff,35,33,2,0,0
8781,West Campus,CHM 1025 - 0049   Introductory Chemistry,0049-LEC Main Sess,Staff,35,34,1,0,0
13955,Medical Campus,NUR 1025 - 0001   Fundamentals Of Nursing,0001-LEC Conversion,Staff,48,44,4,0,0
13957,Medical Campus,NUR 1025 - 0003   Fundamentals Of Nursing,0003-LEC Conversion,Staff,30,0,30,0,0
13954,Medical Campus,NUR 1025 - 0004   Fundamentals Of Nursing,0004-LEC Conversion,Staff,40,24,16,0,0
13958,Homestead Campus,NUR 1025 - 0006   Fundamentals Of Nursing,0006-LEC Conversion,Staff,65,49,16,0,0
13956,Homestead Campus,NUR 1025 - 0007   Fundamentals Of Nursing,0007-LEC Conversion,Staff,35,25,10,0,0
9707,North Campus,PHY 1025 - 0001   Basic Physics,0001-LEC Main Sess,Staff,30,16,14,0,0
9693,North Campus,PHY 1025 - 0002   Basic Physics,0002-LEC Main Sess,Staff,30,21,9,0,0
9694,North Campus,PHY 1025 - 0003   Basic Physics,0003-LEC Main Sess,Staff,32,30,2,0,0
9695,Kendall Campus,PHY 1025 - 0005   Basic Physics,0005-LEC Main Sess,Staff,110,50,60,0,0
9696,Kendall Campus,PHY 1025 - 0006   Basic Physics,0006-LEC Main Sess,Staff,35,25,10,0,0
9697,Wolfson Campus,PHY 1025 - 0007   Basic Physics,0007-LEC Main Sess,Staff,30,29,1,0,0
9699,Wolfson Campus,PHY 1025 - 0009   Basic Physics,0009-LEC Main Sess,Staff,35,18,17,0,0
9700,Wolfson Campus,PHY 1025 - 0010   Basic Physics,0010-LEC Main Sess,Staff,35,32,3,0,0
9701,Wolfson Campus,PHY 1025 - 0011   Basic Physics,0011-LEC Main Sess,Staff,30,26,4,0,0
9702,Wolfson Campus,PHY 1025 - 0012   Basic Physics,0012-LEC Main Sess,Staff,30,18,12,0,0
9703,Homestead Campus,PHY 1025 - 0013   Basic Physics,0013-LEC Main Sess,Staff,39,0,39,0,0
9704,Homestead Campus,PHY 1025 - 0014   Basic Physics,0014-LEC Main Sess,Staff,39,19,20,0,0
9705,InterAmerican Campus,PHY 1025 - 0015   Basic Physics,0015-LEC Main Sess,Staff,33,11,22,0,0
9706,InterAmerican Campus,PHY 1025 - 0016   Basic Physics,0016-LEC Main Sess,Staff,24,12,12,0,0
8058,North Campus,CHM 1025L - 0001   Introductory Chemistry Lab,0001-LAB Main Sess,Staff,24,16,8,0,0
8059,North Campus,CHM 1025L - 0002   Introductory Chemistry Lab,0002-LAB Main Sess,Staff,24,12,12,0,0
8065,North Campus,CHM 1025L - 0003   Introductory Chemistry Lab,0003-LAB Main Sess,Staff,24,22,2,0,0
8070,Kendall Campus,CHM 1025L - 0004   Introductory Chemistry Lab,0004-LAB 1st Mon Sp,Staff,36,31,5,0,0
8060,Kendall Campus,CHM 1025L - 0005   Introductory Chemistry Lab,0005-LAB Main Sess,Staff,35,31,4,0,0
8061,Kendall Campus,CHM 1025L - 0006   Introductory Chemistry Lab,0006-LAB Main Sess,Staff,45,30,15,0,0
8062,Kendall Campus,CHM 1025L - 0007   Introductory Chemistry Lab,0007-LAB Main Sess,Staff,36,27,9,0,0
8069,Kendall Campus,CHM 1025L - 0008   Introductory Chemistry Lab,0008-LAB Conversion,Staff,30,0,30,0,0
8063,Wolfson Campus,CHM 1025L - 0009   Introductory Chemistry Lab,0009-LAB Main Sess,Staff,20,14,6,0,0
8064,Wolfson Campus,CHM 1025L - 0010   Introductory Chemistry Lab,0010-LAB Main Sess,Staff,20,12,8,0,0
8066,Homestead Campus,CHM 1025L - 0011   Introductory Chemistry Lab,0011-LAB Main Sess,Staff,24,5,19,0,0
8067,Homestead Campus,CHM 1025L - 0012   Introductory Chemistry Lab,0012-LAB Main Sess,Staff,24,16,8,0,0
8068,InterAmerican Campus,CHM 1025L - 0013   Introductory Chemistry Lab,0013-LAB Main Sess,Staff,24,10,14,0,0
12340,Medical Campus,NUR 1025L - 0001   Fundamentals Of Nursing Clinical Lab,0001-CLN Conversion,Staff,8,7,1,0,0
12357,Medical Campus,NUR 1025L - 0006   Fundamentals Of Nursing Clinical Lab,0006-CLN Conversion,Staff,8,6,2,0,0
12341,Medical Campus,NUR 1025L - 0007   Fundamentals Of Nursing Clinical Lab,0007-CLN Conversion,Staff,8,0,8,0,0
12342,Medical Campus,NUR 1025L - 0008   Fundamentals Of Nursing Clinical Lab,0008-CLN Conversion,Staff,8,7,1,0,0
12362,Medical Campus,NUR 1025L - 0013   Fundamentals Of Nursing Clinical Lab,0013-CLN Conversion,Staff,8,7,1,0,0
12363,Medical Campus,NUR 1025L - 0014   Fundamentals Of Nursing Clinical Lab,0014-CLN Conversion,Staff,8,0,8,0,0
12359,Medical Campus,NUR 1025L - 0015   Fundamentals Of Nursing Clinical Lab,0015-CLN Conversion,Staff,8,0,8,0,0
12343,Medical Campus,NUR 1025L - 0016   Fundamentals Of Nursing Clinical Lab,0016-CLN Conversion,Staff,8,6,2,0,0
12344,Medical Campus,NUR 1025L - 0022   Fundamentals Of Nursing Clinical Lab,0022-CLN Conversion,Staff,8,0,8,0,0
12366,Medical Campus,NUR 1025L - 0023   Fundamentals Of Nursing Clinical Lab,0023-CLN Conversion,Staff,8,6,2,0,0
12353,Medical Campus,NUR 1025L - 0026   Fundamentals Of Nursing Clinical Lab,0026-CLN Conversion,Staff,8,7,1,0,0
12332,Homestead Campus,NUR 1025L - 0030   Fundamentals Of Nursing Clinical Lab,0030-CLN Conversion,Staff,8,7,1,0,0
12339,Homestead Campus,NUR 1025L - 0037   Fundamentals Of Nursing Clinical Lab,0037-CLN Conversion,Staff,8,5,3,0,0
6890,Homestead Campus,AVM 1022 - 0001   Flight Operations,0001-LEC Main Sess,Staff,30,17,13,0,0
10390,North Campus,MKA 1021 - 0001   Fundamentals Of Selling,0001-LEC Twelve Wk,Staff,30,10,20,0,0
10388,Wolfson Campus,MKA 1021 - 0002   Fundamentals Of Selling,0002-LEC Main Sess,Staff,40,29,11,0,0
10389,Wolfson Campus,MKA 1021 - 0003   Fundamentals Of Selling,0003-LEC Main Sess,Staff,34,22,12,0,0
8123,North Campus,CCJ 1020 - 0001   Introduction To Criminal Justice,0001-LEC 1st Mon Sp,Staff,30,26,4,0,0
8120,North Campus,CCJ 1020 - 0002   Introduction To Criminal Justice,0002-LEC Twelve Wk,Staff,30,27,3,0,0
8102,North Campus,CCJ 1020 - 0003   Introduction To Criminal Justice,0003-LEC Main Sess,Staff,30,29,1,0,0
8103,North Campus,CCJ 1020 - 0004   Introduction To Criminal Justice,0004-LEC Main Sess,Staff,30,0,30,0,0
8119,North Campus,CCJ 1020 - 0005   Introduction To Criminal Justice,0005-LEC Twelve Wk,Staff,30,0,30,0,0
8111,North Campus,CCJ 1020 - 0006   Introduction To Criminal Justice,0006-LEC Main Sess,Staff,30,13,17,0,0
8112,Kendall Campus,CCJ 1020 - 0007   Introduction To Criminal Justice,0007-LEC Main Sess,Staff,32,31,1,0,0
8113,Kendall Campus,CCJ 1020 - 0008   Introduction To Criminal Justice,0008-LEC Main Sess,Staff,45,31,14,0,0
8114,Kendall Campus,CCJ 1020 - 0009   Introduction To Criminal Justice,0009-LEC Main Sess,Staff,35,33,2,0,0
8115,Wolfson Campus,CCJ 1020 - 0010   Introduction To Criminal Justice,0010-LEC Main Sess,Staff,40,39,1,0,0
8110,Wolfson Campus,CCJ 1020 - 0011   Introduction To Criminal Justice,0011-LEC Main Sess,Staff,40,37,3,0,0
8109,Wolfson Campus,CCJ 1020 - 0012   Introduction To Criminal Justice,0012-LEC Main Sess,Staff,30,27,3,0,0
8108,Wolfson Campus,CCJ 1020 - 0013   Introduction To Criminal Justice,0013-LEC Main Sess,Staff,30,29,1,0,0
8122,Wolfson Campus,CCJ 1020 - 0014   Introduction To Criminal Justice,0014-LEC Conversion,Staff,30,0,30,0,0
8121,Wolfson Campus,CCJ 1020 - 0015   Introduction To Criminal Justice,0015-LEC Conversion,Staff,34,27,7,0,0
8118,Homestead Campus,CCJ 1020 - 0016   Introduction To Criminal Justice,0016-LEC Twelve Wk,Staff,30,28,2,0,0
8107,Homestead Campus,CCJ 1020 - 0017   Introduction To Criminal Justice,0017-LEC Main Sess,Staff,39,33,6,0,0
8106,InterAmerican Campus,CCJ 1020 - 0018   Introduction To Criminal Justice,0018-LEC Main Sess,Staff,30,27,3,0,0
8117,InterAmerican Campus,CCJ 1020 - 0019   Introduction To Criminal Justice,0019-LEC Twelve Wk,Staff,30,14,16,0,0
8105,InterAmerican Campus,CCJ 1020 - 0020   Introduction To Criminal Justice,0020-LEC Main Sess,Staff,30,0,30,0,0
8116,Hialeah Campus,CCJ 1020 - 0021   Introduction To Criminal Justice,0021-LEC Twelve Wk,Staff,25,0,25,0,0
8104,West Campus,CCJ 1020 - 0022   Introduction To Criminal Justice,0022-LEC Main Sess,Staff,30,28,2,0,0
7991,North Campus,CHM 1020 - 0001   General Education Chemistry,0001-LEC Main Sess,Staff,40,0,40,0,0
7990,Kendall Campus,CHM 1020 - 0002   General Education Chemistry,0002-LEC Main Sess,Staff,18,13,5,0,0
12660,North Campus,HUM 1020 - 0001   Humanities,0001-LEC Main Sess,Staff,35,32,3,0,0
12662,North Campus,HUM 1020 - 0003   Humanities,0003-LEC Main Sess,Staff,35,32,3,0,0
12663,North Campus,HUM 1020 - 0004   Humanities,0004-LEC Main Sess,Staff,35,30,5,0,0
12664,North Campus,HUM 1020 - 0005   Humanities,0005-LEC Main Sess,Staff,35,30,5,0,0
12665,North Campus,HUM 1020 - 0006   Humanities,0006-LEC Main Sess,Staff,35,33,2,0,0
12666,North Campus,HUM 1020 - 0007   Humanities,0007-LEC Main Sess,Staff,35,34,1,0,0
12667,North Campus,HUM 1020 - 0008   Humanities,0008-LEC Main Sess,Staff,35,29,6,0,0
12668,North Campus,HUM 1020 - 0009   Humanities,0009-LEC Main Sess,Staff,35,30,5,0,0
12669,North Campus,HUM 1020 - 0010   Humanities,0010-LEC Main Sess,Staff,35,28,7,0,0
12670,North Campus,HUM 1020 - 0011   Humanities,0011-LEC Main Sess,Staff,35,29,6,0,0
12671,North Campus,HUM 1020 - 0012   Humanities,0012-LEC Main Sess,Staff,35,34,1,0,0
12672,North Campus,HUM 1020 - 0013   Humanities,0013-LEC Main Sess,Staff,35,34,1,0,0
12673,North Campus,HUM 1020 - 0014   Humanities,0014-LEC Main Sess,Staff,35,31,4,0,0
12674,North Campus,HUM 1020 - 0015   Humanities,0015-LEC Main Sess,Staff,35,22,13,0,0
12731,North Campus,HUM 1020 - 0016   Humanities,0016-LEC Twelve Wk,Staff,35,0,35,0,0
12737,North Campus,HUM 1020 - 0017   Humanities,0017-LEC Twelve Wk,Staff,35,0,35,0,0
12675,North Campus,HUM 1020 - 0018   Humanities,0018-LEC Main Sess,Staff,30,12,18,0,0
12747,North Campus,HUM 1020 - 0019   Humanities,0019-LEC Conversion,Staff,30,0,30,0,0
12676,Kendall Campus,HUM 1020 - 0020   Humanities,0020-LEC Main Sess,Staff,110,107,3,0,0
12677,Kendall Campus,HUM 1020 - 0021   Humanities,0021-LEC Main Sess,Staff,110,108,2,0,0
12678,Kendall Campus,HUM 1020 - 0022   Humanities,0022-LEC Main Sess,Staff,79,74,5,0,0
12738,Kendall Campus,HUM 1020 - 0023   Humanities,0023-LEC Twelve Wk,Staff,40,36,4,0,0
12679,Kendall Campus,HUM 1020 - 0024   Humanities,0024-LEC Main Sess,Staff,45,44,1,0,0
12680,Kendall Campus,HUM 1020 - 0025   Humanities,0025-LEC Main Sess,Staff,37,36,1,0,0
12681,Kendall Campus,HUM 1020 - 0026   Humanities,0026-LEC Main Sess,Staff,45,14,31,0,0
12739,Kendall Campus,HUM 1020 - 0027   Humanities,0027-LEC Twelve Wk,Staff,50,31,19,0,0
12745,Kendall Campus,HUM 1020 - 0028   Humanities,0028-LEC Eight Wk 2,Staff,35,19,16,0,0
12682,Kendall Campus,HUM 1020 - 0029   Humanities,0029-LEC Main Sess,Staff,109,29,80,0,0
12683,Kendall Campus,HUM 1020 - 0030   Humanities,0030-LEC Main Sess,Staff,110,109,1,0,0
12684,Kendall Campus,HUM 1020 - 0031   Humanities,0031-LEC Main Sess,Staff,37,31,6,0,0
12685,Kendall Campus,HUM 1020 - 0032   Humanities,0032-LEC Main Sess,Staff,109,47,62,0,0
12686,Kendall Campus,HUM 1020 - 0033   Humanities,0033-LEC Main Sess,Staff,109,104,5,0,0
12687,Kendall Campus,HUM 1020 - 0035   Humanities,0035-LEC Main Sess,Staff,30,26,4,0,0
12688,Kendall Campus,HUM 1020 - 0036   Humanities,0036-LEC Main Sess,Staff,1,0,1,0,0
12689,Wolfson Campus,HUM 1020 - 0037   Humanities,0037-LEC Main Sess,Staff,47,33,14,0,0
12690,Wolfson Campus,HUM 1020 - 0038   Humanities,0038-LEC Main Sess,Staff,50,22,28,0,0
12691,Wolfson Campus,HUM 1020 - 0039   Humanities,0039-LEC Main Sess,Staff,50,49,1,0,0
12692,Wolfson Campus,HUM 1020 - 0040   Humanities,0040-LEC Main Sess,Staff,50,49,1,0,0
12693,Wolfson Campus,HUM 1020 - 0041   Humanities,0041-LEC Main Sess,Staff,50,0,50,0,0
12741,Wolfson Campus,HUM 1020 - 0042   Humanities,0042-LEC Twelve Wk,Staff,45,41,4,0,0
12694,Wolfson Campus,HUM 1020 - 0043   Humanities,0043-LEC Main Sess,Staff,50,41,9,0,0
12695,Wolfson Campus,HUM 1020 - 0044   Humanities,0044-LEC Main Sess,Staff,50,48,2,0,0
12735,Wolfson Campus,HUM 1020 - 0046   Humanities,0046-LEC Twelve Wk,Staff,50,36,14,0,0
12696,Wolfson Campus,HUM 1020 - 0047   Humanities,0047-LEC Main Sess,Staff,47,30,17,0,0
12697,Wolfson Campus,HUM 1020 - 0048   Humanities,0048-LEC Main Sess,Staff,50,44,6,0,0
12746,Wolfson Campus,HUM 1020 - 0050   Humanities,0050-LEC Conversion,Staff,38,35,3,0,0
12699,Wolfson Campus,HUM 1020 - 0051   Humanities,0051-LEC Main Sess,Staff,50,0,50,0,0
12701,Wolfson Campus,HUM 1020 - 0053   Humanities,0053-LEC Main Sess,Staff,30,28,2,0,0
12702,Wolfson Campus,HUM 1020 - 0054   Humanities,0054-LEC Main Sess,Staff,30,23,7,0,0
12703,Wolfson Campus,HUM 1020 - 0055   Humanities,0055-LEC Main Sess,Staff,30,22,8,0,0
12704,Wolfson Campus,HUM 1020 - 0056   Humanities,0056-LEC Main Sess,Staff,30,21,9,0,0
12705,Wolfson Campus,HUM 1020 - 0057   Humanities,0057-LEC Main Sess,Staff,30,28,2,0,0
12706,Wolfson Campus,HUM 1020 - 0058   Humanities,0058-LEC Main Sess,Staff,30,24,6,0,0
12707,Wolfson Campus,HUM 1020 - 0059   Humanities,0059-LEC Main Sess,Staff,30,25,5,0,0
12708,Wolfson Campus,HUM 1020 - 0060   Humanities,0060-LEC Main Sess,Staff,30,23,7,0,0
12709,Wolfson Campus,HUM 1020 - 0061   Humanities,0061-LEC Main Sess,Staff,30,25,5,0,0
12710,Wolfson Campus,HUM 1020 - 0062   Humanities,0062-LEC Main Sess,Staff,30,23,7,0,0
12711,Wolfson Campus,HUM 1020 - 0063   Humanities,0063-LEC Main Sess,Staff,30,26,4,0,0
12712,Wolfson Campus,HUM 1020 - 0064   Humanities,0064-LEC Main Sess,Staff,30,25,5,0,0
12748,Homestead Campus,HUM 1020 - 0065   Humanities,0065-LEC Conversion,Staff,30,21,9,0,0
12750,Homestead Campus,HUM 1020 - 0066   Humanities,0066-LEC Weekend,Staff,30,0,30,0,0
12713,InterAmerican Campus,HUM 1020 - 0067   Humanities,0067-LEC Main Sess,Staff,35,28,7,0,0
12714,InterAmerican Campus,HUM 1020 - 0068   Humanities,0068-LEC Main Sess,Staff,30,25,5,0,0
12715,InterAmerican Campus,HUM 1020 - 0069   Humanities,0069-LEC Main Sess,Staff,35,28,7,0,0
12742,InterAmerican Campus,HUM 1020 - 0070   Humanities,0070-LEC Eight Wk 1,Staff,35,18,17,0,0
12743,InterAmerican Campus,HUM 1020 - 0071   Humanities,0071-LEC Eight Wk 2,Staff,25,0,25,0,0
12744,InterAmerican Campus,HUM 1020 - 0072   Humanities,0072-LEC Eight Wk 2,Staff,35,0,35,0,0
12716,InterAmerican Campus,HUM 1020 - 0073   Humanities,0073-LEC Main Sess,Staff,35,29,6,0,0
12717,InterAmerican Campus,HUM 1020 - 0074   Humanities,0074-LEC Main Sess,Staff,35,14,21,0,0
12734,Hialeah Campus,HUM 1020 - 0075   Humanities,0075-LEC Twelve Wk,Staff,33,28,5,0,0
12719,Hialeah Campus,HUM 1020 - 0077   Humanities,0077-LEC Main Sess,Staff,33,32,1,0,0
12720,Hialeah Campus,HUM 1020 - 0078   Humanities,0078-LEC Main Sess,Staff,25,22,3,0,0
12721,Hialeah Campus,HUM 1020 - 0079   Humanities,0079-LEC Main Sess,Staff,33,24,9,0,0
12722,Hialeah Campus,HUM 1020 - 0080   Humanities,0080-LEC Main Sess,Staff,33,32,1,0,0
12723,Hialeah Campus,HUM 1020 - 0081   Humanities,0081-LEC Main Sess,Staff,33,32,1,0,0
12725,West Campus,HUM 1020 - 0083   Humanities,0083-LEC Main Sess,Staff,35,29,6,0,0
12733,West Campus,HUM 1020 - 0084   Humanities,0084-LEC Twelve Wk,Staff,35,22,13,0,0
12749,West Campus,HUM 1020 - 0085   Humanities,0085-LEC Conversion,Staff,35,33,2,0,0
12726,West Campus,HUM 1020 - 0086   Humanities,0086-LEC Main Sess,Staff,35,10,25,0,0
12728,West Campus,HUM 1020 - 0088   Humanities,0088-LEC Main Sess,Staff,35,9,26,0,0
12732,West Campus,HUM 1020 - 0090   Humanities,0090-LEC Twelve Wk,Staff,35,0,35,0,0
12730,West Campus,HUM 1020 - 0091   Humanities,0091-LEC Main Sess,Staff,35,12,23,0,0
16459,North Campus,PHY 1020 - 0001   General Education Physics,0001-LEC Main Sess,Staff,40,7,33,0,0
16458,Kendall Campus,PHY 1020 - 0002   General Education Physics,0002-LEC Main Sess,Staff,30,0,30,0,0
8349,Kendall Campus,CHM 1020L - 0001   General Education Chemistry Laboratory,0001-LAB Main Sess,Staff,18,13,5,0,0
16764,Kendall Campus,MVJ 1019 - 0001   Pre-Applied Jazz Percussion,0001-LEC Main Sess,Staff,15,4,11,0,0
16766,Kendall Campus,MVJ 1019 - 0002   Pre-Applied Jazz Percussion,0002-LEC Main Sess,Staff,15,1,14,0,0
11508,Kendall Campus,MVJ 1018 - 0001   Pre-Applied Jazz Trombone,0001-LEC Main Sess,Staff,15,0,15,0,0
11507,Wolfson Campus,MVJ 1018 - 0002   Pre-Applied Jazz Trombone,0002-LEC Main Sess,Staff,1,0,1,0,0
12975,Wolfson Campus,MVJ 1017 - 0001   Pre-Applied Jazz Trumpet,0001-LEC Main Sess,Staff,1,0,1,0,0
16955,North Campus,SPC 1017 - 0001   Fundamentals Of Speech Communication,0001-LEC Main Sess,Staff,28,27,1,0,0
16956,North Campus,SPC 1017 - 0002   Fundamentals Of Speech Communication,0002-LEC Main Sess,Staff,2,0,2,0,0
16957,North Campus,SPC 1017 - 0003   Fundamentals Of Speech Communication,0003-LEC Main Sess,Staff,28,27,1,0,0
16959,North Campus,SPC 1017 - 0005   Fundamentals Of Speech Communication,0005-LEC Main Sess,Staff,28,26,2,0,0
16960,North Campus,SPC 1017 - 0006   Fundamentals Of Speech Communication,0006-LEC Main Sess,Staff,28,26,2,0,0
16961,North Campus,SPC 1017 - 0007   Fundamentals Of Speech Communication,0007-LEC Main Sess,Staff,28,25,3,0,0
16962,North Campus,SPC 1017 - 0008   Fundamentals Of Speech Communication,0008-LEC Main Sess,Staff,28,18,10,0,0
16963,North Campus,SPC 1017 - 0009   Fundamentals Of Speech Communication,0009-LEC Main Sess,Staff,28,26,2,0,0
16965,North Campus,SPC 1017 - 0011   Fundamentals Of Speech Communication,0011-LEC Main Sess,Staff,28,27,1,0,0
17197,North Campus,SPC 1017 - 0012   Fundamentals Of Speech Communication,0012-LEC Twelve Wk,Staff,28,0,28,0,0
17224,North Campus,SPC 1017 - 0013   Fundamentals Of Speech Communication,0013-LEC Weekend,Staff,28,0,28,0,0
16966,North Campus,SPC 1017 - 0014   Fundamentals Of Speech Communication,0014-LEC Main Sess,Staff,28,20,8,0,0
16968,North Campus,SPC 1017 - 0016   Fundamentals Of Speech Communication,0016-LEC Main Sess,Staff,2,0,2,0,0
16969,North Campus,SPC 1017 - 0017   Fundamentals Of Speech Communication,0017-LEC Main Sess,Staff,28,23,5,0,0
16971,North Campus,SPC 1017 - 0019   Fundamentals Of Speech Communication,0019-LEC Main Sess,Staff,4,0,4,0,0
16972,North Campus,SPC 1017 - 0020   Fundamentals Of Speech Communication,0020-LEC Main Sess,Staff,28,23,5,0,0
16973,North Campus,SPC 1017 - 0021   Fundamentals Of Speech Communication,0021-LEC Main Sess,Staff,28,0,28,0,0
16974,North Campus,SPC 1017 - 0022   Fundamentals Of Speech Communication,0022-LEC Main Sess,Staff,28,26,2,0,0
16975,North Campus,SPC 1017 - 0023   Fundamentals Of Speech Communication,0023-LEC Main Sess,Staff,28,0,28,0,0
16976,North Campus,SPC 1017 - 0024   Fundamentals Of Speech Communication,0024-LEC Main Sess,Staff,28,17,11,0,0
16977,North Campus,SPC 1017 - 0025   Fundamentals Of Speech Communication,0025-LEC Main Sess,Staff,22,18,4,0,0
17196,North Campus,SPC 1017 - 0026   Fundamentals Of Speech Communication,0026-LEC Twelve Wk,Staff,28,0,28,0,0
17195,North Campus,SPC 1017 - 0027   Fundamentals Of Speech Communication,0027-LEC Twelve Wk,Staff,2,0,2,0,0
17194,North Campus,SPC 1017 - 0028   Fundamentals Of Speech Communication,0028-LEC Twelve Wk,Staff,28,27,1,0,0
16978,North Campus,SPC 1017 - 0029   Fundamentals Of Speech Communication,0029-LEC Main Sess,Staff,28,25,3,0,0
16981,North Campus,SPC 1017 - 0032   Fundamentals Of Speech Communication,0032-LEC Main Sess,Staff,28,25,3,0,0
16983,North Campus,SPC 1017 - 0034   Fundamentals Of Speech Communication,0034-LEC Main Sess,Staff,28,26,2,0,0
16984,North Campus,SPC 1017 - 0035   Fundamentals Of Speech Communication,0035-LEC Main Sess,Staff,28,25,3,0,0
16985,North Campus,SPC 1017 - 0036   Fundamentals Of Speech Communication,0036-LEC Main Sess,Staff,25,22,3,0,0
16986,North Campus,SPC 1017 - 0037   Fundamentals Of Speech Communication,0037-LEC Main Sess,Staff,27,26,1,0,0
16988,North Campus,SPC 1017 - 0039   Fundamentals Of Speech Communication,0039-LEC Main Sess,Staff,28,0,28,0,0
16989,North Campus,SPC 1017 - 0040   Fundamentals Of Speech Communication,0040-LEC Main Sess,Staff,26,0,26,0,0
17225,North Campus,SPC 1017 - 0041   Fundamentals Of Speech Communication,0041-LEC Weekend,Staff,28,24,4,0,0
16990,North Campus,SPC 1017 - 0042   Fundamentals Of Speech Communication,0042-LEC Main Sess,Staff,28,19,9,0,0
16991,North Campus,SPC 1017 - 0043   Fundamentals Of Speech Communication,0043-LEC Main Sess,Staff,28,26,2,0,0
16992,North Campus,SPC 1017 - 0044   Fundamentals Of Speech Communication,0044-LEC Main Sess,Staff,28,24,4,0,0
16993,North Campus,SPC 1017 - 0045   Fundamentals Of Speech Communication,0045-LEC Main Sess,Staff,28,0,28,0,0
16994,North Campus,SPC 1017 - 0046   Fundamentals Of Speech Communication,0046-LEC Main Sess,Staff,27,0,27,0,0
16996,North Campus,SPC 1017 - 0048   Fundamentals Of Speech Communication,0048-LEC Main Sess,Staff,28,26,2,0,0
17188,North Campus,SPC 1017 - 0049   Fundamentals Of Speech Communication,0049-LEC Twelve Wk,Staff,28,27,1,0,0
17192,North Campus,SPC 1017 - 0050   Fundamentals Of Speech Communication,0050-LEC Twelve Wk,Staff,25,21,4,0,0
17208,North Campus,SPC 1017 - 0051   Fundamentals Of Speech Communication,0051-LEC Conversion,Staff,30,0,30,0,0
17191,North Campus,SPC 1017 - 0052   Fundamentals Of Speech Communication,0052-LEC Twelve Wk,Staff,28,0,28,0,0
16997,North Campus,SPC 1017 - 0053   Fundamentals Of Speech Communication,0053-LEC Main Sess,Staff,26,20,6,0,0
16998,North Campus,SPC 1017 - 0054   Fundamentals Of Speech Communication,0054-LEC Main Sess,Staff,28,0,28,0,0
17190,North Campus,SPC 1017 - 0055   Fundamentals Of Speech Communication,0055-LEC Twelve Wk,Staff,28,24,4,0,0
16999,North Campus,SPC 1017 - 0056   Fundamentals Of Speech Communication,0056-LEC Main Sess,Staff,28,0,28,0,0
17222,North Campus,SPC 1017 - 0057   Fundamentals Of Speech Communication,0057-LEC 1st Mon Sp,Staff,28,21,7,0,0
17000,North Campus,SPC 1017 - 0058   Fundamentals Of Speech Communication,0058-LEC Main Sess,Staff,28,22,6,0,0
17001,North Campus,SPC 1017 - 0059   Fundamentals Of Speech Communication,0059-LEC Main Sess,Staff,28,10,18,0,0
17002,North Campus,SPC 1017 - 0060   Fundamentals Of Speech Communication,0060-LEC Main Sess,Staff,25,0,25,0,0
17003,Kendall Campus,SPC 1017 - 0061   Fundamentals Of Speech Communication,0061-LEC Main Sess,Staff,30,27,3,0,0
17004,Kendall Campus,SPC 1017 - 0062   Fundamentals Of Speech Communication,0062-LEC Main Sess,Staff,30,25,5,0,0
17005,Kendall Campus,SPC 1017 - 0063   Fundamentals Of Speech Communication,0063-LEC Main Sess,Staff,30,26,4,0,0
17006,Kendall Campus,SPC 1017 - 0064   Fundamentals Of Speech Communication,0064-LEC Main Sess,Staff,30,28,2,0,0
17007,Kendall Campus,SPC 1017 - 0065   Fundamentals Of Speech Communication,0065-LEC Main Sess,Staff,1,0,1,0,0
17009,Kendall Campus,SPC 1017 - 0067   Fundamentals Of Speech Communication,0067-LEC Main Sess,Staff,30,28,2,0,0
17010,Kendall Campus,SPC 1017 - 0068   Fundamentals Of Speech Communication,0068-LEC Main Sess,Staff,30,25,5,0,0
17011,Kendall Campus,SPC 1017 - 0069   Fundamentals Of Speech Communication,0069-LEC Main Sess,Staff,1,0,1,0,0
17012,Kendall Campus,SPC 1017 - 0070   Fundamentals Of Speech Communication,0070-LEC Main Sess,Staff,1,0,1,0,0
17013,Kendall Campus,SPC 1017 - 0071   Fundamentals Of Speech Communication,0071-LEC Main Sess,Staff,30,28,2,0,0
17015,Kendall Campus,SPC 1017 - 0073   Fundamentals Of Speech Communication,0073-LEC Main Sess,Staff,30,27,3,0,0
17019,Kendall Campus,SPC 1017 - 0077   Fundamentals Of Speech Communication,0077-LEC Main Sess,Staff,30,27,3,0,0
17020,Kendall Campus,SPC 1017 - 0078   Fundamentals Of Speech Communication,0078-LEC Main Sess,Staff,30,28,2,0,0
17021,Kendall Campus,SPC 1017 - 0079   Fundamentals Of Speech Communication,0079-LEC Main Sess,Staff,30,29,1,0,0
17022,Kendall Campus,SPC 1017 - 0080   Fundamentals Of Speech Communication,0080-LEC Main Sess,Staff,30,29,1,0,0
17023,Kendall Campus,SPC 1017 - 0082   Fundamentals Of Speech Communication,0082-LEC Main Sess,Staff,3,0,3,0,0
17024,Kendall Campus,SPC 1017 - 0083   Fundamentals Of Speech Communication,0083-LEC Main Sess,Staff,25,22,3,0,0
17026,Kendall Campus,SPC 1017 - 0085   Fundamentals Of Speech Communication,0085-LEC Main Sess,Staff,30,25,5,0,0
17027,Kendall Campus,SPC 1017 - 0086   Fundamentals Of Speech Communication,0086-LEC Main Sess,Staff,30,29,1,0,0
17029,Kendall Campus,SPC 1017 - 0088   Fundamentals Of Speech Communication,0088-LEC Main Sess,Staff,30,25,5,0,0
17031,Kendall Campus,SPC 1017 - 0090   Fundamentals Of Speech Communication,0090-LEC Main Sess,Staff,30,28,2,0,0
17032,Kendall Campus,SPC 1017 - 0091   Fundamentals Of Speech Communication,0091-LEC Main Sess,Staff,30,27,3,0,0
17033,Kendall Campus,SPC 1017 - 0092   Fundamentals Of Speech Communication,0092-LEC Main Sess,Staff,30,28,2,0,0
17034,Kendall Campus,SPC 1017 - 0093   Fundamentals Of Speech Communication,0093-LEC Main Sess,Staff,28,24,4,0,0
17036,Kendall Campus,SPC 1017 - 0095   Fundamentals Of Speech Communication,0095-LEC Main Sess,Staff,30,27,3,0,0
17038,Kendall Campus,SPC 1017 - 0097   Fundamentals Of Speech Communication,0097-LEC Main Sess,Staff,1,0,1,0,0
17039,Kendall Campus,SPC 1017 - 0098   Fundamentals Of Speech Communication,0098-LEC Main Sess,Staff,1,0,1,0,0
17040,Kendall Campus,SPC 1017 - 0099   Fundamentals Of Speech Communication,0099-LEC Main Sess,Staff,25,22,3,0,0
17041,Kendall Campus,SPC 1017 - 0100   Fundamentals Of Speech Communication,0100-LEC Main Sess,Staff,1,0,1,0,0
17042,Kendall Campus,SPC 1017 - 0101   Fundamentals Of Speech Communication,0101-LEC Main Sess,Staff,1,0,1,0,0
17043,Kendall Campus,SPC 1017 - 0102   Fundamentals Of Speech Communication,0102-LEC Main Sess,Staff,28,26,2,0,0
17044,Kendall Campus,SPC 1017 - 0103   Fundamentals Of Speech Communication,0103-LEC Main Sess,Staff,25,24,1,0,0
17045,Kendall Campus,SPC 1017 - 0104   Fundamentals Of Speech Communication,0104-LEC Main Sess,Staff,30,25,5,0,0
17046,Kendall Campus,SPC 1017 - 0105   Fundamentals Of Speech Communication,0105-LEC Main Sess,Staff,30,28,2,0,0
17047,Kendall Campus,SPC 1017 - 0106   Fundamentals Of Speech Communication,0106-LEC Main Sess,Staff,30,27,3,0,0
17048,Kendall Campus,SPC 1017 - 0107   Fundamentals Of Speech Communication,0107-LEC Main Sess,Staff,30,27,3,0,0
17049,Kendall Campus,SPC 1017 - 0108   Fundamentals Of Speech Communication,0108-LEC Main Sess,Staff,30,27,3,0,0
17050,Kendall Campus,SPC 1017 - 0109   Fundamentals Of Speech Communication,0109-LEC Main Sess,Staff,30,28,2,0,0
17051,Kendall Campus,SPC 1017 - 0110   Fundamentals Of Speech Communication,0110-LEC Main Sess,Staff,1,0,1,0,0
17053,Kendall Campus,SPC 1017 - 0112   Fundamentals Of Speech Communication,0112-LEC Main Sess,Staff,1,0,1,0,0
17054,Kendall Campus,SPC 1017 - 0113   Fundamentals Of Speech Communication,0113-LEC Main Sess,Staff,30,28,2,0,0
17209,Kendall Campus,SPC 1017 - 0114   Fundamentals Of Speech Communication,0114-LEC Conversion,Staff,30,27,3,0,0
17055,Kendall Campus,SPC 1017 - 0115   Fundamentals Of Speech Communication,0115-LEC Main Sess,Staff,30,25,5,0,0
17056,Kendall Campus,SPC 1017 - 0116   Fundamentals Of Speech Communication,0116-LEC Main Sess,Staff,30,28,2,0,0
17057,Kendall Campus,SPC 1017 - 0117   Fundamentals Of Speech Communication,0117-LEC Main Sess,Staff,30,25,5,0,0
17058,Kendall Campus,SPC 1017 - 0118   Fundamentals Of Speech Communication,0118-LEC Main Sess,Staff,30,27,3,0,0
17060,Kendall Campus,SPC 1017 - 0120   Fundamentals Of Speech Communication,0120-LEC Main Sess,Staff,30,26,4,0,0
17062,Kendall Campus,SPC 1017 - 0122   Fundamentals Of Speech Communication,0122-LEC Main Sess,Staff,30,26,4,0,0
17063,Kendall Campus,SPC 1017 - 0123   Fundamentals Of Speech Communication,0123-LEC Main Sess,Staff,30,26,4,0,0
17064,Kendall Campus,SPC 1017 - 0124   Fundamentals Of Speech Communication,0124-LEC Main Sess,Staff,30,28,2,0,0
17065,Kendall Campus,SPC 1017 - 0125   Fundamentals Of Speech Communication,0125-LEC Main Sess,Staff,30,28,2,0,0
17066,Kendall Campus,SPC 1017 - 0126   Fundamentals Of Speech Communication,0126-LEC Main Sess,Staff,30,27,3,0,0
17067,Kendall Campus,SPC 1017 - 0127   Fundamentals Of Speech Communication,0127-LEC Main Sess,Staff,30,29,1,0,0
17068,Kendall Campus,SPC 1017 - 0128   Fundamentals Of Speech Communication,0128-LEC Main Sess,Staff,1,0,1,0,0
17069,Kendall Campus,SPC 1017 - 0129   Fundamentals Of Speech Communication,0129-LEC Main Sess,Staff,30,28,2,0,0
17070,Kendall Campus,SPC 1017 - 0130   Fundamentals Of Speech Communication,0130-LEC Main Sess,Staff,30,27,3,0,0
17231,Kendall Campus,SPC 1017 - 0131   Fundamentals Of Speech Communication,0131-LEC Weekend,Staff,30,29,1,0,0
17189,Kendall Campus,SPC 1017 - 0133   Fundamentals Of Speech Communication,0133-LEC Twelve Wk,Staff,1,0,1,0,0
17071,Kendall Campus,SPC 1017 - 0134   Fundamentals Of Speech Communication,0134-LEC Main Sess,Staff,30,27,3,0,0
17072,Wolfson Campus,SPC 1017 - 0135   Fundamentals Of Speech Communication,0135-LEC Main Sess,Staff,28,25,3,0,0
17073,Wolfson Campus,SPC 1017 - 0136   Fundamentals Of Speech Communication,0136-LEC Main Sess,Staff,28,27,1,0,0
17074,Wolfson Campus,SPC 1017 - 0137   Fundamentals Of Speech Communication,0137-LEC Main Sess,Staff,28,26,2,0,0
17075,Wolfson Campus,SPC 1017 - 0138   Fundamentals Of Speech Communication,0138-LEC Main Sess,Staff,30,26,4,0,0
17076,Wolfson Campus,SPC 1017 - 0139   Fundamentals Of Speech Communication,0139-LEC Main Sess,Staff,28,25,3,0,0
17079,Wolfson Campus,SPC 1017 - 0142   Fundamentals Of Speech Communication,0142-LEC Main Sess,Staff,25,22,3,0,0
17080,Wolfson Campus,SPC 1017 - 0143   Fundamentals Of Speech Communication,0143-LEC Main Sess,Staff,28,23,5,0,0
17193,Wolfson Campus,SPC 1017 - 0144   Fundamentals Of Speech Communication,0144-LEC Twelve Wk,Staff,28,24,4,0,0
17200,Wolfson Campus,SPC 1017 - 0145   Fundamentals Of Speech Communication,0145-LEC Eight Wk 2,Staff,28,26,2,0,0
17221,Wolfson Campus,SPC 1017 - 0146   Fundamentals Of Speech Communication,0146-LEC 1st Mon Sp,Staff,28,27,1,0,0
17199,Wolfson Campus,SPC 1017 - 0147   Fundamentals Of Speech Communication,0147-LEC Eight Wk 2,Staff,30,0,30,0,0
17081,Wolfson Campus,SPC 1017 - 0148   Fundamentals Of Speech Communication,0148-LEC Main Sess,Staff,28,25,3,0,0
17085,Wolfson Campus,SPC 1017 - 0152   Fundamentals Of Speech Communication,0152-LEC Main Sess,Staff,7,0,7,0,0
17086,Wolfson Campus,SPC 1017 - 0153   Fundamentals Of Speech Communication,0153-LEC Main Sess,Staff,30,29,1,0,0
17087,Wolfson Campus,SPC 1017 - 0154   Fundamentals Of Speech Communication,0154-LEC Main Sess,Staff,28,21,7,0,0
17229,Wolfson Campus,SPC 1017 - 0156   Fundamentals Of Speech Communication,0156-LEC Weekend,Staff,30,28,2,0,0
17089,Wolfson Campus,SPC 1017 - 0157   Fundamentals Of Speech Communication,0157-LEC Main Sess,Staff,28,23,5,0,0
17090,Wolfson Campus,SPC 1017 - 0158   Fundamentals Of Speech Communication,0158-LEC Main Sess,Staff,17,0,17,0,0
17091,Wolfson Campus,SPC 1017 - 0159   Fundamentals Of Speech Communication,0159-LEC Main Sess,Staff,30,29,1,0,0
17093,Wolfson Campus,SPC 1017 - 0161   Fundamentals Of Speech Communication,0161-LEC Main Sess,Staff,30,22,8,0,0
17094,Wolfson Campus,SPC 1017 - 0162   Fundamentals Of Speech Communication,0162-LEC Main Sess,Staff,30,27,3,0,0
17230,Wolfson Campus,SPC 1017 - 0165   Fundamentals Of Speech Communication,0165-LEC Weekend,Staff,30,28,2,0,0
17101,Wolfson Campus,SPC 1017 - 0170   Fundamentals Of Speech Communication,0170-LEC Main Sess,Staff,30,28,2,0,0
17102,Wolfson Campus,SPC 1017 - 0171   Fundamentals Of Speech Communication,0171-LEC Main Sess,Staff,30,26,4,0,0
17103,Wolfson Campus,SPC 1017 - 0172   Fundamentals Of Speech Communication,0172-LEC Main Sess,Staff,28,27,1,0,0
17104,Wolfson Campus,SPC 1017 - 0173   Fundamentals Of Speech Communication,0173-LEC Main Sess,Staff,30,28,2,0,0
17105,Wolfson Campus,SPC 1017 - 0174   Fundamentals Of Speech Communication,0174-LEC Main Sess,Staff,25,23,2,0,0
17202,Wolfson Campus,SPC 1017 - 0176   Fundamentals Of Speech Communication,0176-LEC Eight Wk 2,Staff,28,25,3,0,0
17107,Wolfson Campus,SPC 1017 - 0178   Fundamentals Of Speech Communication,0178-LEC Main Sess,Staff,30,24,6,0,0
17108,Wolfson Campus,SPC 1017 - 0179   Fundamentals Of Speech Communication,0179-LEC Main Sess,Staff,30,24,6,0,0
17109,Wolfson Campus,SPC 1017 - 0180   Fundamentals Of Speech Communication,0180-LEC Main Sess,Staff,34,30,4,0,0
17110,Wolfson Campus,SPC 1017 - 0181   Fundamentals Of Speech Communication,0181-LEC Main Sess,Staff,34,28,6,0,0
17111,Wolfson Campus,SPC 1017 - 0183   Fundamentals Of Speech Communication,0183-LEC Main Sess,Staff,30,26,4,0,0
17112,Wolfson Campus,SPC 1017 - 0184   Fundamentals Of Speech Communication,0184-LEC Main Sess,Staff,30,28,2,0,0
17113,Wolfson Campus,SPC 1017 - 0185   Fundamentals Of Speech Communication,0185-LEC Main Sess,Staff,30,27,3,0,0
17115,Wolfson Campus,SPC 1017 - 0187   Fundamentals Of Speech Communication,0187-LEC Main Sess,Staff,34,27,7,0,0
17116,Wolfson Campus,SPC 1017 - 0188   Fundamentals Of Speech Communication,0188-LEC Main Sess,Staff,30,29,1,0,0
17117,Wolfson Campus,SPC 1017 - 0189   Fundamentals Of Speech Communication,0189-LEC Main Sess,Staff,30,26,4,0,0
17118,Wolfson Campus,SPC 1017 - 0190   Fundamentals Of Speech Communication,0190-LEC Main Sess,Staff,34,28,6,0,0
17119,Wolfson Campus,SPC 1017 - 0191   Fundamentals Of Speech Communication,0191-LEC Main Sess,Staff,34,24,10,0,0
17120,Wolfson Campus,SPC 1017 - 0192   Fundamentals Of Speech Communication,0192-LEC Main Sess,Staff,34,30,4,0,0
17121,Wolfson Campus,SPC 1017 - 0193   Fundamentals Of Speech Communication,0193-LEC Main Sess,Staff,34,31,3,0,0
17122,Wolfson Campus,SPC 1017 - 0194   Fundamentals Of Speech Communication,0194-LEC Main Sess,Staff,34,29,5,0,0
17211,Wolfson Campus,SPC 1017 - 0195   Fundamentals Of Speech Communication,0195-LEC Conversion,Staff,34,33,1,0,0
17210,Wolfson Campus,SPC 1017 - 0196   Fundamentals Of Speech Communication,0196-LEC Conversion,Staff,34,31,3,0,0
17123,Wolfson Campus,SPC 1017 - 0197   Fundamentals Of Speech Communication,0197-LEC Main Sess,Staff,30,26,4,0,0
17124,Wolfson Campus,SPC 1017 - 0198   Fundamentals Of Speech Communication,0198-LEC Main Sess,Staff,30,29,1,0,0
17125,Wolfson Campus,SPC 1017 - 0199   Fundamentals Of Speech Communication,0199-LEC Main Sess,Staff,34,28,6,0,0
17126,Wolfson Campus,SPC 1017 - 0200   Fundamentals Of Speech Communication,0200-LEC Main Sess,Staff,30,29,1,0,0
17127,Wolfson Campus,SPC 1017 - 0201   Fundamentals Of Speech Communication,0201-LEC Main Sess,Staff,34,27,7,0,0
17128,Wolfson Campus,SPC 1017 - 0202   Fundamentals Of Speech Communication,0202-LEC Main Sess,Staff,34,26,8,0,0
17129,Wolfson Campus,SPC 1017 - 0203   Fundamentals Of Speech Communication,0203-LEC Main Sess,Staff,34,31,3,0,0
17130,Homestead Campus,SPC 1017 - 0204   Fundamentals Of Speech Communication,0204-LEC Main Sess,Staff,25,0,25,0,0
17131,Homestead Campus,SPC 1017 - 0205   Fundamentals Of Speech Communication,0205-LEC Main Sess,Staff,25,23,2,0,0
17132,Homestead Campus,SPC 1017 - 0206   Fundamentals Of Speech Communication,0206-LEC Main Sess,Staff,25,0,25,0,0
17134,Homestead Campus,SPC 1017 - 0208   Fundamentals Of Speech Communication,0208-LEC Main Sess,Staff,25,22,3,0,0
17137,Homestead Campus,SPC 1017 - 0211   Fundamentals Of Speech Communication,0211-LEC Main Sess,Staff,25,24,1,0,0
17139,Homestead Campus,SPC 1017 - 0213   Fundamentals Of Speech Communication,0213-LEC Main Sess,Staff,25,22,3,0,0
17140,Homestead Campus,SPC 1017 - 0214   Fundamentals Of Speech Communication,0214-LEC Main Sess,Staff,25,18,7,0,0
17141,Homestead Campus,SPC 1017 - 0215   Fundamentals Of Speech Communication,0215-LEC Main Sess,Staff,25,23,2,0,0
17207,Homestead Campus,SPC 1017 - 0216   Fundamentals Of Speech Communication,0216-LEC Eight Wk 2,Staff,25,22,3,0,0
17142,Homestead Campus,SPC 1017 - 0217   Fundamentals Of Speech Communication,0217-LEC Main Sess,Staff,25,23,2,0,0
17143,InterAmerican Campus,SPC 1017 - 0218   Fundamentals Of Speech Communication,0218-LEC Main Sess,Staff,29,0,29,0,0
17144,InterAmerican Campus,SPC 1017 - 0219   Fundamentals Of Speech Communication,0219-LEC Main Sess,Staff,29,17,12,0,0
17145,InterAmerican Campus,SPC 1017 - 0220   Fundamentals Of Speech Communication,0220-LEC Main Sess,Staff,29,23,6,0,0
17204,InterAmerican Campus,SPC 1017 - 0221   Fundamentals Of Speech Communication,0221-LEC Eight Wk 2,Staff,29,0,29,0,0
17205,InterAmerican Campus,SPC 1017 - 0223   Fundamentals Of Speech Communication,0223-LEC Eight Wk 2,Staff,29,27,2,0,0
17146,InterAmerican Campus,SPC 1017 - 0224   Fundamentals Of Speech Communication,0224-LEC Main Sess,Staff,29,25,4,0,0
17147,InterAmerican Campus,SPC 1017 - 0225   Fundamentals Of Speech Communication,0225-LEC Main Sess,Staff,29,26,3,0,0
17213,InterAmerican Campus,SPC 1017 - 0226   Fundamentals Of Speech Communication,0226-LEC Conversion,Staff,29,24,5,0,0
17206,InterAmerican Campus,SPC 1017 - 0227   Fundamentals Of Speech Communication,0227-LEC Eight Wk 2,Staff,29,0,29,0,0
17148,InterAmerican Campus,SPC 1017 - 0228   Fundamentals Of Speech Communication,0228-LEC Main Sess,Staff,29,26,3,0,0
17149,InterAmerican Campus,SPC 1017 - 0229   Fundamentals Of Speech Communication,0229-LEC Main Sess,Staff,29,25,4,0,0
17203,InterAmerican Campus,SPC 1017 - 0230   Fundamentals Of Speech Communication,0230-LEC Eight Wk 2,Staff,29,0,29,0,0
17150,InterAmerican Campus,SPC 1017 - 0231   Fundamentals Of Speech Communication,0231-LEC Main Sess,Staff,29,27,2,0,0
17219,InterAmerican Campus,SPC 1017 - 0232   Fundamentals Of Speech Communication,0232-LEC 1st Mon Sp,Staff,29,28,1,0,0
17151,InterAmerican Campus,SPC 1017 - 0233   Fundamentals Of Speech Communication,0233-LEC Main Sess,Staff,29,11,18,0,0
17218,InterAmerican Campus,SPC 1017 - 0234   Fundamentals Of Speech Communication,0234-LEC 1st Mon Sp,Staff,29,0,29,0,0
17152,InterAmerican Campus,SPC 1017 - 0235   Fundamentals Of Speech Communication,0235-LEC Main Sess,Staff,29,17,12,0,0
17153,InterAmerican Campus,SPC 1017 - 0236   Fundamentals Of Speech Communication,0236-LEC Main Sess,Staff,29,21,8,0,0
17154,InterAmerican Campus,SPC 1017 - 0237   Fundamentals Of Speech Communication,0237-LEC Main Sess,Staff,29,20,9,0,0
17155,InterAmerican Campus,SPC 1017 - 0238   Fundamentals Of Speech Communication,0238-LEC Main Sess,Staff,29,21,8,0,0
17201,InterAmerican Campus,SPC 1017 - 0239   Fundamentals Of Speech Communication,0239-LEC Eight Wk 2,Staff,29,26,3,0,0
17214,InterAmerican Campus,SPC 1017 - 0240   Fundamentals Of Speech Communication,0240-LEC Conversion,Staff,29,20,9,0,0
17156,Hialeah Campus,SPC 1017 - 0241   Fundamentals Of Speech Communication,0241-LEC Main Sess,Staff,31,30,1,0,0
17157,Hialeah Campus,SPC 1017 - 0242   Fundamentals Of Speech Communication,0242-LEC Main Sess,Staff,31,27,4,0,0
17158,Hialeah Campus,SPC 1017 - 0243   Fundamentals Of Speech Communication,0243-LEC Main Sess,Staff,31,28,3,0,0
17159,Hialeah Campus,SPC 1017 - 0244   Fundamentals Of Speech Communication,0244-LEC Main Sess,Staff,31,30,1,0,0
17186,Hialeah Campus,SPC 1017 - 0245   Fundamentals Of Speech Communication,0245-LEC Main Sess,Staff,31,28,3,0,0
17160,Hialeah Campus,SPC 1017 - 0246   Fundamentals Of Speech Communication,0246-LEC Main Sess,Staff,31,30,1,0,0
17217,Hialeah Campus,SPC 1017 - 0247   Fundamentals Of Speech Communication,0247-LEC 1st Mon Sp,Staff,31,30,1,0,0
17161,Hialeah Campus,SPC 1017 - 0248   Fundamentals Of Speech Communication,0248-LEC Main Sess,Staff,31,16,15,0,0
17162,Hialeah Campus,SPC 1017 - 0249   Fundamentals Of Speech Communication,0249-LEC Main Sess,Staff,31,30,1,0,0
17163,Hialeah Campus,SPC 1017 - 0250   Fundamentals Of Speech Communication,0250-LEC Main Sess,Staff,31,30,1,0,0
17227,Hialeah Campus,SPC 1017 - 0252   Fundamentals Of Speech Communication,0252-LEC Weekend,Staff,30,26,4,0,0
17198,Hialeah Campus,SPC 1017 - 0254   Fundamentals Of Speech Communication,0254-LEC Twelve Wk,Staff,31,30,1,0,0
17166,Hialeah Campus,SPC 1017 - 0256   Fundamentals Of Speech Communication,0256-LEC Main Sess,Staff,30,28,2,0,0
17168,Hialeah Campus,SPC 1017 - 0258   Fundamentals Of Speech Communication,0258-LEC Main Sess,Staff,31,29,2,0,0
17169,Hialeah Campus,SPC 1017 - 0259   Fundamentals Of Speech Communication,0259-LEC Main Sess,Staff,31,30,1,0,0
17170,Hialeah Campus,SPC 1017 - 0260   Fundamentals Of Speech Communication,0260-LEC Main Sess,Staff,31,30,1,0,0
17171,Hialeah Campus,SPC 1017 - 0261   Fundamentals Of Speech Communication,0261-LEC Main Sess,Staff,31,30,1,0,0
17172,West Campus,SPC 1017 - 0262   Fundamentals Of Speech Communication,0262-LEC Main Sess,Staff,30,23,7,0,0
17173,West Campus,SPC 1017 - 0263   Fundamentals Of Speech Communication,0263-LEC Main Sess,Staff,28,0,28,0,0
17174,West Campus,SPC 1017 - 0264   Fundamentals Of Speech Communication,0264-LEC Main Sess,Staff,28,0,28,0,0
17175,West Campus,SPC 1017 - 0265   Fundamentals Of Speech Communication,0265-LEC Main Sess,Staff,30,22,8,0,0
17176,West Campus,SPC 1017 - 0266   Fundamentals Of Speech Communication,0266-LEC Main Sess,Staff,30,14,16,0,0
17177,West Campus,SPC 1017 - 0267   Fundamentals Of Speech Communication,0267-LEC Main Sess,Staff,30,29,1,0,0
17178,West Campus,SPC 1017 - 0268   Fundamentals Of Speech Communication,0268-LEC Main Sess,Staff,30,24,6,0,0
17179,West Campus,SPC 1017 - 0269   Fundamentals Of Speech Communication,0269-LEC Main Sess,Staff,30,25,5,0,0
17180,West Campus,SPC 1017 - 0270   Fundamentals Of Speech Communication,0270-LEC Main Sess,Staff,30,21,9,0,0
17181,West Campus,SPC 1017 - 0271   Fundamentals Of Speech Communication,0271-LEC Main Sess,Staff,30,0,30,0,0
17182,West Campus,SPC 1017 - 0272   Fundamentals Of Speech Communication,0272-LEC Main Sess,Staff,30,15,15,0,0
17215,West Campus,SPC 1017 - 0273   Fundamentals Of Speech Communication,0273-LEC 1st Mon Sp,Staff,30,0,30,0,0
17183,West Campus,SPC 1017 - 0274   Fundamentals Of Speech Communication,0274-LEC Main Sess,Staff,28,0,28,0,0
17184,West Campus,SPC 1017 - 0275   Fundamentals Of Speech Communication,0275-LEC Main Sess,Staff,30,27,3,0,0
17223,West Campus,SPC 1017 - 0276   Fundamentals Of Speech Communication,0276-LEC Weekend,Staff,28,0,28,0,0
17185,West Campus,SPC 1017 - 0277   Fundamentals Of Speech Communication,0277-LEC Main Sess,Staff,30,19,11,0,0
7986,Kendall Campus,MVJ 1016 - 0001   Pre-Applied Jazz Saxophone,0001-LEC Main Sess,Staff,50,2,48,0,0
7985,Wolfson Campus,MVJ 1016 - 0002   Pre-Applied Jazz Saxophone,0002-LEC Main Sess,Staff,1,0,1,0,0
16770,North Campus,MVS 1016 - 0001   Pre-Applied Guitar,0001-LEC Main Sess,Staff,1,0,1,0,0
16773,Kendall Campus,MVS 1016 - 0002   Pre-Applied Guitar,0002-LEC Main Sess,Staff,16,2,14,0,0
16772,Kendall Campus,MVS 1016 - 0003   Pre-Applied Guitar,0003-LEC Main Sess,Staff,10,0,10,0,0
14868,Kendall Campus,MVB 1015 - 0001   Pre-Applied Tuba,0001-LEC Main Sess,Staff,50,1,49,0,0
9045,Kendall Campus,MVJ 1014 - 0001   Pre-Applied Jazz Electric Bass,0001-LEC Main Sess,Staff,50,1,49,0,0
9044,Wolfson Campus,MVJ 1014 - 0002   Pre-Applied Jazz Electric Bass,0002-LEC Main Sess,Staff,1,0,1,0,0
12980,Wolfson Campus,MVS 1014 - 0001   Pre-Applied String Bass,0001-LEC Main Sess,Staff,1,0,1,0,0
9061,Kendall Campus,MVW 1014 - 0001   Pre-Applied Bassoon,0001-LEC Main Sess,Staff,30,0,30,0,0
16763,Kendall Campus,MVB 1013 - 0001   Pre-Applied Trombone,0001-LEC Main Sess,Staff,15,2,13,0,0
16762,Wolfson Campus,MVB 1013 - 0002   Pre-Applied Trombone,0002-LEC Main Sess,Staff,1,0,1,0,0
16392,North Campus,MVJ 1013 - 0001   Pre-Applied Jazz Guitar,0001-LEC Main Sess,Staff,1,0,1,0,0
16393,Kendall Campus,MVJ 1013 - 0002   Pre-Applied Jazz Guitar,0002-LEC Main Sess,Staff,50,7,43,0,0
16396,Kendall Campus,MVJ 1013 - 0003   Pre-Applied Jazz Guitar,0003-LEC Main Sess,Staff,16,5,11,0,0
16395,Kendall Campus,MVJ 1013 - 0004   Pre-Applied Jazz Guitar,0004-LEC Main Sess,Staff,20,8,12,0,0
8054,Kendall Campus,MVS 1013 - 0001   Pre-Applied Cello,0001-LEC Main Sess,Staff,30,2,28,0,0
16428,Kendall Campus,MVW 1013 - 0001   Pre-Applied Clarinet,0001-LEC Main Sess,Staff,50,1,49,0,0
16427,Wolfson Campus,MVW 1013 - 0002   Pre-Applied Clarinet,0002-LEC Main Sess,Staff,1,0,1,0,0
8922,Medical Campus,HUN 1012 - 0001   Nutritional Counseling,0001-LEC Main Sess,Staff,50,0,50,0,0
8923,Medical Campus,HUN 1012 - 0002   Nutritional Counseling,0002-LEC Conversion,Staff,1,0,1,0,0
12307,Kendall Campus,MVW 1012 - 0001   Pre-Applied Oboe,0001-LEC Main Sess,Staff,30,0,30,0,0
12306,Kendall Campus,MVW 1012 - 0002   Pre-Applied Oboe,0002-LEC Main Sess,Staff,30,0,30,0,0
14568,North Campus,GEB 1011 - 0001   Principles Of Business,0001-LEC Main Sess,Staff,35,31,4,0,0
14569,North Campus,GEB 1011 - 0002   Principles Of Business,0002-LEC Main Sess,Staff,35,21,14,0,0
14620,North Campus,GEB 1011 - 0003   Principles Of Business,0003-LEC Conversion,Staff,35,0,35,0,0
14611,North Campus,GEB 1011 - 0004   Principles Of Business,0004-LEC Twelve Wk,Staff,40,0,40,0,0
14613,North Campus,GEB 1011 - 0005   Principles Of Business,0005-LEC Eight Wk 1,Staff,30,10,20,0,0
14587,North Campus,GEB 1011 - 0006   Principles Of Business,0006-LEC Main Sess,Staff,35,0,35,0,0
14588,North Campus,GEB 1011 - 0007   Principles Of Business,0007-LEC Main Sess,Staff,40,16,24,0,0
14589,North Campus,GEB 1011 - 0008   Principles Of Business,0008-LEC Main Sess,Staff,35,24,11,0,0
14621,North Campus,GEB 1011 - 0009   Principles Of Business,0009-LEC Conversion,Staff,35,0,35,0,0
14614,North Campus,GEB 1011 - 0010   Principles Of Business,0010-LEC Eight Wk 1,Staff,30,0,30,0,0
14615,North Campus,GEB 1011 - 0011   Principles Of Business,0011-LEC Eight Wk 1,Staff,30,14,16,0,0
14590,North Campus,GEB 1011 - 0012   Principles Of Business,0012-LEC Main Sess,Staff,35,16,19,0,0
14591,North Campus,GEB 1011 - 0013   Principles Of Business,0013-LEC Main Sess,Staff,35,16,19,0,0
14592,North Campus,GEB 1011 - 0014   Principles Of Business,0014-LEC Main Sess,Staff,35,17,18,0,0
14593,North Campus,GEB 1011 - 0015   Principles Of Business,0015-LEC Main Sess,Staff,35,16,19,0,0
14610,North Campus,GEB 1011 - 0016   Principles Of Business,0016-LEC Twelve Wk,Staff,30,20,10,0,0
14595,Kendall Campus,GEB 1011 - 0018   Principles Of Business,0018-LEC Main Sess,Staff,45,41,4,0,0
14617,Kendall Campus,GEB 1011 - 0019   Principles Of Business,0019-LEC Eight Wk 2,Staff,30,20,10,0,0
14596,Kendall Campus,GEB 1011 - 0020   Principles Of Business,0020-LEC Main Sess,Staff,45,38,7,0,0
14597,Kendall Campus,GEB 1011 - 0021   Principles Of Business,0021-LEC Main Sess,Staff,25,23,2,0,0
14598,Kendall Campus,GEB 1011 - 0022   Principles Of Business,0022-LEC Main Sess,Staff,36,34,2,0,0
14600,Kendall Campus,GEB 1011 - 0024   Principles Of Business,0024-LEC Main Sess,Staff,36,34,2,0,0
14601,Kendall Campus,GEB 1011 - 0025   Principles Of Business,0025-LEC Main Sess,Staff,30,28,2,0,0
14612,Kendall Campus,GEB 1011 - 0026   Principles Of Business,0026-LEC Twelve Wk,Staff,25,23,2,0,0
14607,Kendall Campus,GEB 1011 - 0027   Principles Of Business,0027-LEC Twelve Wk,Staff,42,38,4,0,0
14608,Kendall Campus,GEB 1011 - 0028   Principles Of Business,0028-LEC Twelve Wk,Staff,36,33,3,0,0
14603,Kendall Campus,GEB 1011 - 0030   Principles Of Business,0030-LEC Main Sess,Staff,36,33,3,0,0
14604,Wolfson Campus,GEB 1011 - 0031   Principles Of Business,0031-LEC Main Sess,Staff,35,29,6,0,0
14606,Wolfson Campus,GEB 1011 - 0033   Principles Of Business,0033-LEC Main Sess,Staff,35,32,3,0,0
14586,Wolfson Campus,GEB 1011 - 0034   Principles Of Business,0034-LEC Main Sess,Staff,35,34,1,0,0
14585,Wolfson Campus,GEB 1011 - 0035   Principles Of Business,0035-LEC Main Sess,Staff,35,33,2,0,0
14609,Wolfson Campus,GEB 1011 - 0036   Principles Of Business,0036-LEC Twelve Wk,Staff,40,37,3,0,0
14622,Wolfson Campus,GEB 1011 - 0038   Principles Of Business,0038-LEC Conversion,Staff,30,25,5,0,0
14583,Wolfson Campus,GEB 1011 - 0039   Principles Of Business,0039-LEC Main Sess,Staff,30,27,3,0,0
14582,Wolfson Campus,GEB 1011 - 0040   Principles Of Business,0040-LEC Main Sess,Staff,30,29,1,0,0
14581,Wolfson Campus,GEB 1011 - 0041   Principles Of Business,0041-LEC Main Sess,Staff,30,29,1,0,0
14580,Wolfson Campus,GEB 1011 - 0042   Principles Of Business,0042-LEC Main Sess,Staff,30,27,3,0,0
14579,Wolfson Campus,GEB 1011 - 0043   Principles Of Business,0043-LEC Main Sess,Staff,30,27,3,0,0
14578,Wolfson Campus,GEB 1011 - 0044   Principles Of Business,0044-LEC Main Sess,Staff,30,24,6,0,0
14619,Homestead Campus,GEB 1011 - 0045   Principles Of Business,0045-LEC Eight Wk 2,Staff,39,35,4,0,0
14577,Homestead Campus,GEB 1011 - 0046   Principles Of Business,0046-LEC Main Sess,Staff,35,23,12,0,0
14624,InterAmerican Campus,GEB 1011 - 0047   Principles Of Business,0047-LEC 1st Mon Sp,Staff,30,16,14,0,0
14623,InterAmerican Campus,GEB 1011 - 0048   Principles Of Business,0048-LEC 1st Mon Sp,Staff,30,15,15,0,0
14576,InterAmerican Campus,GEB 1011 - 0049   Principles Of Business,0049-LEC Main Sess,Staff,32,20,12,0,0
14575,Hialeah Campus,GEB 1011 - 0050   Principles Of Business,0050-LEC Main Sess,Staff,30,0,30,0,0
14616,Hialeah Campus,GEB 1011 - 0051   Principles Of Business,0051-LEC Eight Wk 1,Staff,30,11,19,0,0
14618,Hialeah Campus,GEB 1011 - 0052   Principles Of Business,0052-LEC Eight Wk 2,Staff,30,26,4,0,0
14574,West Campus,GEB 1011 - 0053   Principles Of Business,0053-LEC Main Sess,Staff,35,17,18,0,0
14573,West Campus,GEB 1011 - 0054   Principles Of Business,0054-LEC Main Sess,Staff,30,0,30,0,0
14572,West Campus,GEB 1011 - 0055   Principles Of Business,0055-LEC Main Sess,Staff,38,37,1,0,0
14570,West Campus,GEB 1011 - 0057   Principles Of Business,0057-LEC Main Sess,Staff,35,26,9,0,0
6402,Kendall Campus,HOS 1011 - 0001   Horticulture 2,0001-LEC Main Sess,Staff,24,10,14,0,0
12830,North Campus,MAR 1011 - 0001   Principles Of Marketing,0001-LEC Twelve Wk,Staff,40,19,21,0,0
12815,North Campus,MAR 1011 - 0002   Principles Of Marketing,0002-LEC Main Sess,Staff,45,41,4,0,0
12831,North Campus,MAR 1011 - 0003   Principles Of Marketing,0003-LEC Eight Wk 1,Staff,40,0,40,0,0
12835,North Campus,MAR 1011 - 0004   Principles Of Marketing,0004-LEC 1st Mon Sp,Staff,35,33,2,0,0
12816,Kendall Campus,MAR 1011 - 0005   Principles Of Marketing,0005-LEC Main Sess,Staff,36,34,2,0,0
12829,Kendall Campus,MAR 1011 - 0006   Principles Of Marketing,0006-LEC Twelve Wk,Staff,30,29,1,0,0
12824,Kendall Campus,MAR 1011 - 0008   Principles Of Marketing,0008-LEC Main Sess,Staff,40,33,7,0,0
12825,Wolfson Campus,MAR 1011 - 0009   Principles Of Marketing,0009-LEC Main Sess,Staff,35,19,16,0,0
12826,Wolfson Campus,MAR 1011 - 0010   Principles Of Marketing,0010-LEC Main Sess,Staff,35,23,12,0,0
12827,Wolfson Campus,MAR 1011 - 0011   Principles Of Marketing,0011-LEC Main Sess,Staff,30,22,8,0,0
12834,Wolfson Campus,MAR 1011 - 0012   Principles Of Marketing,0012-LEC Conversion,Staff,35,17,18,0,0
12828,Wolfson Campus,MAR 1011 - 0013   Principles Of Marketing,0013-LEC Main Sess,Staff,40,13,27,0,0
12822,Wolfson Campus,MAR 1011 - 0014   Principles Of Marketing,0014-LEC Main Sess,Staff,34,31,3,0,0
12833,Wolfson Campus,MAR 1011 - 0015   Principles Of Marketing,0015-LEC Conversion,Staff,34,31,3,0,0
12821,Wolfson Campus,MAR 1011 - 0016   Principles Of Marketing,0016-LEC Main Sess,Staff,34,31,3,0,0
12832,Wolfson Campus,MAR 1011 - 0017   Principles Of Marketing,0017-LEC Conversion,Staff,34,32,2,0,0
12820,Homestead Campus,MAR 1011 - 0018   Principles Of Marketing,0018-LEC Main Sess,Staff,30,0,30,0,0
12819,Homestead Campus,MAR 1011 - 0019   Principles Of Marketing,0019-LEC Main Sess,Staff,1,0,1,0,0
12818,InterAmerican Campus,MAR 1011 - 0020   Principles Of Marketing,0020-LEC Main Sess,Staff,21,17,4,0,0
12817,West Campus,MAR 1011 - 0021   Principles Of Marketing,0021-LEC Main Sess,Staff,30,22,8,0,0
12968,Kendall Campus,MVB 1011 - 0002   Pre-Applied Trumpet,0002-LEC Main Sess,Staff,15,2,13,0,0
12273,Kendall Campus,MVJ 1011 - 0001   Pre-Applied Jazz Voice,0001-LEC Main Sess,Staff,50,9,41,0,0
12276,Kendall Campus,MVJ 1011 - 0002   Pre-Applied Jazz Voice,0002-LEC Main Sess,Staff,25,10,15,0,0
12275,Kendall Campus,MVJ 1011 - 0003   Pre-Applied Jazz Voice,0003-LEC Main Sess,Staff,25,0,25,0,0
12274,Kendall Campus,MVJ 1011 - 0004   Pre-Applied Jazz Voice,0004-LEC Main Sess,Staff,15,0,15,0,0
10466,Kendall Campus,MVK 1011 - 0002   Pre-Applied Piano,0002-LEC Main Sess,Staff,16,2,14,0,0
10467,Kendall Campus,MVK 1011 - 0003   Pre-Applied Piano,0003-LEC Main Sess,Staff,15,10,5,0,0
10472,Kendall Campus,MVK 1011 - 0004   Pre-Applied Piano,0004-LEC Main Sess,Staff,20,3,17,0,0
10469,Kendall Campus,MVK 1011 - 0005   Pre-Applied Piano,0005-LEC Main Sess,Staff,40,3,37,0,0
10471,Wolfson Campus,MVK 1011 - 0007   Pre-Applied Piano,0007-LEC Main Sess,Staff,1,0,1,0,0
16421,Kendall Campus,MVS 1011 - 0001   Pre-Applied Violin,0001-LEC Main Sess,Staff,50,1,49,0,0
14878,North Campus,MVV 1011 - 0001   Pre-Applied Voice,0001-LEC Main Sess,Staff,1,0,1,0,0
14879,Kendall Campus,MVV 1011 - 0002   Pre-Applied Voice,0002-LEC Main Sess,Staff,16,7,9,0,0
14880,Kendall Campus,MVV 1011 - 0003   Pre-Applied Voice,0003-LEC Main Sess,Staff,20,1,19,0,0
14884,Kendall Campus,MVV 1011 - 0004   Pre-Applied Voice,0004-LEC Main Sess,Staff,16,1,15,0,0
14882,Wolfson Campus,MVV 1011 - 0005   Pre-Applied Voice,0005-LEC Main Sess,Staff,1,0,1,0,0
14881,Wolfson Campus,MVV 1011 - 0007   Pre-Applied Voice,0007-LEC Main Sess,Staff,1,0,1,0,0
13947,Kendall Campus,MVW 1011 - 0001   Pre-Applied Flute,0001-LEC Main Sess,Staff,50,1,49,0,0
13946,Wolfson Campus,MVW 1011 - 0002   Pre-Applied Flute,0002-LEC Main Sess,Staff,2,0,2,0,0
5316,Homestead Campus,ASC 1010 - 0001   Aerospace History,0001-LEC Main Sess,Staff,30,10,20,0,0
7758,Homestead Campus,AVM 1010 - 0001   Aviation Industry Operation,0001-LEC Main Sess,Staff,30,0,30,0,0
7761,Homestead Campus,AVM 1010 - 0002   Aviation Industry Operation,0002-LEC Main Sess,Staff,30,27,3,0,0
7760,Homestead Campus,AVM 1010 - 0003   Aviation Industry Operation,0003-LEC Main Sess,Staff,1,0,1,0,0
7759,Homestead Campus,AVM 1010 - 0004   Aviation Industry Operation,0004-LEC Main Sess,Staff,30,0,30,0,0
7785,Kendall Campus,BOT 1010 - 0001   Botany,0001-LEC Main Sess,Staff,24,15,9,0,0
7784,Kendall Campus,BOT 1010 - 0002   Botany,0002-LEC Main Sess,Staff,24,0,24,0,0
9000,North Campus,CCJ 1010 - 0001   Introduction To Criminology,0001-LEC Main Sess,Staff,40,38,2,0,0
9001,North Campus,CCJ 1010 - 0002   Introduction To Criminology,0002-LEC Main Sess,Staff,40,0,40,0,0
9012,North Campus,CCJ 1010 - 0003   Introduction To Criminology,0003-LEC Twelve Wk,Staff,40,33,7,0,0
9011,North Campus,CCJ 1010 - 0004   Introduction To Criminology,0004-LEC Twelve Wk,Staff,40,39,1,0,0
9010,North Campus,CCJ 1010 - 0005   Introduction To Criminology,0005-LEC Twelve Wk,Staff,40,0,40,0,0
9013,North Campus,CCJ 1010 - 0006   Introduction To Criminology,0006-LEC Twelve Wk,Staff,40,0,40,0,0
9002,North Campus,CCJ 1010 - 0007   Introduction To Criminology,0007-LEC Main Sess,Staff,40,21,19,0,0
9003,Kendall Campus,CCJ 1010 - 0008   Introduction To Criminology,0008-LEC Main Sess,Staff,40,33,7,0,0
9004,Kendall Campus,CCJ 1010 - 0009   Introduction To Criminology,0009-LEC Main Sess,Staff,30,24,6,0,0
9005,Wolfson Campus,CCJ 1010 - 0010   Introduction To Criminology,0010-LEC Main Sess,Staff,40,39,1,0,0
9006,Wolfson Campus,CCJ 1010 - 0011   Introduction To Criminology,0011-LEC Main Sess,Staff,30,16,14,0,0
9009,Wolfson Campus,CCJ 1010 - 0012   Introduction To Criminology,0012-LEC Main Sess,Staff,30,25,5,0,0
9008,Wolfson Campus,CCJ 1010 - 0013   Introduction To Criminology,0013-LEC Main Sess,Staff,30,29,1,0,0
9007,Hialeah Campus,CCJ 1010 - 0014   Introduction To Criminology,0014-LEC Main Sess,Staff,30,28,2,0,0
11368,North Campus,GLY 1010 - 0001   Physical Geology,0001-LEC Main Sess,Staff,32,31,1,0,0
15288,Kendall Campus,HOS 1010 - 0001   Horticulture 1,0001-LEC Main Sess,Staff,24,0,24,0,0
15289,Kendall Campus,HOS 1010 - 0002   Horticulture 1,0002-LEC 1st Mon Sp,Staff,24,20,4,0,0
12222,North Campus,MET 1010 - 0001   Introduction To Weather,0001-LEC Main Sess,Staff,32,0,32,0,0
12221,Kendall Campus,MET 1010 - 0002   Introduction To Weather,0002-LEC Main Sess,Staff,45,43,2,0,0
14738,North Campus,MUL 1010 - 0001   Music Appreciation,0001-LEC Main Sess,Staff,30,26,4,0,0
14747,North Campus,MUL 1010 - 0003   Music Appreciation,0003-LEC Main Sess,Staff,20,0,20,0,0
14748,North Campus,MUL 1010 - 0004   Music Appreciation,0004-LEC Main Sess,Staff,30,26,4,0,0
14785,North Campus,MUL 1010 - 0005   Music Appreciation,0005-LEC Twelve Wk,Staff,30,16,14,0,0
14749,North Campus,MUL 1010 - 0006   Music Appreciation,0006-LEC Main Sess,Staff,30,29,1,0,0
14750,North Campus,MUL 1010 - 0007   Music Appreciation,0007-LEC Main Sess,Staff,30,13,17,0,0
14784,North Campus,MUL 1010 - 0008   Music Appreciation,0008-LEC Twelve Wk,Staff,20,8,12,0,0
14783,North Campus,MUL 1010 - 0009   Music Appreciation,0009-LEC Twelve Wk,Staff,30,9,21,0,0
14751,Kendall Campus,MUL 1010 - 0010   Music Appreciation,0010-LEC Main Sess,Staff,40,17,23,0,0
14752,Kendall Campus,MUL 1010 - 0011   Music Appreciation,0011-LEC Main Sess,Staff,40,22,18,0,0
14753,Kendall Campus,MUL 1010 - 0012   Music Appreciation,0012-LEC Main Sess,Staff,40,0,40,0,0
14754,Kendall Campus,MUL 1010 - 0013   Music Appreciation,0013-LEC Main Sess,Staff,40,12,28,0,0
14755,Kendall Campus,MUL 1010 - 0014   Music Appreciation,0014-LEC Main Sess,Staff,40,20,20,0,0
14756,Kendall Campus,MUL 1010 - 0015   Music Appreciation,0015-LEC Main Sess,Staff,35,0,35,0,0
14757,Kendall Campus,MUL 1010 - 0016   Music Appreciation,0016-LEC Main Sess,Staff,40,20,20,0,0
14758,Kendall Campus,MUL 1010 - 0017   Music Appreciation,0017-LEC Main Sess,Staff,40,31,9,0,0
14759,Kendall Campus,MUL 1010 - 0018   Music Appreciation,0018-LEC Main Sess,Staff,40,20,20,0,0
14760,Kendall Campus,MUL 1010 - 0019   Music Appreciation,0019-LEC Main Sess,Staff,35,30,5,0,0
14761,Kendall Campus,MUL 1010 - 0020   Music Appreciation,0020-LEC Main Sess,Staff,40,15,25,0,0
14762,Kendall Campus,MUL 1010 - 0021   Music Appreciation,0021-LEC Main Sess,Staff,40,8,32,0,0
14763,Kendall Campus,MUL 1010 - 0022   Music Appreciation,0022-LEC Main Sess,Staff,40,38,2,0,0
14764,Kendall Campus,MUL 1010 - 0023   Music Appreciation,0023-LEC Main Sess,Staff,30,0,30,0,0
14788,Kendall Campus,MUL 1010 - 0024   Music Appreciation,0024-LEC Conversion,Staff,40,35,5,0,0
14782,Kendall Campus,MUL 1010 - 0025   Music Appreciation,0025-LEC Twelve Wk,Staff,36,19,17,0,0
14781,Kendall Campus,MUL 1010 - 0026   Music Appreciation,0026-LEC Twelve Wk,Staff,30,29,1,0,0
14786,Kendall Campus,MUL 1010 - 0027   Music Appreciation,0027-LEC Eight Wk 2,Staff,25,16,9,0,0
14765,Kendall Campus,MUL 1010 - 0028   Music Appreciation,0028-LEC Main Sess,Staff,40,18,22,0,0
14766,Kendall Campus,MUL 1010 - 0029   Music Appreciation,0029-LEC Main Sess,Staff,25,17,8,0,0
14767,Kendall Campus,MUL 1010 - 0030   Music Appreciation,0030-LEC Main Sess,Staff,40,0,40,0,0
14768,Wolfson Campus,MUL 1010 - 0031   Music Appreciation,0031-LEC Main Sess,Staff,40,38,2,0,0
14769,Wolfson Campus,MUL 1010 - 0032   Music Appreciation,0032-LEC Main Sess,Staff,40,36,4,0,0
14770,Wolfson Campus,MUL 1010 - 0033   Music Appreciation,0033-LEC Main Sess,Staff,35,0,35,0,0
14771,Wolfson Campus,MUL 1010 - 0034   Music Appreciation,0034-LEC Main Sess,Staff,40,15,25,0,0
14772,Wolfson Campus,MUL 1010 - 0035   Music Appreciation,0035-LEC Main Sess,Staff,40,29,11,0,0
14773,Wolfson Campus,MUL 1010 - 0036   Music Appreciation,0036-LEC Main Sess,Staff,40,26,14,0,0
14774,Wolfson Campus,MUL 1010 - 0037   Music Appreciation,0037-LEC Main Sess,Staff,35,22,13,0,0
14775,Wolfson Campus,MUL 1010 - 0038   Music Appreciation,0038-LEC Main Sess,Staff,30,19,11,0,0
14776,Wolfson Campus,MUL 1010 - 0039   Music Appreciation,0039-LEC Main Sess,Staff,30,25,5,0,0
14777,Wolfson Campus,MUL 1010 - 0040   Music Appreciation,0040-LEC Main Sess,Staff,30,28,2,0,0
14778,Wolfson Campus,MUL 1010 - 0041   Music Appreciation,0041-LEC Main Sess,Staff,30,22,8,0,0
14779,Homestead Campus,MUL 1010 - 0042   Music Appreciation,0042-LEC Main Sess,Staff,30,23,7,0,0
14780,InterAmerican Campus,MUL 1010 - 0043   Music Appreciation,0043-LEC Main Sess,Staff,30,19,11,0,0
14787,InterAmerican Campus,MUL 1010 - 0044   Music Appreciation,0044-LEC Eight Wk 2,Staff,30,26,4,0,0
14746,Hialeah Campus,MUL 1010 - 0045   Music Appreciation,0045-LEC Main Sess,Staff,33,31,2,0,0
14745,Hialeah Campus,MUL 1010 - 0046   Music Appreciation,0046-LEC Main Sess,Staff,33,30,3,0,0
14744,Hialeah Campus,MUL 1010 - 0047   Music Appreciation,0047-LEC Main Sess,Staff,33,31,2,0,0
14743,West Campus,MUL 1010 - 0048   Music Appreciation,0048-LEC Main Sess,Staff,35,0,35,0,0
14742,West Campus,MUL 1010 - 0049   Music Appreciation,0049-LEC Main Sess,Staff,35,16,19,0,0
14741,West Campus,MUL 1010 - 0050   Music Appreciation,0050-LEC Main Sess,Staff,35,17,18,0,0
14740,West Campus,MUL 1010 - 0051   Music Appreciation,0051-LEC Main Sess,Staff,30,0,30,0,0
13924,Kendall Campus,MVJ 1010 - 0002   Pre-Applied Jazz Piano,0002-LEC Main Sess,Staff,50,6,44,0,0
9608,Wolfson Campus,OCB 1010 - 0001   Introduction To Marine Biology,0001-LEC Main Sess,Staff,30,29,1,0,0
9610,Homestead Campus,OCB 1010 - 0002   Introduction To Marine Biology,0002-LEC Eight Wk 2,Staff,39,33,6,0,0
9609,Homestead Campus,OCB 1010 - 0003   Introduction To Marine Biology,0003-LEC Eight Wk 2,Staff,39,0,39,0,0
5337,Kendall Campus,BOT 1010L - 0001   Botany Laboratory,0001-LAB Main Sess,Staff,24,15,9,0,0
11369,North Campus,GLY 1010L - 0001   Physical Geology Laboratory,0001-LAB Main Sess,Staff,32,29,3,0,0
10609,North Campus,CLP 1006 - 0001   Psychology Of Personal Effectiveness,0001-LEC Main Sess,Staff,40,0,40,0,0
10612,North Campus,CLP 1006 - 0004   Psychology Of Personal Effectiveness,0004-LEC Main Sess,Staff,35,0,35,0,0
10731,North Campus,CLP 1006 - 0005   Psychology Of Personal Effectiveness,0005-LEC Eight Wk 1,Staff,40,0,40,0,0
10613,North Campus,CLP 1006 - 0006   Psychology Of Personal Effectiveness,0006-LEC Main Sess,Staff,40,36,4,0,0
10614,North Campus,CLP 1006 - 0007   Psychology Of Personal Effectiveness,0007-LEC Main Sess,Staff,40,32,8,0,0
10615,North Campus,CLP 1006 - 0008   Psychology Of Personal Effectiveness,0008-LEC Main Sess,Staff,40,39,1,0,0
10616,North Campus,CLP 1006 - 0009   Psychology Of Personal Effectiveness,0009-LEC Main Sess,Staff,40,30,10,0,0
10617,North Campus,CLP 1006 - 0010   Psychology Of Personal Effectiveness,0010-LEC Main Sess,Staff,40,38,2,0,0
10618,North Campus,CLP 1006 - 0011   Psychology Of Personal Effectiveness,0011-LEC Main Sess,Staff,30,0,30,0,0
10619,North Campus,CLP 1006 - 0012   Psychology Of Personal Effectiveness,0012-LEC Main Sess,Staff,35,0,35,0,0
10732,North Campus,CLP 1006 - 0013   Psychology Of Personal Effectiveness,0013-LEC Eight Wk 2,Staff,40,37,3,0,0
10620,North Campus,CLP 1006 - 0014   Psychology Of Personal Effectiveness,0014-LEC Main Sess,Staff,35,14,21,0,0
10621,North Campus,CLP 1006 - 0015   Psychology Of Personal Effectiveness,0015-LEC Main Sess,Staff,40,38,2,0,0
10622,North Campus,CLP 1006 - 0016   Psychology Of Personal Effectiveness,0016-LEC Main Sess,Staff,40,19,21,0,0
10623,North Campus,CLP 1006 - 0017   Psychology Of Personal Effectiveness,0017-LEC Main Sess,Staff,40,0,40,0,0
10624,North Campus,CLP 1006 - 0018   Psychology Of Personal Effectiveness,0018-LEC Main Sess,Staff,35,18,17,0,0
10744,North Campus,CLP 1006 - 0019   Psychology Of Personal Effectiveness,0019-LEC Conversion,Staff,40,0,40,0,0
10751,North Campus,CLP 1006 - 0021   Psychology Of Personal Effectiveness,0021-LEC Weekend,Staff,40,0,40,0,0
10746,North Campus,CLP 1006 - 0022   Psychology Of Personal Effectiveness,0022-LEC 1st Mon Sp,Staff,40,18,22,0,0
10728,North Campus,CLP 1006 - 0023   Psychology Of Personal Effectiveness,0023-LEC Twelve Wk,Staff,40,24,16,0,0
10625,North Campus,CLP 1006 - 0024   Psychology Of Personal Effectiveness,0024-LEC Main Sess,Staff,40,18,22,0,0
10626,North Campus,CLP 1006 - 0025   Psychology Of Personal Effectiveness,0025-LEC Main Sess,Staff,40,18,22,0,0
10627,North Campus,CLP 1006 - 0026   Psychology Of Personal Effectiveness,0026-LEC Main Sess,Staff,40,31,9,0,0
10628,North Campus,CLP 1006 - 0027   Psychology Of Personal Effectiveness,0027-LEC Main Sess,Staff,40,26,14,0,0
10629,North Campus,CLP 1006 - 0028   Psychology Of Personal Effectiveness,0028-LEC Main Sess,Staff,40,36,4,0,0
10727,North Campus,CLP 1006 - 0029   Psychology Of Personal Effectiveness,0029-LEC Twelve Wk,Staff,40,31,9,0,0
10630,North Campus,CLP 1006 - 0030   Psychology Of Personal Effectiveness,0030-LEC Main Sess,Staff,40,0,40,0,0
10726,North Campus,CLP 1006 - 0031   Psychology Of Personal Effectiveness,0031-LEC Twelve Wk,Staff,40,27,13,0,0
10725,North Campus,CLP 1006 - 0032   Psychology Of Personal Effectiveness,0032-LEC Twelve Wk,Staff,36,12,24,0,0
10631,Kendall Campus,CLP 1006 - 0033   Psychology Of Personal Effectiveness,0033-LEC Main Sess,Staff,49,47,2,0,0
10632,Kendall Campus,CLP 1006 - 0034   Psychology Of Personal Effectiveness,0034-LEC Main Sess,Staff,49,45,4,0,0
10633,Kendall Campus,CLP 1006 - 0035   Psychology Of Personal Effectiveness,0035-LEC Main Sess,Staff,37,36,1,0,0
10634,Kendall Campus,CLP 1006 - 0036   Psychology Of Personal Effectiveness,0036-LEC Main Sess,Staff,49,26,23,0,0
10747,Kendall Campus,CLP 1006 - 0037   Psychology Of Personal Effectiveness,0037-LEC 1st Mon Sp,Staff,48,44,4,0,0
10733,Kendall Campus,CLP 1006 - 0038   Psychology Of Personal Effectiveness,0038-LEC Eight Wk 2,Staff,30,26,4,0,0
10750,Kendall Campus,CLP 1006 - 0039   Psychology Of Personal Effectiveness,0039-LEC Weekend,Staff,30,11,19,0,0
10635,Kendall Campus,CLP 1006 - 0040   Psychology Of Personal Effectiveness,0040-LEC Main Sess,Staff,48,34,14,0,0
10636,Kendall Campus,CLP 1006 - 0041   Psychology Of Personal Effectiveness,0041-LEC Main Sess,Staff,45,37,8,0,0
10637,Kendall Campus,CLP 1006 - 0042   Psychology Of Personal Effectiveness,0042-LEC Main Sess,Staff,49,44,5,0,0
10638,Kendall Campus,CLP 1006 - 0043   Psychology Of Personal Effectiveness,0043-LEC Main Sess,Staff,49,29,20,0,0
10639,Kendall Campus,CLP 1006 - 0044   Psychology Of Personal Effectiveness,0044-LEC Main Sess,Staff,49,47,2,0,0
10640,Kendall Campus,CLP 1006 - 0045   Psychology Of Personal Effectiveness,0045-LEC Main Sess,Staff,49,34,15,0,0
10641,Kendall Campus,CLP 1006 - 0046   Psychology Of Personal Effectiveness,0046-LEC Main Sess,Staff,45,16,29,0,0
10642,Kendall Campus,CLP 1006 - 0047   Psychology Of Personal Effectiveness,0047-LEC Main Sess,Staff,48,41,7,0,0
10643,Kendall Campus,CLP 1006 - 0048   Psychology Of Personal Effectiveness,0048-LEC Main Sess,Staff,48,0,48,0,0
10644,Kendall Campus,CLP 1006 - 0049   Psychology Of Personal Effectiveness,0049-LEC Main Sess,Staff,45,41,4,0,0
10717,Kendall Campus,CLP 1006 - 0050   Psychology Of Personal Effectiveness,0050-LEC Twelve Wk,Staff,40,36,4,0,0
10723,Kendall Campus,CLP 1006 - 0051   Psychology Of Personal Effectiveness,0051-LEC Twelve Wk,Staff,36,33,3,0,0
10734,Kendall Campus,CLP 1006 - 0052   Psychology Of Personal Effectiveness,0052-LEC Eight Wk 2,Staff,40,36,4,0,0
10645,Kendall Campus,CLP 1006 - 0053   Psychology Of Personal Effectiveness,0053-LEC Main Sess,Staff,48,30,18,0,0
10646,Kendall Campus,CLP 1006 - 0054   Psychology Of Personal Effectiveness,0054-LEC Main Sess,Staff,49,30,19,0,0
10647,Kendall Campus,CLP 1006 - 0055   Psychology Of Personal Effectiveness,0055-LEC Main Sess,Staff,45,41,4,0,0
10648,Kendall Campus,CLP 1006 - 0056   Psychology Of Personal Effectiveness,0056-LEC Main Sess,Staff,45,44,1,0,0
10649,Kendall Campus,CLP 1006 - 0057   Psychology Of Personal Effectiveness,0057-LEC Main Sess,Staff,45,42,3,0,0
10650,Kendall Campus,CLP 1006 - 0058   Psychology Of Personal Effectiveness,0058-LEC Main Sess,Staff,45,42,3,0,0
10651,Kendall Campus,CLP 1006 - 0059   Psychology Of Personal Effectiveness,0059-LEC Main Sess,Staff,49,24,25,0,0
10652,Kendall Campus,CLP 1006 - 0060   Psychology Of Personal Effectiveness,0060-LEC Main Sess,Staff,45,33,12,0,0
10735,Kendall Campus,CLP 1006 - 0061   Psychology Of Personal Effectiveness,0061-LEC Eight Wk 2,Staff,30,29,1,0,0
10743,Kendall Campus,CLP 1006 - 0062   Psychology Of Personal Effectiveness,0062-LEC Conversion,Staff,30,26,4,0,0
10653,Kendall Campus,CLP 1006 - 0063   Psychology Of Personal Effectiveness,0063-LEC Main Sess,Staff,48,35,13,0,0
10654,Kendall Campus,CLP 1006 - 0064   Psychology Of Personal Effectiveness,0064-LEC Main Sess,Staff,48,21,27,0,0
10655,Kendall Campus,CLP 1006 - 0065   Psychology Of Personal Effectiveness,0065-LEC Main Sess,Staff,49,0,49,0,0
10656,Kendall Campus,CLP 1006 - 0066   Psychology Of Personal Effectiveness,0066-LEC Main Sess,Staff,48,0,48,0,0
10657,Kendall Campus,CLP 1006 - 0067   Psychology Of Personal Effectiveness,0067-LEC Main Sess,Staff,48,46,2,0,0
10659,Kendall Campus,CLP 1006 - 0069   Psychology Of Personal Effectiveness,0069-LEC Main Sess,Staff,37,34,3,0,0
10660,Kendall Campus,CLP 1006 - 0070   Psychology Of Personal Effectiveness,0070-LEC Main Sess,Staff,40,38,2,0,0
10661,Wolfson Campus,CLP 1006 - 0071   Psychology Of Personal Effectiveness,0071-LEC Main Sess,Staff,45,40,5,0,0
10722,Wolfson Campus,CLP 1006 - 0073   Psychology Of Personal Effectiveness,0073-LEC Twelve Wk,Staff,47,45,2,0,0
10721,Wolfson Campus,CLP 1006 - 0074   Psychology Of Personal Effectiveness,0074-LEC Twelve Wk,Staff,35,33,2,0,0
10663,Wolfson Campus,CLP 1006 - 0075   Psychology Of Personal Effectiveness,0075-LEC Main Sess,Staff,47,30,17,0,0
10664,Wolfson Campus,CLP 1006 - 0076   Psychology Of Personal Effectiveness,0076-LEC Main Sess,Staff,47,37,10,0,0
10665,Wolfson Campus,CLP 1006 - 0077   Psychology Of Personal Effectiveness,0077-LEC Main Sess,Staff,47,44,3,0,0
10666,Wolfson Campus,CLP 1006 - 0078   Psychology Of Personal Effectiveness,0078-LEC Main Sess,Staff,40,33,7,0,0
10667,Wolfson Campus,CLP 1006 - 0079   Psychology Of Personal Effectiveness,0079-LEC Main Sess,Staff,47,19,28,0,0
10668,Wolfson Campus,CLP 1006 - 0080   Psychology Of Personal Effectiveness,0080-LEC Main Sess,Staff,47,37,10,0,0
10669,Wolfson Campus,CLP 1006 - 0081   Psychology Of Personal Effectiveness,0081-LEC Main Sess,Staff,47,46,1,0,0
10670,Wolfson Campus,CLP 1006 - 0082   Psychology Of Personal Effectiveness,0082-LEC Main Sess,Staff,45,15,30,0,0
10671,Wolfson Campus,CLP 1006 - 0083   Psychology Of Personal Effectiveness,0083-LEC Main Sess,Staff,47,36,11,0,0
10742,Wolfson Campus,CLP 1006 - 0084   Psychology Of Personal Effectiveness,0084-LEC Conversion,Staff,47,45,2,0,0
10720,Wolfson Campus,CLP 1006 - 0085   Psychology Of Personal Effectiveness,0085-LEC Twelve Wk,Staff,47,46,1,0,0
10672,Wolfson Campus,CLP 1006 - 0086   Psychology Of Personal Effectiveness,0086-LEC Main Sess,Staff,47,27,20,0,0
10673,Wolfson Campus,CLP 1006 - 0087   Psychology Of Personal Effectiveness,0087-LEC Main Sess,Staff,47,43,4,0,0
10674,Wolfson Campus,CLP 1006 - 0088   Psychology Of Personal Effectiveness,0088-LEC Main Sess,Staff,47,26,21,0,0
10675,Wolfson Campus,CLP 1006 - 0089   Psychology Of Personal Effectiveness,0089-LEC Main Sess,Staff,47,34,13,0,0
10749,Wolfson Campus,CLP 1006 - 0090   Psychology Of Personal Effectiveness,0090-LEC Weekend,Staff,40,33,7,0,0
10676,Wolfson Campus,CLP 1006 - 0091   Psychology Of Personal Effectiveness,0091-LEC Main Sess,Staff,30,25,5,0,0
10677,Wolfson Campus,CLP 1006 - 0092   Psychology Of Personal Effectiveness,0092-LEC Main Sess,Staff,30,25,5,0,0
10678,Wolfson Campus,CLP 1006 - 0093   Psychology Of Personal Effectiveness,0093-LEC Main Sess,Staff,30,26,4,0,0
10740,Wolfson Campus,CLP 1006 - 0094   Psychology Of Personal Effectiveness,0094-LEC Conversion,Staff,30,27,3,0,0
10679,Wolfson Campus,CLP 1006 - 0095   Psychology Of Personal Effectiveness,0095-LEC Main Sess,Staff,30,26,4,0,0
10680,Wolfson Campus,CLP 1006 - 0096   Psychology Of Personal Effectiveness,0096-LEC Main Sess,Staff,30,26,4,0,0
10681,Wolfson Campus,CLP 1006 - 0097   Psychology Of Personal Effectiveness,0097-LEC Main Sess,Staff,30,15,15,0,0
10739,Wolfson Campus,CLP 1006 - 0098   Psychology Of Personal Effectiveness,0098-LEC Conversion,Staff,30,28,2,0,0
10738,Wolfson Campus,CLP 1006 - 0099   Psychology Of Personal Effectiveness,0099-LEC Conversion,Staff,30,22,8,0,0
10682,Wolfson Campus,CLP 1006 - 0100   Psychology Of Personal Effectiveness,0100-LEC Main Sess,Staff,30,28,2,0,0
10683,Wolfson Campus,CLP 1006 - 0101   Psychology Of Personal Effectiveness,0101-LEC Main Sess,Staff,30,25,5,0,0
10684,Wolfson Campus,CLP 1006 - 0102   Psychology Of Personal Effectiveness,0102-LEC Main Sess,Staff,30,25,5,0,0
10685,Wolfson Campus,CLP 1006 - 0103   Psychology Of Personal Effectiveness,0103-LEC Main Sess,Staff,30,27,3,0,0
10686,Wolfson Campus,CLP 1006 - 0104   Psychology Of Personal Effectiveness,0104-LEC Main Sess,Staff,30,25,5,0,0
10737,Wolfson Campus,CLP 1006 - 0105   Psychology Of Personal Effectiveness,0105-LEC Conversion,Staff,30,24,6,0,0
10687,Homestead Campus,CLP 1006 - 0106   Psychology Of Personal Effectiveness,0106-LEC Main Sess,Staff,39,33,6,0,0
10688,Homestead Campus,CLP 1006 - 0107   Psychology Of Personal Effectiveness,0107-LEC Main Sess,Staff,39,14,25,0,0
10689,Homestead Campus,CLP 1006 - 0108   Psychology Of Personal Effectiveness,0108-LEC Main Sess,Staff,39,0,39,0,0
10748,Homestead Campus,CLP 1006 - 0109   Psychology Of Personal Effectiveness,0109-LEC Weekend,Staff,30,18,12,0,0
10690,Homestead Campus,CLP 1006 - 0110   Psychology Of Personal Effectiveness,0110-LEC Main Sess,Staff,39,38,1,0,0
10691,Homestead Campus,CLP 1006 - 0111   Psychology Of Personal Effectiveness,0111-LEC Main Sess,Staff,39,21,18,0,0
10693,InterAmerican Campus,CLP 1006 - 0114   Psychology Of Personal Effectiveness,0114-LEC Main Sess,Staff,40,6,34,0,0
10718,InterAmerican Campus,CLP 1006 - 0115   Psychology Of Personal Effectiveness,0115-LEC Twelve Wk,Staff,30,21,9,0,0
10694,InterAmerican Campus,CLP 1006 - 0116   Psychology Of Personal Effectiveness,0116-LEC Main Sess,Staff,37,27,10,0,0
10745,InterAmerican Campus,CLP 1006 - 0118   Psychology Of Personal Effectiveness,0118-LEC 1st Mon Sp,Staff,40,38,2,0,0
10696,InterAmerican Campus,CLP 1006 - 0119   Psychology Of Personal Effectiveness,0119-LEC Main Sess,Staff,40,34,6,0,0
10697,InterAmerican Campus,CLP 1006 - 0120   Psychology Of Personal Effectiveness,0120-LEC Main Sess,Staff,40,36,4,0,0
10698,InterAmerican Campus,CLP 1006 - 0121   Psychology Of Personal Effectiveness,0121-LEC Main Sess,Staff,40,19,21,0,0
10699,Hialeah Campus,CLP 1006 - 0122   Psychology Of Personal Effectiveness,0122-LEC Main Sess,Staff,33,0,33,0,0
10700,Hialeah Campus,CLP 1006 - 0123   Psychology Of Personal Effectiveness,0123-LEC Main Sess,Staff,30,0,30,0,0
10701,Hialeah Campus,CLP 1006 - 0124   Psychology Of Personal Effectiveness,0124-LEC Main Sess,Staff,30,12,18,0,0
10702,Hialeah Campus,CLP 1006 - 0125   Psychology Of Personal Effectiveness,0125-LEC Main Sess,Staff,35,26,9,0,0
10724,Hialeah Campus,CLP 1006 - 0127   Psychology Of Personal Effectiveness,0127-LEC Twelve Wk,Staff,44,31,13,0,0
10716,Hialeah Campus,CLP 1006 - 0128   Psychology Of Personal Effectiveness,0128-LEC Twelve Wk,Staff,35,11,24,0,0
10752,Hialeah Campus,CLP 1006 - 0129   Psychology Of Personal Effectiveness,0129-LEC Weekend,Staff,33,0,33,0,0
10704,Hialeah Campus,CLP 1006 - 0130   Psychology Of Personal Effectiveness,0130-LEC Main Sess,Staff,30,28,2,0,0
10705,Hialeah Campus,CLP 1006 - 0131   Psychology Of Personal Effectiveness,0131-LEC Main Sess,Staff,35,17,18,0,0
10706,Hialeah Campus,CLP 1006 - 0132   Psychology Of Personal Effectiveness,0132-LEC Main Sess,Staff,33,32,1,0,0
10707,West Campus,CLP 1006 - 0133   Psychology Of Personal Effectiveness,0133-LEC Main Sess,Staff,35,20,15,0,0
10708,West Campus,CLP 1006 - 0134   Psychology Of Personal Effectiveness,0134-LEC Main Sess,Staff,35,22,13,0,0
10741,West Campus,CLP 1006 - 0135   Psychology Of Personal Effectiveness,0135-LEC Conversion,Staff,35,16,19,0,0
10709,West Campus,CLP 1006 - 0136   Psychology Of Personal Effectiveness,0136-LEC Main Sess,Staff,35,34,1,0,0
10710,West Campus,CLP 1006 - 0137   Psychology Of Personal Effectiveness,0137-LEC Main Sess,Staff,35,20,15,0,0
10711,West Campus,CLP 1006 - 0138   Psychology Of Personal Effectiveness,0138-LEC Main Sess,Staff,35,32,3,0,0
10712,West Campus,CLP 1006 - 0139   Psychology Of Personal Effectiveness,0139-LEC Main Sess,Staff,35,34,1,0,0
10713,West Campus,CLP 1006 - 0140   Psychology Of Personal Effectiveness,0140-LEC Main Sess,Staff,35,22,13,0,0
10714,West Campus,CLP 1006 - 0141   Psychology Of Personal Effectiveness,0141-LEC Main Sess,Staff,35,14,21,0,0
10729,West Campus,CLP 1006 - 0142   Psychology Of Personal Effectiveness,0142-LEC Twelve Wk,Staff,35,0,35,0,0
10736,West Campus,CLP 1006 - 0143   Psychology Of Personal Effectiveness,0143-LEC Conversion,Staff,35,21,14,0,0
10715,West Campus,CLP 1006 - 0144   Psychology Of Personal Effectiveness,0144-LEC Main Sess,Staff,35,0,35,0,0
6096,North Campus,DSC 1006 - 0001   Introduction To Homeland Security,0001-LEC Twelve Wk,Staff,40,18,22,0,0
6092,North Campus,DSC 1006 - 0002   Introduction To Homeland Security,0002-LEC Main Sess,Staff,40,0,40,0,0
6093,Kendall Campus,DSC 1006 - 0003   Introduction To Homeland Security,0003-LEC Main Sess,Staff,45,16,29,0,0
6094,Wolfson Campus,DSC 1006 - 0004   Introduction To Homeland Security,0004-LEC Main Sess,Staff,34,33,1,0,0
6098,Wolfson Campus,DSC 1006 - 0006   Introduction To Homeland Security,0006-LEC Twelve Wk,Staff,34,0,34,0,0
6095,InterAmerican Campus,DSC 1006 - 0007   Introduction To Homeland Security,0007-LEC Main Sess,Staff,30,0,30,0,0
6099,InterAmerican Campus,DSC 1006 - 0008   Introduction To Homeland Security,0008-LEC 1st Mon Sp,Staff,30,0,30,0,0
6909,North Campus,BSC 1005 - 0001   General Education Biology,0001-LEC Main Sess,Staff,40,23,17,0,0
6983,North Campus,BSC 1005 - 0002   General Education Biology,0002-LEC Twelve Wk,Staff,40,38,2,0,0
6910,North Campus,BSC 1005 - 0003   General Education Biology,0003-LEC Main Sess,Staff,40,35,5,0,0
6912,North Campus,BSC 1005 - 0005   General Education Biology,0005-LEC Main Sess,Staff,40,36,4,0,0
6913,North Campus,BSC 1005 - 0006   General Education Biology,0006-LEC Main Sess,Staff,40,37,3,0,0
6993,North Campus,BSC 1005 - 0007   General Education Biology,0007-LEC Conversion,Staff,20,9,11,0,0
6914,North Campus,BSC 1005 - 0008   General Education Biology,0008-LEC Main Sess,Staff,40,37,3,0,0
6915,North Campus,BSC 1005 - 0009   General Education Biology,0009-LEC Main Sess,Staff,40,21,19,0,0
6916,North Campus,BSC 1005 - 0010   General Education Biology,0010-LEC Main Sess,Staff,40,36,4,0,0
6984,North Campus,BSC 1005 - 0011   General Education Biology,0011-LEC Twelve Wk,Staff,40,14,26,0,0
6989,North Campus,BSC 1005 - 0012   General Education Biology,0012-LEC Eight Wk 2,Staff,30,23,7,0,0
6917,Kendall Campus,BSC 1005 - 0013   General Education Biology,0013-LEC Main Sess,Staff,49,48,1,0,0
6918,Kendall Campus,BSC 1005 - 0014   General Education Biology,0014-LEC Main Sess,Staff,49,35,14,0,0
6919,Kendall Campus,BSC 1005 - 0015   General Education Biology,0015-LEC Main Sess,Staff,49,18,31,0,0
6920,Kendall Campus,BSC 1005 - 0016   General Education Biology,0016-LEC Main Sess,Staff,40,38,2,0,0
6921,Kendall Campus,BSC 1005 - 0017   General Education Biology,0017-LEC Main Sess,Staff,39,22,17,0,0
6998,Kendall Campus,BSC 1005 - 0018   General Education Biology,0018-LEC Weekend,Staff,49,23,26,0,0
6985,Kendall Campus,BSC 1005 - 0019   General Education Biology,0019-LEC Twelve Wk,Staff,45,41,4,0,0
6922,Kendall Campus,BSC 1005 - 0020   General Education Biology,0020-LEC Main Sess,Staff,49,48,1,0,0
6923,Kendall Campus,BSC 1005 - 0021   General Education Biology,0021-LEC Main Sess,Staff,49,46,3,0,0
6924,Kendall Campus,BSC 1005 - 0022   General Education Biology,0022-LEC Main Sess,Staff,49,20,29,0,0
6926,Kendall Campus,BSC 1005 - 0024   General Education Biology,0024-LEC Main Sess,Staff,38,36,2,0,0
6927,Kendall Campus,BSC 1005 - 0025   General Education Biology,0025-LEC Main Sess,Staff,49,48,1,0,0
6928,Kendall Campus,BSC 1005 - 0026   General Education Biology,0026-LEC Main Sess,Staff,39,37,2,0,0
6930,Kendall Campus,BSC 1005 - 0028   General Education Biology,0028-LEC Main Sess,Staff,49,46,3,0,0
6931,Kendall Campus,BSC 1005 - 0029   General Education Biology,0029-LEC Main Sess,Staff,39,35,4,0,0
6932,Kendall Campus,BSC 1005 - 0030   General Education Biology,0030-LEC Main Sess,Staff,49,48,1,0,0
6986,Kendall Campus,BSC 1005 - 0031   General Education Biology,0031-LEC Twelve Wk,Staff,49,45,4,0,0
6987,Kendall Campus,BSC 1005 - 0032   General Education Biology,0032-LEC Twelve Wk,Staff,30,27,3,0,0
6933,Kendall Campus,BSC 1005 - 0033   General Education Biology,0033-LEC Main Sess,Staff,49,46,3,0,0
6934,Kendall Campus,BSC 1005 - 0034   General Education Biology,0034-LEC Main Sess,Staff,45,43,2,0,0
6935,Kendall Campus,BSC 1005 - 0035   General Education Biology,0035-LEC Main Sess,Staff,49,44,5,0,0
6936,Kendall Campus,BSC 1005 - 0036   General Education Biology,0036-LEC Main Sess,Staff,49,47,2,0,0
6937,Kendall Campus,BSC 1005 - 0037   General Education Biology,0037-LEC Main Sess,Staff,49,47,2,0,0
6982,Kendall Campus,BSC 1005 - 0038   General Education Biology,0038-LEC Twelve Wk,Staff,45,41,4,0,0
6938,Kendall Campus,BSC 1005 - 0039   General Education Biology,0039-LEC Main Sess,Staff,30,28,2,0,0
6988,Kendall Campus,BSC 1005 - 0040   General Education Biology,0040-LEC Twelve Wk,Staff,49,47,2,0,0
6939,Kendall Campus,BSC 1005 - 0041   General Education Biology,0041-LEC Main Sess,Staff,30,23,7,0,0
6995,Wolfson Campus,BSC 1005 - 0042   General Education Biology,0042-LEC Conversion,Staff,30,26,4,0,0
6940,Wolfson Campus,BSC 1005 - 0043   General Education Biology,0043-LEC Main Sess,Staff,45,36,9,0,0
6980,Wolfson Campus,BSC 1005 - 0044   General Education Biology,0044-LEC Twelve Wk,Staff,45,38,7,0,0
6941,Wolfson Campus,BSC 1005 - 0045   General Education Biology,0045-LEC Main Sess,Staff,45,35,10,0,0
6942,Wolfson Campus,BSC 1005 - 0046   General Education Biology,0046-LEC Main Sess,Staff,45,40,5,0,0
6943,Wolfson Campus,BSC 1005 - 0047   General Education Biology,0047-LEC Main Sess,Staff,45,40,5,0,0
6944,Wolfson Campus,BSC 1005 - 0048   General Education Biology,0048-LEC Main Sess,Staff,45,41,4,0,0
6945,Wolfson Campus,BSC 1005 - 0049   General Education Biology,0049-LEC Main Sess,Staff,40,37,3,0,0
6979,Wolfson Campus,BSC 1005 - 0050   General Education Biology,0050-LEC Twelve Wk,Staff,45,42,3,0,0
6997,Wolfson Campus,BSC 1005 - 0051   General Education Biology,0051-LEC 1st Mon Sp,Staff,45,33,12,0,0
6946,Wolfson Campus,BSC 1005 - 0052   General Education Biology,0052-LEC Main Sess,Staff,30,27,3,0,0
6947,Wolfson Campus,BSC 1005 - 0053   General Education Biology,0053-LEC Main Sess,Staff,30,25,5,0,0
6992,Wolfson Campus,BSC 1005 - 0054   General Education Biology,0054-LEC Conversion,Staff,30,29,1,0,0
6948,Wolfson Campus,BSC 1005 - 0055   General Education Biology,0055-LEC Main Sess,Staff,30,27,3,0,0
6949,Wolfson Campus,BSC 1005 - 0056   General Education Biology,0056-LEC Main Sess,Staff,30,29,1,0,0
6950,Wolfson Campus,BSC 1005 - 0057   General Education Biology,0057-LEC Main Sess,Staff,30,25,5,0,0
6951,Wolfson Campus,BSC 1005 - 0058   General Education Biology,0058-LEC Main Sess,Staff,30,29,1,0,0
6952,Wolfson Campus,BSC 1005 - 0059   General Education Biology,0059-LEC Main Sess,Staff,30,28,2,0,0
6953,Wolfson Campus,BSC 1005 - 0060   General Education Biology,0060-LEC Main Sess,Staff,30,22,8,0,0
6954,Wolfson Campus,BSC 1005 - 0061   General Education Biology,0061-LEC Main Sess,Staff,30,25,5,0,0
6955,Wolfson Campus,BSC 1005 - 0062   General Education Biology,0062-LEC Main Sess,Staff,30,28,2,0,0
6978,Homestead Campus,BSC 1005 - 0063   General Education Biology,0063-LEC Twelve Wk,Staff,39,38,1,0,0
6956,Homestead Campus,BSC 1005 - 0064   General Education Biology,0064-LEC Main Sess,Staff,39,32,7,0,0
6977,Homestead Campus,BSC 1005 - 0065   General Education Biology,0065-LEC Twelve Wk,Staff,39,31,8,0,0
6957,InterAmerican Campus,BSC 1005 - 0066   General Education Biology,0066-LEC Main Sess,Staff,35,32,3,0,0
6958,InterAmerican Campus,BSC 1005 - 0067   General Education Biology,0067-LEC Main Sess,Staff,38,29,9,0,0
6959,InterAmerican Campus,BSC 1005 - 0068   General Education Biology,0068-LEC Main Sess,Staff,40,37,3,0,0
6976,InterAmerican Campus,BSC 1005 - 0069   General Education Biology,0069-LEC Twelve Wk,Staff,40,23,17,0,0
6996,InterAmerican Campus,BSC 1005 - 0070   General Education Biology,0070-LEC 1st Mon Sp,Staff,38,26,12,0,0
6960,InterAmerican Campus,BSC 1005 - 0071   General Education Biology,0071-LEC Main Sess,Staff,35,29,6,0,0
6961,Hialeah Campus,BSC 1005 - 0072   General Education Biology,0072-LEC Main Sess,Staff,33,29,4,0,0
6963,Hialeah Campus,BSC 1005 - 0074   General Education Biology,0074-LEC Main Sess,Staff,35,24,11,0,0
6964,Hialeah Campus,BSC 1005 - 0075   General Education Biology,0075-LEC Main Sess,Staff,33,32,1,0,0
6965,Hialeah Campus,BSC 1005 - 0076   General Education Biology,0076-LEC Main Sess,Staff,35,34,1,0,0
6967,Hialeah Campus,BSC 1005 - 0078   General Education Biology,0078-LEC Main Sess,Staff,35,33,2,0,0
6968,Hialeah Campus,BSC 1005 - 0079   General Education Biology,0079-LEC Main Sess,Staff,33,32,1,0,0
6969,Hialeah Campus,BSC 1005 - 0080   General Education Biology,0080-LEC Main Sess,Staff,33,32,1,0,0
6990,West Campus,BSC 1005 - 0081   General Education Biology,0081-LEC Conversion,Staff,35,15,20,0,0
6971,West Campus,BSC 1005 - 0083   General Education Biology,0083-LEC Main Sess,Staff,35,0,35,0,0
6972,West Campus,BSC 1005 - 0084   General Education Biology,0084-LEC Main Sess,Staff,35,10,25,0,0
6981,West Campus,BSC 1005 - 0085   General Education Biology,0085-LEC Twelve Wk,Staff,30,0,30,0,0
6973,West Campus,BSC 1005 - 0087   General Education Biology,0087-LEC Main Sess,Staff,35,19,16,0,0
6974,West Campus,BSC 1005 - 0088   General Education Biology,0088-LEC Main Sess,Staff,35,9,26,0,0
6975,West Campus,BSC 1005 - 0089   General Education Biology,0089-LEC Main Sess,Staff,35,0,35,0,0
6994,West Campus,BSC 1005 - 0090   General Education Biology,0090-LEC Conversion,Staff,35,32,3,0,0
9866,North Campus,EDF 1005 - 0001   Introduction To The Teaching Profession,0001-LEC Main Sess,Staff,30,28,2,0,0
9867,North Campus,EDF 1005 - 0002   Introduction To The Teaching Profession,0002-LEC Main Sess,Staff,30,26,4,0,0
9881,North Campus,EDF 1005 - 0003   Introduction To The Teaching Profession,0003-LEC Eight Wk 2,Staff,30,0,30,0,0
9873,Kendall Campus,EDF 1005 - 0005   Introduction To The Teaching Profession,0005-LEC Main Sess,Staff,36,34,2,0,0
9880,Kendall Campus,EDF 1005 - 0006   Introduction To The Teaching Profession,0006-LEC Eight Wk 2,Staff,30,11,19,0,0
9874,Kendall Campus,EDF 1005 - 0007   Introduction To The Teaching Profession,0007-LEC Main Sess,Staff,36,34,2,0,0
9883,Kendall Campus,EDF 1005 - 0008   Introduction To The Teaching Profession,0008-LEC Conversion,Staff,35,32,3,0,0
9876,Wolfson Campus,EDF 1005 - 0010   Introduction To The Teaching Profession,0010-LEC Main Sess,Staff,30,27,3,0,0
9877,Wolfson Campus,EDF 1005 - 0011   Introduction To The Teaching Profession,0011-LEC Main Sess,Staff,30,26,4,0,0
9878,Wolfson Campus,EDF 1005 - 0012   Introduction To The Teaching Profession,0012-LEC Main Sess,Staff,30,27,3,0,0
9879,Homestead Campus,EDF 1005 - 0013   Introduction To The Teaching Profession,0013-LEC Main Sess,Staff,30,0,30,0,0
9884,InterAmerican Campus,EDF 1005 - 0014   Introduction To The Teaching Profession,0014-LEC Weekend,Staff,25,22,3,0,0
9871,InterAmerican Campus,EDF 1005 - 0015   Introduction To The Teaching Profession,0015-LEC Main Sess,Staff,25,21,4,0,0
9870,InterAmerican Campus,EDF 1005 - 0016   Introduction To The Teaching Profession,0016-LEC Main Sess,Staff,25,18,7,0,0
9869,InterAmerican Campus,EDF 1005 - 0017   Introduction To The Teaching Profession,0017-LEC Main Sess,Staff,25,0,25,0,0
9868,InterAmerican Campus,EDF 1005 - 0018   Introduction To The Teaching Profession,0018-LEC Main Sess,Staff,30,23,7,0,0
9882,Hialeah Campus,EDF 1005 - 0019   Introduction To The Teaching Profession,0019-LEC Eight Wk 2,Staff,25,0,25,0,0
6100,North Campus,BSC 1005L - 0001   General Education Biology Laboratory,0001-LAB Main Sess,Staff,24,23,1,0,0
6115,North Campus,BSC 1005L - 0002   General Education Biology Laboratory,0002-LAB 1st Mon Sp,Staff,24,0,24,0,0
6114,North Campus,BSC 1005L - 0003   General Education Biology Laboratory,0003-LAB 1st Mon Sp,Staff,24,0,24,0,0
6113,North Campus,BSC 1005L - 0004   General Education Biology Laboratory,0004-LAB 1st Mon Sp,Staff,24,15,9,0,0
6108,Kendall Campus,BSC 1005L - 0006   General Education Biology Laboratory,0006-LAB Main Sess,Staff,24,20,4,0,0
6109,Kendall Campus,BSC 1005L - 0007   General Education Biology Laboratory,0007-LAB Main Sess,Staff,24,9,15,0,0
6110,Kendall Campus,BSC 1005L - 0008   General Education Biology Laboratory,0008-LAB Main Sess,Staff,4,0,4,0,0
6107,Kendall Campus,BSC 1005L - 0009   General Education Biology Laboratory,0009-LAB Main Sess,Staff,24,9,15,0,0
6116,Kendall Campus,BSC 1005L - 0010   General Education Biology Laboratory,0010-LAB 1st Mon Sp,Staff,24,6,18,0,0
6106,Kendall Campus,BSC 1005L - 0011   General Education Biology Laboratory,0011-LAB Main Sess,Staff,24,22,2,0,0
6105,Kendall Campus,BSC 1005L - 0012   General Education Biology Laboratory,0012-LAB Main Sess,Staff,24,22,2,0,0
6104,Kendall Campus,BSC 1005L - 0013   General Education Biology Laboratory,0013-LAB Main Sess,Staff,24,0,24,0,0
6112,Kendall Campus,BSC 1005L - 0014   General Education Biology Laboratory,0014-LAB Twelve Wk,Staff,24,13,11,0,0
6103,Wolfson Campus,BSC 1005L - 0015   General Education Biology Laboratory,0015-LAB Main Sess,Staff,22,10,12,0,0
6102,Wolfson Campus,BSC 1005L - 0016   General Education Biology Laboratory,0016-LAB Main Sess,Staff,22,10,12,0,0
6117,Wolfson Campus,BSC 1005L - 0017   General Education Biology Laboratory,0017-LAB Weekend,Staff,22,16,6,0,0
6111,Homestead Campus,BSC 1005L - 0018   General Education Biology Laboratory,0018-LAB Twelve Wk,Staff,24,8,16,0,0
7190,North Campus,BAN 1004 - 0001   Principles Of Banking,0001-LEC Conversion,Staff,30,14,16,0,0
7188,Wolfson Campus,BAN 1004 - 0002   Principles Of Banking,0002-LEC Conversion,Staff,30,5,25,0,0
7189,Homestead Campus,BAN 1004 - 0003   Principles Of Banking,0003-LEC Conversion,Staff,30,12,18,0,0
8750,Kendall Campus,PHY 1004 - 0002   Physics With Applications 1,0002-LEC Main Sess,Staff,30,25,5,0,0
8753,Kendall Campus,PHY 1004 - 0003   Physics With Applications 1,0003-LEC Main Sess,Staff,48,46,2,0,0
8939,Kendall Campus,PHY 1004L - 0002   Physics With Applications 1 Lab,0002-LAB Main Sess,Staff,18,0,18,0,0
8942,Kendall Campus,PHY 1004L - 0003   Physics With Applications 1 Lab,0003-LAB 1st Mon Sp,Staff,21,20,1,0,0
8940,Kendall Campus,PHY 1004L - 0004   Physics With Applications 1 Lab,0004-LAB Conversion,Staff,21,20,1,0,0
8937,Kendall Campus,PHY 1004L - 0005   Physics With Applications 1 Lab,0005-LAB Main Sess,Staff,21,20,1,0,0
8941,Kendall Campus,PHY 1004L - 0006   Physics With Applications 1 Lab,0006-LAB Conversion,Staff,21,18,3,0,0
8943,Kendall Campus,PHY 1004L - 0007   Physics With Applications 1 Lab,0007-LAB 1st Mon Sp,Staff,21,20,1,0,0
16376,North Campus,MUT 1003 - 0002   Fundamentals Of Music Theory Lab,0002-LAB Main Sess,Staff,20,13,7,0,0
16385,North Campus,MUT 1003 - 0003   Fundamentals Of Music Theory Lab,0003-LAB Twelve Wk,Staff,20,0,20,0,0
16377,Kendall Campus,MUT 1003 - 0004   Fundamentals Of Music Theory Lab,0004-LAB Main Sess,Staff,15,11,4,0,0
16378,Kendall Campus,MUT 1003 - 0005   Fundamentals Of Music Theory Lab,0005-LAB Main Sess,Staff,18,9,9,0,0
16379,Kendall Campus,MUT 1003 - 0006   Fundamentals Of Music Theory Lab,0006-LAB Main Sess,Staff,18,17,1,0,0
16380,Kendall Campus,MUT 1003 - 0007   Fundamentals Of Music Theory Lab,0007-LAB Main Sess,Staff,18,13,5,0,0
16382,Kendall Campus,MUT 1003 - 0008   Fundamentals Of Music Theory Lab,0008-LAB Main Sess,Staff,16,11,5,0,0
16383,Wolfson Campus,MUT 1003 - 0009   Fundamentals Of Music Theory Lab,0009-LAB Main Sess,Staff,15,11,4,0,0
16384,Wolfson Campus,MUT 1003 - 0010   Fundamentals Of Music Theory Lab,0010-LAB Main Sess,Staff,15,9,6,0,0
16381,West Campus,MUT 1003 - 0011   Fundamentals Of Music Theory Lab,0011-LAB Main Sess,Staff,35,0,35,0,0
16386,West Campus,MUT 1003 - 0012   Fundamentals Of Music Theory Lab,0012-LAB Twelve Wk,Staff,30,0,30,0,0
7179,North Campus,AST 1002 - 0001   Descriptive Astronomy,0001-LEC 1st Mon Sp,Staff,40,25,15,0,0
7171,Kendall Campus,AST 1002 - 0002   Descriptive Astronomy,0002-LEC Main Sess,Staff,110,108,2,0,0
7172,Kendall Campus,AST 1002 - 0003   Descriptive Astronomy,0003-LEC Main Sess,Staff,58,55,3,0,0
7173,Kendall Campus,AST 1002 - 0004   Descriptive Astronomy,0004-LEC Main Sess,Staff,60,57,3,0,0
7174,Wolfson Campus,AST 1002 - 0005   Descriptive Astronomy,0005-LEC Main Sess,Staff,45,41,4,0,0
7175,Wolfson Campus,AST 1002 - 0006   Descriptive Astronomy,0006-LEC Main Sess,Staff,45,40,5,0,0
7176,Homestead Campus,AST 1002 - 0007   Descriptive Astronomy,0007-LEC Main Sess,Staff,39,0,39,0,0
7177,Homestead Campus,AST 1002 - 0008   Descriptive Astronomy,0008-LEC Main Sess,Staff,39,23,16,0,0
7178,InterAmerican Campus,AST 1002 - 0009   Descriptive Astronomy,0009-LEC Main Sess,Staff,30,18,12,0,0
15292,North Campus,IDH 1002 - 0001   Honors Leadership Seminar 2,0001-LEC Main Sess,Staff,20,18,2,0,0
15293,North Campus,IDH 1002 - 0002   Honors Leadership Seminar 2,0002-LEC Main Sess,Staff,20,15,5,0,0
15298,North Campus,IDH 1002 - 0004   Honors Leadership Seminar 2,0004-LEC Main Sess,Staff,20,14,6,0,0
15299,Kendall Campus,IDH 1002 - 0005   Honors Leadership Seminar 2,0005-LEC Main Sess,Staff,25,24,1,0,0
15301,Kendall Campus,IDH 1002 - 0007   Honors Leadership Seminar 2,0007-LEC Main Sess,Staff,25,0,25,0,0
15302,Kendall Campus,IDH 1002 - 0008   Honors Leadership Seminar 2,0008-LEC Main Sess,Staff,25,23,2,0,0
15306,Wolfson Campus,IDH 1002 - 0012   Honors Leadership Seminar 2,0012-LEC Conversion,Staff,18,17,1,0,0
15296,InterAmerican Campus,IDH 1002 - 0013   Honors Leadership Seminar 2,0013-LEC Main Sess,Staff,25,24,1,0,0
15295,InterAmerican Campus,IDH 1002 - 0014   Honors Leadership Seminar 2,0014-LEC Main Sess,Staff,25,14,11,0,0
15294,InterAmerican Campus,IDH 1002 - 0015   Honors Leadership Seminar 2,0015-LEC Main Sess,Staff,25,12,13,0,0
16746,North Campus,MSL 1002 - 0001   First Year Basic Army Rotc,0001-LEC Main Sess,Staff,30,6,24,0,0
16747,Kendall Campus,MSL 1002 - 0002   First Year Basic Army Rotc,0002-LEC Main Sess,Staff,20,3,17,0,0
16748,Kendall Campus,MSL 1002 - 0003   First Year Basic Army Rotc,0003-LEC Conversion,Staff,24,13,11,0,0
13001,Wolfson Campus,NUR 1002 - 0001   Transition To Professional Nursing,0001-LEC Main Sess,Staff,30,28,2,0,0
13000,Wolfson Campus,NUR 1002 - 0002   Transition To Professional Nursing,0002-LEC Main Sess,Staff,30,16,14,0,0
13003,Medical Campus,NUR 1002 - 0003   Transition To Professional Nursing,0003-LEC Conversion,Staff,30,19,11,0,0
13002,Medical Campus,NUR 1002 - 0005   Transition To Professional Nursing,0005-LEC Conversion,Staff,25,0,25,0,0
5388,Kendall Campus,AST 1002L - 0001   Descriptive Astronomy Laboratory,0001-LAB 1st Mon Sp,Staff,15,8,7,0,0
11661,Medical Campus,NUR 1002L - 0001   Transition To Professional Nursing Laboratory,0001-CLN Conversion,Staff,10,7,3,0,0
11668,Medical Campus,NUR 1002L - 0004   Transition To Professional Nursing Laboratory,0004-CLN Conversion,Staff,10,8,2,0,0
11663,Medical Campus,NUR 1002L - 0005   Transition To Professional Nursing Laboratory,0005-CLN Conversion,Staff,8,7,1,0,0
11672,Medical Campus,NUR 1002L - 0007   Transition To Professional Nursing Laboratory,0007-CLN Conversion,Staff,8,0,8,0,0
11669,Medical Campus,NUR 1002L - 0008   Transition To Professional Nursing Laboratory,0008-CLN Conversion,Staff,10,0,10,0,0
11675,Medical Campus,NUR 1002L - 0010   Transition To Professional Nursing Laboratory,0010-CLN Conversion,Staff,8,7,1,0,0
11673,Medical Campus,NUR 1002L - 0012   Transition To Professional Nursing Laboratory,0012-CLN Conversion,Staff,8,0,8,0,0
11667,Medical Campus,NUR 1002L - 0014   Transition To Professional Nursing Laboratory,0014-CLN Conversion,Staff,10,9,1,0,0
11674,Medical Campus,NUR 1002L - 0015   Transition To Professional Nursing Laboratory,0015-CLN Conversion,Staff,8,7,1,0,0
11671,Medical Campus,NUR 1002L - 0016   Transition To Professional Nursing Laboratory,0016-CLN Conversion,Staff,10,0,10,0,0
11660,Medical Campus,NUR 1002L - 0017   Transition To Professional Nursing Laboratory,0017-CLN Conversion,Staff,8,0,8,0,0
14486,North Campus,EEC 1001 - 0001   Introduction To Early Childhood Infant/Toddler Education,0001-LEC Conversion,Staff,30,0,30,0,0
14484,North Campus,EEC 1001 - 0002   Introduction To Early Childhood Infant/Toddler Education,0002-LEC Conversion,Staff,25,0,25,0,0
14483,North Campus,EEC 1001 - 0003   Introduction To Early Childhood Infant/Toddler Education,0003-LEC Twelve Wk,Staff,30,15,15,0,0
14479,North Campus,EEC 1001 - 0004   Introduction To Early Childhood Infant/Toddler Education,0004-LEC Main Sess,Staff,30,0,30,0,0
14482,Kendall Campus,EEC 1001 - 0005   Introduction To Early Childhood Infant/Toddler Education,0005-LEC Twelve Wk,Staff,30,15,15,0,0
14485,Kendall Campus,EEC 1001 - 0006   Introduction To Early Childhood Infant/Toddler Education,0006-LEC Conversion,Staff,30,16,14,0,0
14480,Kendall Campus,EEC 1001 - 0007   Introduction To Early Childhood Infant/Toddler Education,0007-LEC Main Sess,Staff,30,0,30,0,0
14478,Homestead Campus,EEC 1001 - 0008   Introduction To Early Childhood Infant/Toddler Education,0008-LEC Main Sess,Staff,30,0,30,0,0
14481,Homestead Campus,EEC 1001 - 0009   Introduction To Early Childhood Infant/Toddler Education,0009-LEC Twelve Wk,Staff,30,11,19,0,0
14547,North Campus,EVR 1001 - 0001   Introduction To Environmental Sciences,0001-LEC Twelve Wk,Staff,30,0,30,0,0
14533,North Campus,EVR 1001 - 0002   Introduction To Environmental Sciences,0002-LEC Main Sess,Staff,30,0,30,0,0
14551,North Campus,EVR 1001 - 0003   Introduction To Environmental Sciences,0003-LEC Conversion,Staff,24,0,24,0,0
14546,North Campus,EVR 1001 - 0004   Introduction To Environmental Sciences,0004-LEC Twelve Wk,Staff,24,16,8,0,0
14534,Kendall Campus,EVR 1001 - 0005   Introduction To Environmental Sciences,0005-LEC Main Sess,Staff,30,24,6,0,0
14542,Kendall Campus,EVR 1001 - 0006   Introduction To Environmental Sciences,0006-LEC Main Sess,Staff,30,9,21,0,0
14543,Kendall Campus,EVR 1001 - 0007   Introduction To Environmental Sciences,0007-LEC Main Sess,Staff,30,0,30,0,0
14545,Kendall Campus,EVR 1001 - 0008   Introduction To Environmental Sciences,0008-LEC Twelve Wk,Staff,30,17,13,0,0
14541,Kendall Campus,EVR 1001 - 0009   Introduction To Environmental Sciences,0009-LEC Main Sess,Staff,30,19,11,0,0
14540,Kendall Campus,EVR 1001 - 0010   Introduction To Environmental Sciences,0010-LEC Main Sess,Staff,30,28,2,0,0
14539,Kendall Campus,EVR 1001 - 0011   Introduction To Environmental Sciences,0011-LEC Main Sess,Staff,30,13,17,0,0
14538,Kendall Campus,EVR 1001 - 0012   Introduction To Environmental Sciences,0012-LEC Main Sess,Staff,30,0,30,0,0
14544,Kendall Campus,EVR 1001 - 0013   Introduction To Environmental Sciences,0013-LEC Twelve Wk,Staff,30,12,18,0,0
14537,Wolfson Campus,EVR 1001 - 0014   Introduction To Environmental Sciences,0014-LEC Main Sess,Staff,45,0,45,0,0
14536,Wolfson Campus,EVR 1001 - 0015   Introduction To Environmental Sciences,0015-LEC Main Sess,Staff,45,13,32,0,0
14549,Homestead Campus,EVR 1001 - 0016   Introduction To Environmental Sciences,0016-LEC Eight Wk 2,Staff,39,28,11,0,0
14548,Homestead Campus,EVR 1001 - 0017   Introduction To Environmental Sciences,0017-LEC Eight Wk 2,Staff,39,0,39,0,0
14550,InterAmerican Campus,EVR 1001 - 0018   Introduction To Environmental Sciences,0018-LEC Eight Wk 2,Staff,30,0,30,0,0
14535,West Campus,EVR 1001 - 0019   Introduction To Environmental Sciences,0019-LEC Main Sess,Staff,30,0,30,0,0
14638,Wolfson Campus,HUS 1001 - 0001   Introduction To Human Services,0001-LEC Main Sess,Staff,35,0,35,0,0
14639,Wolfson Campus,HUS 1001 - 0002   Introduction To Human Services,0002-LEC Conversion,Staff,35,16,19,0,0
12762,North Campus,LIS 1001 - 0001   Library Research,0001-LEC Conversion,Staff,30,0,30,0,0
12760,Wolfson Campus,LIS 1001 - 0002   Library Research,0002-LEC Main Sess,Staff,25,0,25,0,0
12761,Hialeah Campus,LIS 1001 - 0003   Library Research,0003-LEC Twelve Wk,Staff,25,0,25,0,0
12265,North Campus,MUT 1001 - 0001   Fundamentals Of Music Theory,0001-LEC Twelve Wk,Staff,20,0,20,0,0
12256,North Campus,MUT 1001 - 0003   Fundamentals Of Music Theory,0003-LEC Main Sess,Staff,20,13,7,0,0
12257,Kendall Campus,MUT 1001 - 0004   Fundamentals Of Music Theory,0004-LEC Main Sess,Staff,18,16,2,0,0
12258,Kendall Campus,MUT 1001 - 0005   Fundamentals Of Music Theory,0005-LEC Main Sess,Staff,30,10,20,0,0
12259,Kendall Campus,MUT 1001 - 0006   Fundamentals Of Music Theory,0006-LEC Main Sess,Staff,19,18,1,0,0
12260,Kendall Campus,MUT 1001 - 0007   Fundamentals Of Music Theory,0007-LEC Main Sess,Staff,15,14,1,0,0
12262,Kendall Campus,MUT 1001 - 0008   Fundamentals Of Music Theory,0008-LEC Main Sess,Staff,16,15,1,0,0
12263,Wolfson Campus,MUT 1001 - 0009   Fundamentals Of Music Theory,0009-LEC Main Sess,Staff,15,12,3,0,0
12264,Wolfson Campus,MUT 1001 - 0010   Fundamentals Of Music Theory,0010-LEC Main Sess,Staff,15,7,8,0,0
12261,West Campus,MUT 1001 - 0011   Fundamentals Of Music Theory,0011-LEC Main Sess,Staff,35,0,35,0,0
12266,West Campus,MUT 1001 - 0012   Fundamentals Of Music Theory,0012-LEC Twelve Wk,Staff,30,0,30,0,0
10779,North Campus,OCE 1001 - 0001   Introduction To Oceanography,0001-LEC Main Sess,Staff,32,0,32,0,0
10780,North Campus,OCE 1001 - 0002   Introduction To Oceanography,0002-LEC Main Sess,Staff,32,0,32,0,0
10786,Kendall Campus,OCE 1001 - 0003   Introduction To Oceanography,0003-LEC Main Sess,Staff,49,32,17,0,0
10787,Kendall Campus,OCE 1001 - 0004   Introduction To Oceanography,0004-LEC Main Sess,Staff,49,46,3,0,0
10788,Wolfson Campus,OCE 1001 - 0005   Introduction To Oceanography,0005-LEC Main Sess,Staff,45,42,3,0,0
10789,Wolfson Campus,OCE 1001 - 0006   Introduction To Oceanography,0006-LEC Main Sess,Staff,45,44,1,0,0
10790,Wolfson Campus,OCE 1001 - 0007   Introduction To Oceanography,0007-LEC Main Sess,Staff,45,44,1,0,0
10791,Wolfson Campus,OCE 1001 - 0008   Introduction To Oceanography,0008-LEC Main Sess,Staff,45,25,20,0,0
10792,Wolfson Campus,OCE 1001 - 0009   Introduction To Oceanography,0009-LEC Main Sess,Staff,30,29,1,0,0
10793,Wolfson Campus,OCE 1001 - 0010   Introduction To Oceanography,0010-LEC Main Sess,Staff,30,29,1,0,0
10794,Wolfson Campus,OCE 1001 - 0011   Introduction To Oceanography,0011-LEC Main Sess,Staff,30,28,2,0,0
10802,Wolfson Campus,OCE 1001 - 0015   Introduction To Oceanography,0015-LEC Conversion,Staff,30,29,1,0,0
10784,Wolfson Campus,OCE 1001 - 0016   Introduction To Oceanography,0016-LEC Main Sess,Staff,30,28,2,0,0
10781,Homestead Campus,OCE 1001 - 0019   Introduction To Oceanography,0019-LEC Main Sess,Staff,39,31,8,0,0
10798,Homestead Campus,OCE 1001 - 0020   Introduction To Oceanography,0020-LEC Twelve Wk,Staff,39,0,39,0,0
10799,Homestead Campus,OCE 1001 - 0021   Introduction To Oceanography,0021-LEC Eight Wk 1,Staff,39,0,39,0,0
10800,Homestead Campus,OCE 1001 - 0022   Introduction To Oceanography,0022-LEC Eight Wk 1,Staff,39,22,17,0,0
10801,Homestead Campus,OCE 1001 - 0023   Introduction To Oceanography,0023-LEC Eight Wk 1,Staff,39,0,39,0,0
10797,Homestead Campus,OCE 1001 - 0024   Introduction To Oceanography,0024-LEC Twelve Wk,Staff,39,35,4,0,0
14552,North Campus,EVR 1001L - 0001   Introduction To Environmental Science Laboratory,0001-LAB Main Sess,Staff,24,0,24,0,0
5991,North Campus,ARH 1000 - 0002   Art Appreciation,0002-LEC Main Sess,Staff,35,27,8,0,0
6006,North Campus,ARH 1000 - 0003   Art Appreciation,0003-LEC Main Sess,Staff,35,20,15,0,0
6025,North Campus,ARH 1000 - 0004   Art Appreciation,0004-LEC Twelve Wk,Staff,30,19,11,0,0
6026,North Campus,ARH 1000 - 0005   Art Appreciation,0005-LEC Twelve Wk,Staff,30,18,12,0,0
6007,North Campus,ARH 1000 - 0006   Art Appreciation,0006-LEC Main Sess,Staff,35,12,23,0,0
6008,North Campus,ARH 1000 - 0007   Art Appreciation,0007-LEC Main Sess,Staff,30,0,30,0,0
6032,North Campus,ARH 1000 - 0008   Art Appreciation,0008-LEC Conversion,Staff,30,0,30,0,0
6033,North Campus,ARH 1000 - 0009   Art Appreciation,0009-LEC Conversion,Staff,30,0,30,0,0
6009,North Campus,ARH 1000 - 0010   Art Appreciation,0010-LEC Main Sess,Staff,30,0,30,0,0
6027,North Campus,ARH 1000 - 0011   Art Appreciation,0011-LEC Twelve Wk,Staff,30,0,30,0,0
6011,Kendall Campus,ARH 1000 - 0013   Art Appreciation,0013-LEC Main Sess,Staff,37,11,26,0,0
6012,Kendall Campus,ARH 1000 - 0014   Art Appreciation,0014-LEC Main Sess,Staff,36,15,21,0,0
6013,Kendall Campus,ARH 1000 - 0015   Art Appreciation,0015-LEC Main Sess,Staff,3,0,3,0,0
6031,Kendall Campus,ARH 1000 - 0016   Art Appreciation,0016-LEC Twelve Wk,Staff,36,0,36,0,0
6030,Kendall Campus,ARH 1000 - 0017   Art Appreciation,0017-LEC Twelve Wk,Staff,30,19,11,0,0
6014,Kendall Campus,ARH 1000 - 0018   Art Appreciation,0018-LEC Main Sess,Staff,37,12,25,0,0
6015,Kendall Campus,ARH 1000 - 0019   Art Appreciation,0019-LEC Main Sess,Staff,40,35,5,0,0
6016,Kendall Campus,ARH 1000 - 0020   Art Appreciation,0020-LEC Main Sess,Staff,37,33,4,0,0
6017,Kendall Campus,ARH 1000 - 0021   Art Appreciation,0021-LEC Main Sess,Staff,40,37,3,0,0
5992,Kendall Campus,ARH 1000 - 0022   Art Appreciation,0022-LEC Main Sess,Staff,40,0,40,0,0
6018,Kendall Campus,ARH 1000 - 0023   Art Appreciation,0023-LEC Main Sess,Staff,40,15,25,0,0
6019,Kendall Campus,ARH 1000 - 0024   Art Appreciation,0024-LEC Main Sess,Staff,30,14,16,0,0
6029,Kendall Campus,ARH 1000 - 0025   Art Appreciation,0025-LEC Twelve Wk,Staff,1,0,1,0,0
6028,Kendall Campus,ARH 1000 - 0026   Art Appreciation,0026-LEC Twelve Wk,Staff,40,38,2,0,0
6020,Kendall Campus,ARH 1000 - 0027   Art Appreciation,0027-LEC Main Sess,Staff,35,0,35,0,0
6021,Kendall Campus,ARH 1000 - 0028   Art Appreciation,0028-LEC Main Sess,Staff,30,26,4,0,0
6005,Kendall Campus,ARH 1000 - 0029   Art Appreciation,0029-LEC Main Sess,Staff,38,23,15,0,0
6004,Kendall Campus,ARH 1000 - 0030   Art Appreciation,0030-LEC Main Sess,Staff,38,0,38,0,0
6036,Kendall Campus,ARH 1000 - 0031   Art Appreciation,0031-LEC Weekend,Staff,37,11,26,0,0
6023,Kendall Campus,ARH 1000 - 0032   Art Appreciation,0032-LEC Twelve Wk,Staff,36,19,17,0,0
6003,Kendall Campus,ARH 1000 - 0033   Art Appreciation,0033-LEC Main Sess,Staff,35,0,35,0,0
6002,Kendall Campus,ARH 1000 - 0034   Art Appreciation,0034-LEC Main Sess,Staff,37,20,17,0,0
6034,Wolfson Campus,ARH 1000 - 0035   Art Appreciation,0035-LEC 1st Mon Sp,Staff,45,32,13,0,0
6001,Wolfson Campus,ARH 1000 - 0036   Art Appreciation,0036-LEC Main Sess,Staff,45,0,45,0,0
6000,Wolfson Campus,ARH 1000 - 0037   Art Appreciation,0037-LEC Main Sess,Staff,45,36,9,0,0
6022,Wolfson Campus,ARH 1000 - 0038   Art Appreciation,0038-LEC Twelve Wk,Staff,30,29,1,0,0
5999,Homestead Campus,ARH 1000 - 0039   Art Appreciation,0039-LEC Main Sess,Staff,39,0,39,0,0
5998,Homestead Campus,ARH 1000 - 0040   Art Appreciation,0040-LEC Main Sess,Staff,39,35,4,0,0
5997,Homestead Campus,ARH 1000 - 0041   Art Appreciation,0041-LEC Main Sess,Staff,39,21,18,0,0
5996,InterAmerican Campus,ARH 1000 - 0042   Art Appreciation,0042-LEC Main Sess,Staff,35,13,22,0,0
6035,Hialeah Campus,ARH 1000 - 0043   Art Appreciation,0043-LEC 1st Mon Sp,Staff,33,32,1,0,0
5995,Hialeah Campus,ARH 1000 - 0044   Art Appreciation,0044-LEC Main Sess,Staff,30,29,1,0,0
5994,West Campus,ARH 1000 - 0045   Art Appreciation,0045-LEC Main Sess,Staff,35,0,35,0,0
5993,West Campus,ARH 1000 - 0046   Art Appreciation,0046-LEC Main Sess,Staff,35,0,35,0,0
6024,West Campus,ARH 1000 - 0047   Art Appreciation,0047-LEC Twelve Wk,Staff,30,15,15,0,0
9484,North Campus,CJC 1000 - 0001   Introduction To Corrections,0001-LEC 1st Mon Sp,Staff,40,36,4,0,0
9476,North Campus,CJC 1000 - 0002   Introduction To Corrections,0002-LEC Main Sess,Staff,40,28,12,0,0
9477,North Campus,CJC 1000 - 0003   Introduction To Corrections,0003-LEC Main Sess,Staff,40,0,40,0,0
9482,North Campus,CJC 1000 - 0004   Introduction To Corrections,0004-LEC Twelve Wk,Staff,40,0,40,0,0
9481,Wolfson Campus,CJC 1000 - 0005   Introduction To Corrections,0005-LEC Twelve Wk,Staff,34,17,17,0,0
9478,Wolfson Campus,CJC 1000 - 0006   Introduction To Corrections,0006-LEC Main Sess,Staff,30,27,3,0,0
9483,InterAmerican Campus,CJC 1000 - 0007   Introduction To Corrections,0007-LEC Conversion,Staff,30,14,16,0,0
9480,InterAmerican Campus,CJC 1000 - 0008   Introduction To Corrections,0008-LEC Main Sess,Staff,30,0,30,0,0
9479,West Campus,CJC 1000 - 0009   Introduction To Corrections,0009-LEC Main Sess,Staff,30,17,13,0,0
9528,North Campus,CJL 1000 - 0001   Street Law,0001-LEC Main Sess,Staff,40,12,28,0,0
11072,North Campus,EEC 1000 - 0001   Introduction To Early Childhood Education,0001-LEC Main Sess,Staff,30,0,30,0,0
11074,Kendall Campus,EEC 1000 - 0003   Introduction To Early Childhood Education,0003-LEC Main Sess,Staff,30,0,30,0,0
11075,Kendall Campus,EEC 1000 - 0004   Introduction To Early Childhood Education,0004-LEC Main Sess,Staff,30,26,4,0,0
11082,Kendall Campus,EEC 1000 - 0005   Introduction To Early Childhood Education,0005-LEC 1st Mon Sp,Staff,30,23,7,0,0
11076,Kendall Campus,EEC 1000 - 0006   Introduction To Early Childhood Education,0006-LEC Main Sess,Staff,30,27,3,0,0
11077,Wolfson Campus,EEC 1000 - 0007   Introduction To Early Childhood Education,0007-LEC Main Sess,Staff,30,0,30,0,0
11079,Homestead Campus,EEC 1000 - 0008   Introduction To Early Childhood Education,0008-LEC Main Sess,Staff,25,0,25,0,0
11080,Homestead Campus,EEC 1000 - 0009   Introduction To Early Childhood Education,0009-LEC Main Sess,Staff,30,11,19,0,0
11081,Homestead Campus,EEC 1000 - 0010   Introduction To Early Childhood Education,0010-LEC Conversion,Staff,25,15,10,0,0
11078,InterAmerican Campus,EEC 1000 - 0011   Introduction To Early Childhood Education,0011-LEC Main Sess,Staff,30,10,20,0,0
14517,North Campus,ESC 1000 - 0001   General Education Earth Science,0001-LEC Main Sess,Staff,32,20,12,0,0
14518,North Campus,ESC 1000 - 0002   General Education Earth Science,0002-LEC Main Sess,Staff,32,28,4,0,0
14519,North Campus,ESC 1000 - 0003   General Education Earth Science,0003-LEC Main Sess,Staff,32,0,32,0,0
14520,North Campus,ESC 1000 - 0004   General Education Earth Science,0004-LEC Main Sess,Staff,32,0,32,0,0
14521,Kendall Campus,ESC 1000 - 0005   General Education Earth Science,0005-LEC Main Sess,Staff,50,48,2,0,0
14522,Kendall Campus,ESC 1000 - 0006   General Education Earth Science,0006-LEC Main Sess,Staff,50,43,7,0,0
14523,Kendall Campus,ESC 1000 - 0007   General Education Earth Science,0007-LEC Main Sess,Staff,40,39,1,0,0
14524,Kendall Campus,ESC 1000 - 0008   General Education Earth Science,0008-LEC Main Sess,Staff,30,29,1,0,0
14525,Kendall Campus,ESC 1000 - 0009   General Education Earth Science,0009-LEC Main Sess,Staff,39,34,5,0,0
14527,Kendall Campus,ESC 1000 - 0011   General Education Earth Science,0011-LEC Main Sess,Staff,30,0,30,0,0
14532,Kendall Campus,ESC 1000 - 0013   General Education Earth Science,0013-LEC Weekend,Staff,36,34,2,0,0
14529,Wolfson Campus,ESC 1000 - 0014   General Education Earth Science,0014-LEC Main Sess,Staff,45,43,2,0,0
14530,Wolfson Campus,ESC 1000 - 0015   General Education Earth Science,0015-LEC Main Sess,Staff,45,44,1,0,0
14531,Wolfson Campus,ESC 1000 - 0016   General Education Earth Science,0016-LEC Main Sess,Staff,45,43,2,0,0
12141,North Campus,HFT 1000 - 0001   Introduction To Hospitality,0001-LEC Main Sess,Staff,30,17,13,0,0
12142,Kendall Campus,HFT 1000 - 0002   Introduction To Hospitality,0002-LEC Main Sess,Staff,30,26,4,0,0
12150,Kendall Campus,HFT 1000 - 0003   Introduction To Hospitality,0003-LEC 1st Mon Sp,Staff,30,25,5,0,0
12143,Wolfson Campus,HFT 1000 - 0004   Introduction To Hospitality,0004-LEC Main Sess,Staff,30,20,10,0,0
12144,Wolfson Campus,HFT 1000 - 0005   Introduction To Hospitality,0005-LEC Main Sess,Staff,30,0,30,0,0
12145,Wolfson Campus,HFT 1000 - 0006   Introduction To Hospitality,0006-LEC Main Sess,Staff,39,38,1,0,0
12148,Wolfson Campus,HFT 1000 - 0008   Introduction To Hospitality,0008-LEC Main Sess,Staff,30,0,30,0,0
12149,Wolfson Campus,HFT 1000 - 0009   Introduction To Hospitality,0009-LEC Main Sess,Staff,30,0,30,0,0
12151,InterAmerican Campus,HFT 1000 - 0011   Introduction To Hospitality,0011-LEC 1st Mon Sp,Staff,30,6,24,0,0
11212,Medical Campus,HIM 1000 - 0001   Introduction To Health Information Technology,0001-LEC Conversion,Staff,30,19,11,0,0
13218,Medical Campus,RTE 1000 - 0001   Orientation To The Imaging Sciences,0001-LEC Main Sess,Staff,30,29,1,0,0
16462,North Campus,RTV 1000 - 0001   Fundamentals Of Broadcasting,0001-LEC Main Sess,Staff,30,0,30,0,0
16463,North Campus,RTV 1000 - 0002   Fundamentals Of Broadcasting,0002-LEC 1st Mon Sp,Staff,30,12,18,0,0
15716,North Campus,SBM 1000 - 0001   Small Business Management,0001-LEC Conversion,Staff,30,14,16,0,0
15710,North Campus,SBM 1000 - 0002   Small Business Management,0002-LEC Main Sess,Staff,30,20,10,0,0
15711,Kendall Campus,SBM 1000 - 0003   Small Business Management,0003-LEC Main Sess,Staff,35,29,6,0,0
15715,Wolfson Campus,SBM 1000 - 0004   Small Business Management,0004-LEC Conversion,Staff,30,11,19,0,0
15714,Wolfson Campus,SBM 1000 - 0005   Small Business Management,0005-LEC Twelve Wk,Staff,40,21,19,0,0
15712,Wolfson Campus,SBM 1000 - 0006   Small Business Management,0006-LEC Main Sess,Staff,34,20,14,0,0
15713,Wolfson Campus,SBM 1000 - 0007   Small Business Management,0007-LEC Main Sess,Staff,30,27,3,0,0
14085,North Campus,VIC 1000 - 0002   Visual Communications,0002-LEC Main Sess,Staff,25,21,4,0,0
14087,Kendall Campus,VIC 1000 - 0003   Visual Communications,0003-LEC Main Sess,Staff,30,27,3,0,0
14086,West Campus,VIC 1000 - 0004   Visual Communications,0004-LEC Main Sess,Staff,30,0,30,0,0
2079,Kendall Campus,WBMS  367 - 01   What Makes a Successful Manager?,01-LEC Dynamic,Staff,16,0,16,0,0
2075,Kendall Campus,WBMS  364 - 01   Management and Supervision Excellence,01-LEC Dynamic,Staff,16,0,16,0,0
2068,Kendall Campus,WBPD  364 - 01   How to Hire the Right Person,01-LEC Dynamic,Staff,16,0,16,0,0
2009,Wolfson Campus,WBMS  363 - 01   Leadership in Action,01-LEC Dynamic,Staff,25,0,25,0,0
2073,Kendall Campus,WBMS  362 - 01   Leadership Excellence,01-LEC Dynamic,Staff,16,0,16,0,0
2134,InterAmerican Campus,WTCP  335 - 01   The Business of Game Development,01-LEC Dynamic,Staff,16,0,16,0,0
1767,Wolfson Campus,WTCP  334 - 01   Mobile Game Design for iPhone and Android,01-LEC Dynamic,Staff,20,0,20,0,0
2132,InterAmerican Campus,WTCP  333 - 01   Maya Certification Exam,01-LEC Dynamic,Staff,16,0,16,0,0
1300,Homestead Campus,WTCP  332 - 01   Introduction to Programming in Java,01-LEC Dynamic,Staff,25,0,25,0,0
1294,Homestead Campus,WLEP  331 - 01   English Conversation 1,01-LEC Dynamic,Staff,25,0,25,0,0
1295,Homestead Campus,WLEP  331 - 02   English Conversation 1,02-LEC Dynamic,Staff,25,0,25,0,0
2131,InterAmerican Campus,WTCP  331 - 01   Introduction to Game Audio,01-LEC Dynamic,Staff,16,0,16,0,0
1769,Wolfson Campus,WTCP  330 - 01   Game Design: Minecraft 3D,01-LEC Dynamic,Staff,20,0,20,0,0
1171,Kendall Campus,WLEP  329 - 01   English Conversation,01-LEC Dynamic,Staff,25,0,25,0,0
1172,Kendall Campus,WLEP  329 - 02   English Conversation,02-LEC Dynamic,Staff,25,0,25,0,0
2145,InterAmerican Campus,WTCP  328 - 01   Apple iOS Developer Essentials Level 1,01-LEC Dynamic,Staff,16,0,16,0,0
1167,Kendall Campus,WLEP  326 - 01   Coffee and Conversation - High Intermediate,01-LEC Dynamic,Staff,25,0,25,0,0
1168,Kendall Campus,WLEP  326 - 02   Coffee and Conversation - High Intermediate,02-LEC Dynamic,Staff,25,0,25,0,0
1500,Wolfson Campus,WLEP  325 - 01   Business and Professional English,01-LEC Dynamic,Staff,16,0,16,0,0
1481,Wolfson Campus,WLEP  323 - 01   Accent Reduction - Beginners,01-LEC Dynamic,Staff,16,0,16,0,0
1497,Wolfson Campus,WLEP  321 - 01   Accelerated English Conversation Intermediate,01-LEC Dynamic,Staff,16,0,16,0,0
1496,Wolfson Campus,WLEP  320 - 01   Accelerated English Conversation Beginners,01-LEC Dynamic,Staff,16,0,16,0,0
1299,Homestead Campus,WLEP  319 - 01   Academic and Professional English Level 4,01-LEC Dynamic,Staff,25,0,25,0,0
1298,Homestead Campus,WLEP  318 - 01   Academic and Professional English Level 3,01-LEC Dynamic,Staff,25,0,25,0,0
1297,Homestead Campus,WLEP  317 - 01   Academic and Professional English Level 2,01-LEC Dynamic,Staff,25,0,25,0,0
1296,Homestead Campus,WLEP  316 - 01   Academic and Professional English Level 1,01-LEC Dynamic,Staff,25,0,25,0,0
1438,Kendall Campus,WLEP  315 - 01   Conversation (Intermediate),01-LEC Dynamic,Staff,25,0,25,0,0
1439,Kendall Campus,WLEP  315 - 02   Conversation (Intermediate),02-LEC Dynamic,Staff,25,0,25,0,0
3893,Kendall Campus,WBCT  313 - 01   Teaching Students With Autism: Strategies for Success - Online,01-IND OEE,Staff,50,0,50,0,0
1661,Wolfson Campus,WLEP  313 - 01   Reading and Conversation 3,01-LEC Dynamic,Staff,16,0,16,0,0
3892,Kendall Campus,WBCT  312 - 01   Teaching Students With ADHD - Online,01-IND OEE,Staff,50,0,50,0,0
1660,Wolfson Campus,WLEP  312 - 01   Reading and Conversation 2,01-LEC Dynamic,Staff,16,0,16,0,0
3891,Kendall Campus,WBCT  311 - 01   Teaching Science: Grades 4-6 - Online,01-IND OEE,Staff,50,0,50,0,0
1659,Wolfson Campus,WLEP  311 - 01   Reading and Conversation 1,01-LEC Dynamic,Staff,16,0,16,0,0
3890,Kendall Campus,WBCT  310 - 01   Teaching Preschool: A Year of Inspiring Lessons - Online,01-IND OEE,Staff,50,0,50,0,0
2857,North Campus,WBCC  309 - 02   Personal Trainer Education and Certification Preparation with NCSF - Online,02-IND Dynamic,Staff,50,0,50,0,0
3889,Kendall Campus,WBCT  309 - 01   Teaching Math: Grades 4-6 - Online,01-IND OEE,Staff,50,0,50,0,0
1640,InterAmerican Campus,WTAA  309 - 01   QuickBooks Online Accountant,01-LEC Dynamic,Staff,16,0,16,0,0
3888,Kendall Campus,WBCT  308 - 01   Teaching High School Students - Online,01-IND OEE,Staff,50,0,50,0,0
3887,Kendall Campus,WBCT  307 - 01   Teaching ESL/EFL Vocabulary - Online,01-IND OEE,Staff,50,0,50,0,0
3886,Kendall Campus,WBCT  306 - 01   Teaching ESL/EFL Reading - Online,01-IND OEE,Staff,50,0,50,0,0
3873,Kendall Campus,WBCT  305 - 01   Teaching ESL/EFL Grammar - Online,01-IND OEE,Staff,50,0,50,0,0
2275,Kendall Campus,WINS  305 - 01   4-40 Registered Customer Service Representative (RCSR) Designation Course - Online,01-IND OEE,Staff,25,0,25,0,0
2285,Wolfson Campus,WINS  305 - 02   4-40 Registered Customer Service Representative (RCSR) Designation Course - Online,02-IND Dynamic,Staff,30,0,30,0,0
2303,Kendall Campus,WINS  305 - 03   4-40 Registered Customer Service Representative (RCSR) Designation Course - Online,03-IND Dynamic,Staff,25,0,25,0,0
2358,Kendall Campus,WINS  305 - 04   4-40 Registered Customer Service Representative (RCSR) Designation Course - Online,04-IND Dynamic,Staff,25,0,25,0,0
3872,Kendall Campus,WBCT  304 - 01   Teaching Adults Learners - Online,01-IND OEE,Staff,50,0,50,0,0
2365,Kendall Campus,WBFM  304 - 01   Introduction to Stock Options - Online,01-IND OEE,Staff,25,0,25,0,0
3871,Kendall Campus,WBCT  303 - 01   Survival Kit for New Teachers - Online,01-IND OEE,Staff,50,0,50,0,0
3870,Kendall Campus,WBCT  302 - 01   Solving Classroom Discipline Problems II - Online,01-IND OEE,Staff,50,0,50,0,0
2307,Kendall Campus,WINS  302 - 01   2-15 Life· Health and Variable Annuity· State ID# 68459 - Online,01-IND OEE,Staff,25,0,25,0,0
3869,Kendall Campus,WBCT  301 - 01   Solving Classroom Discipline Problems - Online,01-IND OEE,Staff,50,0,50,0,0
3345,Kendall Campus,WTCT  301 - 01   CompTIA Network+ (N10-005) - Online,01-IND OEE,Staff,50,0,50,0,0
3665,North Campus,WTCT  301 - 02   CompTIA Network+ (N10-005) - Online,02-IND Dynamic,Staff,50,0,50,0,0
2566,West Campus,WTBT  300 - 01   Virtualization,01-LEC Dynamic,Staff,16,0,16,0,0
1462,Kendall Campus,WLFL  260 - 01   French Conversation - Intermediate,01-LEC Dynamic,Staff,16,0,16,0,0
1463,Kendall Campus,WLFL  260 - 02   French Conversation - Intermediate,02-LEC Dynamic,Staff,25,0,25,0,0
1451,Kendall Campus,WLFL  259 - 01   French 2,01-LEC Dynamic,Staff,25,0,25,0,0
1449,Kendall Campus,WLFL  258 - 01   French 1,01-LEC Dynamic,Staff,30,0,30,0,0
3863,Kendall Campus,WLFL  253 - 01   Mandarin Chinese 2,01-LEC Dynamic,Staff,20,0,20,0,0
1490,Kendall Campus,WLFL  251 - 01   Temi di Attualitá Italiana,01-LEC Dynamic,Staff,25,0,25,0,0
1492,Kendall Campus,WLFL  251 - 02   Temi di Attualitá Italiana,02-LEC Dynamic,Staff,25,0,25,0,0
3075,Hialeah Campus,WLFL  246 - 01   Spanish Writing for Professionals,01-LEC Dynamic,Staff,30,0,30,0,0
1693,Wolfson Campus,WLFL  245 - 01   Spanish 6 - Intensive,01-LEC Dynamic,Staff,30,0,30,0,0
2195,Wolfson Campus,WLFL  245 - 02   Spanish 6 - Intensive,02-LEC Dynamic,Staff,30,0,30,0,0
1690,Wolfson Campus,WLFL  244 - 01   Spanish 5 - Intensive,01-LEC Dynamic,Staff,30,0,30,0,0
2194,Wolfson Campus,WLFL  244 - 02   Spanish 5 - Intensive,02-LEC Dynamic,Staff,30,0,30,0,0
1485,Kendall Campus,WLFL  243 - 01   Spanish 4 - Intensive,01-LEC Dynamic,Staff,20,0,20,0,0
1687,Wolfson Campus,WLFL  243 - 02   Spanish 4 - Intensive,02-LEC Dynamic,Staff,30,0,30,0,0
2193,Wolfson Campus,WLFL  243 - 03   Spanish 4 - Intensive,03-LEC Dynamic,Staff,30,0,30,0,0
1483,Kendall Campus,WLFL  242 - 01   Spanish 3 - Intensive,01-LEC Dynamic,Staff,25,0,25,0,0
1680,Wolfson Campus,WLFL  242 - 02   Spanish 3 - Intensive,02-LEC Dynamic,Staff,30,0,30,0,0
2192,Wolfson Campus,WLFL  242 - 03   Spanish 3 - Intensive,03-LEC Dynamic,Staff,30,0,30,0,0
1482,Kendall Campus,WLFL  241 - 01   Spanish 2 - Intensive,01-LEC Dynamic,Staff,25,0,25,0,0
1679,Wolfson Campus,WLFL  241 - 02   Spanish 2 - Intensive,02-LEC Dynamic,Staff,30,0,30,0,0
2191,Wolfson Campus,WLFL  241 - 03   Spanish 2 - Intensive,03-LEC Dynamic,Staff,30,0,30,0,0
1477,Kendall Campus,WLFL  240 - 01   Spanish 1 - Intensive,01-LEC Dynamic,Staff,25,0,25,0,0
1478,Kendall Campus,WLFL  240 - 02   Spanish 1 - Intensive,02-LEC Dynamic,Staff,30,0,30,0,0
1677,Wolfson Campus,WLFL  240 - 03   Spanish 1 - Intensive,03-LEC Dynamic,Staff,30,0,30,0,0
2190,Wolfson Campus,WLFL  240 - 04   Spanish 1 - Intensive,04-LEC Dynamic,Staff,30,0,30,0,0
1464,Kendall Campus,WLFL  231 - 01   Spanish for Advanced Students,01-LEC Dynamic,Staff,25,0,25,0,0
1467,Kendall Campus,WLFL  231 - 02   Spanish for Advanced Students,02-LEC Dynamic,Staff,25,0,25,0,0
3856,North Campus,WLFL  229 - 01   Spanish Conversation - Beginners (42 Hours),01-LEC Dynamic,Staff,16,0,16,0,0
3337,Kendall Campus,RLFS  228 - 01   Zumba Latin Dance Aerobics,01-LEC Dynamic,Staff,20,0,20,0,0
3338,Kendall Campus,RLFS  228 - 02   Zumba Latin Dance Aerobics,02-LEC Dynamic,Staff,20,0,20,0,0
1234,Kendall Campus,WLFL  228 - 01   Mandarin Chinese 1,01-LEC Dynamic,Staff,16,0,16,0,0
3333,Kendall Campus,RLFS  227 - 01   Yoga Unlimited,01-LEC Dynamic,Staff,20,0,20,0,0
3335,Kendall Campus,RLFS  227 - 02   Yoga Unlimited,02-LEC Dynamic,Staff,20,0,20,0,0
1695,Wolfson Campus,WLFL  227 - 01   Spanish Conversation Advanced,01-LEC Dynamic,Staff,30,0,30,0,0
2196,Wolfson Campus,WLFL  227 - 02   Spanish Conversation Advanced,02-LEC Dynamic,Staff,30,0,30,0,0
3858,North Campus,WLFL  227 - 03   Spanish Conversation Advanced,03-LEC Dynamic,Staff,16,0,16,0,0
3857,North Campus,WLFL  226 - 01   Spanish Conversation  Intermediate (42 Hours),01-LEC Dynamic,Staff,16,0,16,0,0
3861,North Campus,WLFL  226 - 02   Spanish Conversation  Intermediate (42 Hours),02-LEC Dynamic,Staff,16,0,16,0,0
3862,North Campus,WLFL  226 - 03   Spanish Conversation  Intermediate (42 Hours),03-LEC Dynamic,Staff,16,0,16,0,0
3859,North Campus,WLFL  225 - 01   Spanish Conversation - Beginners (28 Hours),01-LEC Dynamic,Staff,16,0,16,0,0
3860,North Campus,WLFL  225 - 02   Spanish Conversation - Beginners (28 Hours),02-LEC Dynamic,Staff,16,0,16,0,0
1673,Wolfson Campus,WLFL  223 - 01   Spanish 6,01-LEC Dynamic,Staff,30,0,30,0,0
2189,Wolfson Campus,WLFL  223 - 02   Spanish 6,02-LEC Dynamic,Staff,30,0,30,0,0
1672,Wolfson Campus,WLFL  222 - 01   Spanish 5,01-LEC Dynamic,Staff,30,0,30,0,0
2188,Wolfson Campus,WLFL  222 - 02   Spanish 5,02-LEC Dynamic,Staff,30,0,30,0,0
3810,Kendall Campus,RLFS  221 - 01   Tennis for Beginners (Ages 5 - 8),01-LEC Dynamic,Staff,15,0,15,0,0
3811,Kendall Campus,RLFS  221 - 02   Tennis for Beginners (Ages 5 - 8),02-LEC Dynamic,Staff,15,0,15,0,0
1120,Kendall Campus,WLFL  221 - 01   Spanish 4,01-LEC Dynamic,Staff,25,0,25,0,0
1670,Wolfson Campus,WLFL  221 - 02   Spanish 4,02-LEC Dynamic,Staff,30,0,30,0,0
2187,Wolfson Campus,WLFL  221 - 03   Spanish 4,03-LEC Dynamic,Staff,30,0,30,0,0
1118,Kendall Campus,WLFL  220 - 01   Spanish 3,01-LEC Dynamic,Staff,25,0,25,0,0
1669,Wolfson Campus,WLFL  220 - 02   Spanish 3,02-LEC Dynamic,Staff,30,0,30,0,0
2186,Wolfson Campus,WLFL  220 - 03   Spanish 3,03-LEC Dynamic,Staff,30,0,30,0,0
3593,Kendall Campus,WLFL  220 - 04   Spanish 3,04-LEC Dynamic,Staff,20,0,20,0,0
1110,Kendall Campus,WLFL  219 - 01   Spanish 2,01-LEC Dynamic,Staff,25,0,25,0,0
1668,Wolfson Campus,WLFL  219 - 02   Spanish 2,02-LEC Dynamic,Staff,16,0,16,0,0
2184,Wolfson Campus,WLFL  219 - 03   Spanish 2,03-LEC Dynamic,Staff,30,0,30,0,0
1109,Kendall Campus,WLFL  218 - 01   Spanish 1 (28 hrs),01-LEC Dynamic,Staff,25,0,25,0,0
1667,Wolfson Campus,WLFL  218 - 02   Spanish 1 (28 hrs),02-LEC Dynamic,Staff,16,0,16,0,0
2183,Wolfson Campus,WLFL  218 - 03   Spanish 1 (28 hrs),03-LEC Dynamic,Staff,30,0,30,0,0
3609,Homestead Campus,WLFL  218 - 04   Spanish 1 (28 hrs),04-LEC Dynamic,Staff,25,0,25,0,0
3610,Homestead Campus,WLFL  218 - 05   Spanish 1 (28 hrs),05-LEC Dynamic,Staff,25,0,25,0,0
1691,Wolfson Campus,RLFS  216 - 01   Tai Chi Exercise,01-LEC Dynamic,Staff,20,0,20,0,0
1694,Wolfson Campus,RLFS  216 - 02   Tai Chi Exercise,02-LEC Dynamic,Staff,20,0,20,0,0
2526,Hialeah Campus,RLFS  216 - 03   Tai Chi Exercise,03-LEC Dynamic,Staff,20,0,20,0,0
3297,Kendall Campus,RLFS  215 - 01   Step and Run,01-LEC Dynamic,Staff,20,0,20,0,0
3299,Kendall Campus,RLFS  215 - 02   Step and Run,02-LEC Dynamic,Staff,20,0,20,0,0
3304,North Campus,RLFS  214 - 01   Soccer Beginners (Ages 7-11),01-LEC Dynamic,Staff,15,0,15,8,0
3307,North Campus,RLFS  214 - 02   Soccer Beginners (Ages 7-11),02-LEC Dynamic,Staff,15,0,15,8,0
1340,Homestead Campus,RLFS  213 - 01   Zumba,01-LEC Dynamic,Staff,25,0,25,0,0
1934,Wolfson Campus,WLFL  213 - 01   Russian 1,01-LEC Dynamic,Staff,30,0,30,0,0
2265,Wolfson Campus,WLFL  213 - 02   Russian 1,02-LEC Dynamic,Staff,25,0,25,0,0
1933,Wolfson Campus,WLFL  212 - 01   Portuguese 6 - Intensive,01-LEC Dynamic,Staff,30,0,30,0,0
2262,Wolfson Campus,WLFL  212 - 02   Portuguese 6 - Intensive,02-LEC Dynamic,Staff,25,0,25,0,0
1336,Homestead Campus,RLFS  211 - 01   Yoga for Beginners,01-LEC Dynamic,Staff,30,0,30,0,0
1337,Homestead Campus,RLFS  211 - 02   Yoga for Beginners,02-LEC Dynamic,Staff,25,0,25,0,0
3132,Hialeah Campus,RLFS  211 - 03   Yoga for Beginners,03-LEC Dynamic,Staff,30,0,30,0,0
3313,Kendall Campus,RLFS  211 - 04   Yoga for Beginners,04-LEC Dynamic,Staff,30,0,30,0,0
3314,Kendall Campus,RLFS  211 - 05   Yoga for Beginners,05-LEC Dynamic,Staff,30,0,30,0,0
3316,Kendall Campus,RLFS  211 - 06   Yoga for Beginners,06-LEC Dynamic,Staff,30,0,30,0,0
3320,Kendall Campus,RLFS  211 - 07   Yoga for Beginners,07-LEC Dynamic,Staff,30,0,30,0,0
2263,Kendall Campus,WCTR  211 - 01   Operating an Early Childhood Education Center (Director's Credentials),01-LEC Dynamic,Staff,25,0,25,0,0
3614,Kendall Campus,WCTR  211 - 02   Operating an Early Childhood Education Center (Director's Credentials),02-LEC Dynamic,Staff,16,0,16,0,0
3615,Kendall Campus,WCTR  211 - 04   Operating an Early Childhood Education Center (Director's Credentials),04-LEC Dynamic,Staff,16,0,16,0,0
1932,Wolfson Campus,WLFL  211 - 01   Portuguese 5 - Intensive,01-LEC Dynamic,Staff,30,0,30,0,0
2261,Wolfson Campus,WLFL  211 - 02   Portuguese 5 - Intensive,02-LEC Dynamic,Staff,25,0,25,0,0
1869,Wolfson Campus,WTWD  211 - 01   WordPress - Level 1,01-LEC Dynamic,Staff,20,0,20,0,0
1894,Kendall Campus,WTWD  211 - 02   WordPress - Level 1,02-LEC Dynamic,Staff,15,0,15,0,0
2538,West Campus,WTWD  211 - 03   WordPress - Level 1,03-LEC Dynamic,Staff,35,0,35,0,0
3820,Homestead Campus,WCTR  210 - 01   Introduction to Computers for Child Care Workers,01-LEC Dynamic,Staff,25,0,25,0,0
1099,Kendall Campus,WLFL  210 - 01   Portuguese 4 - Intensive,01-LEC Dynamic,Staff,25,0,25,0,0
1931,Wolfson Campus,WLFL  210 - 02   Portuguese 4 - Intensive,02-LEC Dynamic,Staff,30,0,30,0,0
2260,Wolfson Campus,WLFL  210 - 03   Portuguese 4 - Intensive,03-LEC Dynamic,Staff,25,0,25,0,0
3486,Kendall Campus,WTWI  210 - 01   Administering Windows Server 2012 (70-411),01-LEC Dynamic,Staff,16,0,16,0,0
3308,Kendall Campus,RLFS  209 - 01   Yoga  AMP - Asana· Meditation & Pranayama,01-LEC Dynamic,Staff,15,0,15,0,0
3310,Kendall Campus,RLFS  209 - 02   Yoga  AMP - Asana· Meditation & Pranayama,02-LEC Dynamic,Staff,15,0,15,0,0
1098,Kendall Campus,WLFL  209 - 01   Portuguese 3 - Intensive,01-LEC Dynamic,Staff,25,0,25,0,0
1930,Wolfson Campus,WLFL  209 - 02   Portuguese 3 - Intensive,02-LEC Dynamic,Staff,30,0,30,0,0
2258,Wolfson Campus,WLFL  209 - 03   Portuguese 3 - Intensive,03-LEC Dynamic,Staff,25,0,25,0,0
3829,Kendall Campus,RLFS  208 - 01   Yoga - All Levels,01-LEC Dynamic,Staff,30,0,30,0,0
3833,Kendall Campus,RLFS  208 - 02   Yoga - All Levels,02-LEC Dynamic,Staff,35,0,35,0,0
1097,Kendall Campus,WLFL  208 - 01   Portuguese 2 - Intensive,01-LEC Dynamic,Staff,25,0,25,0,0
1929,Wolfson Campus,WLFL  208 - 02   Portuguese 2 - Intensive,02-LEC Dynamic,Staff,30,0,30,0,0
2257,Wolfson Campus,WLFL  208 - 03   Portuguese 2 - Intensive,03-LEC Dynamic,Staff,25,0,25,0,0
2516,West Campus,WLFL  208 - 04   Portuguese 2 - Intensive,04-LEC Dynamic,Staff,25,0,25,0,0
2515,West Campus,WLFL  208 - 05   Portuguese 2 - Intensive,05-LEC Dynamic,Staff,25,0,25,0,0
3483,Kendall Campus,WTWI  208 - 01   Installing and Configuring Windows Server 2012 (70-410),01-LEC Dynamic,Staff,16,0,16,0,0
3824,Homestead Campus,WCTR  207 - 01   DCF Make-up: Reglas y Regulaciones en el Hogar,01-LEC Dynamic,Staff,25,0,25,0,0
1096,Kendall Campus,WLFL  207 - 01   Portuguese 1 - Intensive,01-LEC Dynamic,Staff,25,0,25,0,0
1928,Wolfson Campus,WLFL  207 - 02   Portuguese 1 - Intensive,02-LEC Dynamic,Staff,30,0,30,0,0
2239,Wolfson Campus,WLFL  207 - 03   Portuguese 1 - Intensive,03-LEC Dynamic,Staff,30,0,30,0,0
2513,West Campus,WLFL  207 - 04   Portuguese 1 - Intensive,04-LEC Dynamic,Staff,25,0,25,0,0
2514,West Campus,WLFL  207 - 05   Portuguese 1 - Intensive,05-LEC Dynamic,Staff,25,0,25,0,0
2084,Kendall Campus,WTNT  207 - 01   MS Windows File Management,01-LEC Dynamic,Staff,15,0,15,0,0
2087,Kendall Campus,WTNT  207 - 02   MS Windows File Management,02-LEC Dynamic,Staff,15,0,15,0,0
3210,North Campus,WCTR  206 - 01   6 Hours Rules and Regulations/Facility,01-LEC Dynamic,Staff,16,0,16,8,0
3213,North Campus,WCTR  206 - 02   6 Hours Rules and Regulations/Facility,02-LEC Dynamic,Staff,16,0,16,8,0
3247,North Campus,WCTR  206 - 03   6 Hours Rules and Regulations/Facility,03-LEC Dynamic,Staff,16,0,16,8,0
3248,North Campus,WCTR  206 - 04   6 Hours Rules and Regulations/Facility,04-LEC Dynamic,Staff,16,0,16,8,0
1101,Kendall Campus,WLFL  206 - 01   Portuguese Conversation-Intermediate,01-LEC Dynamic,Staff,25,0,25,0,0
2520,West Campus,WLFL  206 - 02   Portuguese Conversation-Intermediate,02-LEC Dynamic,Staff,16,0,16,0,0
2519,West Campus,WLFL  206 - 03   Portuguese Conversation-Intermediate,03-LEC Dynamic,Staff,16,0,16,0,0
1100,Kendall Campus,WLFL  205 - 01   Portuguese Conversation - Beginners,01-LEC Dynamic,Staff,25,0,25,0,0
2518,West Campus,WLFL  205 - 02   Portuguese Conversation - Beginners,02-LEC Dynamic,Staff,16,0,16,0,0
2517,West Campus,WLFL  205 - 03   Portuguese Conversation - Beginners,03-LEC Dynamic,Staff,16,0,16,0,0
3608,Homestead Campus,WLFL  205 - 04   Portuguese Conversation - Beginners,04-LEC Dynamic,Staff,26,0,26,0,0
1868,Wolfson Campus,WTWD  205 - 01   Web Content - Joomla,01-LEC Dynamic,Staff,20,0,20,0,0
1893,Kendall Campus,WTWD  205 - 02   Web Content - Joomla,02-LEC Dynamic,Staff,15,0,15,0,0
2539,West Campus,WTWD  205 - 03   Web Content - Joomla,03-LEC Dynamic,Staff,35,0,35,0,0
3016,Kendall Campus,RLKC  204 - 01   Photoshop Level 1 for Teens (Ages 12-16),01-LEC Dynamic,Staff,15,0,15,0,0
1324,Homestead Campus,WCTR  204 - 03   5 Hours Early Literacy Training English,03-LEC Dynamic,Staff,25,0,25,0,0
1325,Homestead Campus,WCTR  204 - 04   5 Hours Early Literacy Training English,04-LEC Dynamic,Staff,25,0,25,0,0
1509,Kendall Campus,WCTR  204 - 06   5 Hours Early Literacy Training English,06-LEC Dynamic,Staff,25,0,25,0,0
1506,Kendall Campus,WCTR  204 - 07   5 Hours Early Literacy Training English,07-LEC Dynamic,Staff,25,0,25,0,0
1513,Kendall Campus,WCTR  204 - 08   5 Hours Early Literacy Training English,08-LEC Dynamic,Staff,25,0,25,0,0
1514,Kendall Campus,WCTR  204 - 09   5 Hours Early Literacy Training English,09-LEC Dynamic,Staff,25,0,25,0,0
3252,North Campus,WCTR  204 - 10   5 Hours Early Literacy Training English,10-LEC Dynamic,Staff,16,0,16,8,0
3253,North Campus,WCTR  204 - 11   5 Hours Early Literacy Training English,11-LEC Dynamic,Staff,16,0,16,8,0
3254,North Campus,WCTR  204 - 12   5 Hours Early Literacy Training English,12-LEC Dynamic,Staff,16,0,16,8,0
3255,North Campus,WCTR  204 - 13   5 Hours Early Literacy Training English,13-LEC Dynamic,Staff,16,0,16,8,0
3256,North Campus,WCTR  204 - 14   5 Hours Early Literacy Training English,14-LEC Dynamic,Staff,16,0,16,8,0
3620,Kendall Campus,WCTR  204 - 15   5 Hours Early Literacy Training English,15-LEC Dynamic,Staff,25,0,25,0,0
3775,Homestead Campus,WCTR  204 - 16   5 Hours Early Literacy Training English,16-LEC Dynamic,Staff,25,0,25,0,0
3776,Homestead Campus,WCTR  204 - 17   5 Hours Early Literacy Training English,17-LEC Dynamic,Staff,25,0,25,0,0
3251,North Campus,WCTR  204 - 18   5 Hours Early Literacy Training English,18-LEC Dynamic,Staff,16,0,16,8,0
3012,Kendall Campus,RLKC  203 - 01   Microsoft Basic Publisher (Ages 7-11),01-LEC Dynamic,Staff,15,0,15,0,0
1331,Homestead Campus,WCTR  203 - 01   5 Horas Entendimiento de La Práctica Apropiada para el Desarrollo (UDAP),01-LEC Dynamic,Staff,25,0,25,0,0
1605,InterAmerican Campus,WCTR  203 - 02   5 Horas Entendimiento de La Práctica Apropiada para el Desarrollo (UDAP),02-LEC Dynamic,Staff,25,0,25,0,0
1606,InterAmerican Campus,WCTR  203 - 03   5 Horas Entendimiento de La Práctica Apropiada para el Desarrollo (UDAP),03-LEC Dynamic,Staff,25,0,25,0,0
1607,InterAmerican Campus,WCTR  203 - 04   5 Horas Entendimiento de La Práctica Apropiada para el Desarrollo (UDAP),04-LEC Dynamic,Staff,25,0,25,0,0
1608,InterAmerican Campus,WCTR  203 - 05   5 Horas Entendimiento de La Práctica Apropiada para el Desarrollo (UDAP),05-LEC Dynamic,Staff,25,0,25,0,0
1609,InterAmerican Campus,WCTR  203 - 06   5 Horas Entendimiento de La Práctica Apropiada para el Desarrollo (UDAP),06-LEC Dynamic,Staff,25,0,25,0,0
2286,Kendall Campus,WCTR  203 - 07   5 Horas Entendimiento de La Práctica Apropiada para el Desarrollo (UDAP),07-LEC Dynamic,Staff,16,0,16,0,0
2287,Kendall Campus,WCTR  203 - 08   5 Horas Entendimiento de La Práctica Apropiada para el Desarrollo (UDAP),08-LEC Dynamic,Staff,16,0,16,0,0
2288,Kendall Campus,WCTR  203 - 09   5 Horas Entendimiento de La Práctica Apropiada para el Desarrollo (UDAP),09-LEC Dynamic,Staff,16,0,16,0,0
2289,Kendall Campus,WCTR  203 - 10   5 Horas Entendimiento de La Práctica Apropiada para el Desarrollo (UDAP),10-LEC Dynamic,Staff,25,0,25,0,0
2290,Kendall Campus,WCTR  203 - 11   5 Horas Entendimiento de La Práctica Apropiada para el Desarrollo (UDAP),11-LEC Dynamic,Staff,25,0,25,0,0
2291,Kendall Campus,WCTR  203 - 12   5 Horas Entendimiento de La Práctica Apropiada para el Desarrollo (UDAP),12-LEC Dynamic,Staff,25,0,25,0,0
2292,Kendall Campus,WCTR  203 - 13   5 Horas Entendimiento de La Práctica Apropiada para el Desarrollo (UDAP),13-LEC Dynamic,Staff,25,0,25,0,0
2622,West Campus,WCTR  203 - 14   5 Horas Entendimiento de La Práctica Apropiada para el Desarrollo (UDAP),14-LEC Dynamic,Staff,16,0,16,0,0
2623,West Campus,WCTR  203 - 15   5 Horas Entendimiento de La Práctica Apropiada para el Desarrollo (UDAP),15-LEC Dynamic,Staff,16,0,16,0,0
2624,West Campus,WCTR  203 - 16   5 Horas Entendimiento de La Práctica Apropiada para el Desarrollo (UDAP),16-LEC Dynamic,Staff,16,0,16,0,0
2625,West Campus,WCTR  203 - 17   5 Horas Entendimiento de La Práctica Apropiada para el Desarrollo (UDAP),17-LEC Dynamic,Staff,16,0,16,0,0
2626,West Campus,WCTR  203 - 18   5 Horas Entendimiento de La Práctica Apropiada para el Desarrollo (UDAP),18-LEC Dynamic,Staff,16,0,16,0,0
3055,Hialeah Campus,WCTR  203 - 20   5 Horas Entendimiento de La Práctica Apropiada para el Desarrollo (UDAP),20-LEC Dynamic,Staff,30,0,30,0,0
3059,Hialeah Campus,WCTR  203 - 21   5 Horas Entendimiento de La Práctica Apropiada para el Desarrollo (UDAP),21-LEC Dynamic,Staff,30,0,30,0,0
3060,Hialeah Campus,WCTR  203 - 22   5 Horas Entendimiento de La Práctica Apropiada para el Desarrollo (UDAP),22-LEC Dynamic,Staff,30,0,30,0,0
3063,Hialeah Campus,WCTR  203 - 23   5 Horas Entendimiento de La Práctica Apropiada para el Desarrollo (UDAP),23-LEC Dynamic,Staff,30,0,30,0,0
3066,Hialeah Campus,WCTR  203 - 24   5 Horas Entendimiento de La Práctica Apropiada para el Desarrollo (UDAP),24-LEC Dynamic,Staff,30,0,30,0,0
2621,West Campus,WCTR  203 - 31   5 Horas Entendimiento de La Práctica Apropiada para el Desarrollo (UDAP),31-LEC Dynamic,Staff,16,0,16,0,0
1320,Kendall Campus,WTNT  203 - 01   Using Your iPad,01-LEC Dynamic,Staff,15,0,15,0,0
1322,Kendall Campus,WTNT  203 - 02   Using Your iPad,02-LEC Dynamic,Staff,15,0,15,0,0
3464,Kendall Campus,WTNT  203 - 03   Using Your iPad,03-LEC Dynamic,Staff,16,0,16,0,0
1327,Homestead Campus,WCTR  202 - 03   5 Horas de Desarrollo del Lenguaje y la Enseñanza de la Lectoescritura (Early Literacy Training),03-LEC Dynamic,Staff,25,0,25,0,0
1328,Homestead Campus,WCTR  202 - 04   5 Horas de Desarrollo del Lenguaje y la Enseñanza de la Lectoescritura (Early Literacy Training),04-LEC Dynamic,Staff,25,0,25,0,0
1553,Kendall Campus,WCTR  202 - 05   5 Horas de Desarrollo del Lenguaje y la Enseñanza de la Lectoescritura (Early Literacy Training),05-LEC Dynamic,Staff,25,0,25,0,0
1554,Kendall Campus,WCTR  202 - 06   5 Horas de Desarrollo del Lenguaje y la Enseñanza de la Lectoescritura (Early Literacy Training),06-LEC Dynamic,Staff,25,0,25,0,0
1556,Kendall Campus,WCTR  202 - 07   5 Horas de Desarrollo del Lenguaje y la Enseñanza de la Lectoescritura (Early Literacy Training),07-LEC Dynamic,Staff,25,0,25,0,0
1559,Kendall Campus,WCTR  202 - 08   5 Horas de Desarrollo del Lenguaje y la Enseñanza de la Lectoescritura (Early Literacy Training),08-LEC Dynamic,Staff,25,0,25,0,0
1562,Kendall Campus,WCTR  202 - 09   5 Horas de Desarrollo del Lenguaje y la Enseñanza de la Lectoescritura (Early Literacy Training),09-LEC Dynamic,Staff,25,0,25,0,0
1566,Kendall Campus,WCTR  202 - 10   5 Horas de Desarrollo del Lenguaje y la Enseñanza de la Lectoescritura (Early Literacy Training),10-LEC Dynamic,Staff,25,0,25,0,0
1567,Kendall Campus,WCTR  202 - 11   5 Horas de Desarrollo del Lenguaje y la Enseñanza de la Lectoescritura (Early Literacy Training),11-LEC Dynamic,Staff,25,0,25,0,0
1571,Kendall Campus,WCTR  202 - 12   5 Horas de Desarrollo del Lenguaje y la Enseñanza de la Lectoescritura (Early Literacy Training),12-LEC Dynamic,Staff,25,0,25,0,0
1572,Kendall Campus,WCTR  202 - 13   5 Horas de Desarrollo del Lenguaje y la Enseñanza de la Lectoescritura (Early Literacy Training),13-LEC Dynamic,Staff,25,0,25,0,0
1574,Kendall Campus,WCTR  202 - 14   5 Horas de Desarrollo del Lenguaje y la Enseñanza de la Lectoescritura (Early Literacy Training),14-LEC Dynamic,Staff,25,0,25,0,0
1575,Kendall Campus,WCTR  202 - 15   5 Horas de Desarrollo del Lenguaje y la Enseñanza de la Lectoescritura (Early Literacy Training),15-LEC Dynamic,Staff,25,0,25,0,0
1600,InterAmerican Campus,WCTR  202 - 16   5 Horas de Desarrollo del Lenguaje y la Enseñanza de la Lectoescritura (Early Literacy Training),16-LEC Dynamic,Staff,25,0,25,0,0
1601,InterAmerican Campus,WCTR  202 - 17   5 Horas de Desarrollo del Lenguaje y la Enseñanza de la Lectoescritura (Early Literacy Training),17-LEC Dynamic,Staff,25,0,25,0,0
1602,InterAmerican Campus,WCTR  202 - 18   5 Horas de Desarrollo del Lenguaje y la Enseñanza de la Lectoescritura (Early Literacy Training),18-LEC Dynamic,Staff,25,0,25,0,0
1603,InterAmerican Campus,WCTR  202 - 19   5 Horas de Desarrollo del Lenguaje y la Enseñanza de la Lectoescritura (Early Literacy Training),19-LEC Dynamic,Staff,25,0,25,0,0
1604,InterAmerican Campus,WCTR  202 - 20   5 Horas de Desarrollo del Lenguaje y la Enseñanza de la Lectoescritura (Early Literacy Training),20-LEC Dynamic,Staff,25,0,25,0,0
2565,Hialeah Campus,WCTR  202 - 21   5 Horas de Desarrollo del Lenguaje y la Enseñanza de la Lectoescritura (Early Literacy Training),21-LEC Dynamic,Staff,30,0,30,0,0
2567,Hialeah Campus,WCTR  202 - 22   5 Horas de Desarrollo del Lenguaje y la Enseñanza de la Lectoescritura (Early Literacy Training),22-LEC Dynamic,Staff,30,0,30,0,0
2569,Hialeah Campus,WCTR  202 - 23   5 Horas de Desarrollo del Lenguaje y la Enseñanza de la Lectoescritura (Early Literacy Training),23-LEC Dynamic,Staff,30,0,30,0,0
2571,Hialeah Campus,WCTR  202 - 24   5 Horas de Desarrollo del Lenguaje y la Enseñanza de la Lectoescritura (Early Literacy Training),24-LEC Dynamic,Staff,30,0,30,0,0
2572,Hialeah Campus,WCTR  202 - 25   5 Horas de Desarrollo del Lenguaje y la Enseñanza de la Lectoescritura (Early Literacy Training),25-LEC Dynamic,Staff,30,0,30,0,0
2605,West Campus,WCTR  202 - 26   5 Horas de Desarrollo del Lenguaje y la Enseñanza de la Lectoescritura (Early Literacy Training),26-LEC Dynamic,Staff,16,0,16,0,0
2606,West Campus,WCTR  202 - 27   5 Horas de Desarrollo del Lenguaje y la Enseñanza de la Lectoescritura (Early Literacy Training),27-LEC Dynamic,Staff,16,0,16,0,0
2603,West Campus,WCTR  202 - 28   5 Horas de Desarrollo del Lenguaje y la Enseñanza de la Lectoescritura (Early Literacy Training),28-LEC Dynamic,Staff,16,0,16,0,0
2602,West Campus,WCTR  202 - 29   5 Horas de Desarrollo del Lenguaje y la Enseñanza de la Lectoescritura (Early Literacy Training),29-LEC Dynamic,Staff,16,0,16,0,0
2604,West Campus,WCTR  202 - 30   5 Horas de Desarrollo del Lenguaje y la Enseñanza de la Lectoescritura (Early Literacy Training),30-LEC Dynamic,Staff,16,0,16,0,0
1926,Wolfson Campus,WLFL  202 - 01   Portuguese 6,01-LEC Dynamic,Staff,30,0,30,0,0
2238,Wolfson Campus,WLFL  202 - 02   Portuguese 6,02-LEC Dynamic,Staff,30,0,30,0,0
2646,West Campus,WLEP  201 - 01   Intensive English 4,01-LEC Dynamic,Staff,16,0,16,0,0
1925,Wolfson Campus,WLFL  201 - 01   Portuguese 5,01-LEC Dynamic,Staff,30,0,30,0,0
2237,Wolfson Campus,WLFL  201 - 02   Portuguese 5,02-LEC Dynamic,Staff,30,0,30,0,0
3355,Kendall Campus,RLFS  200 - 01   Tennis Clinic for Beginners and Intermediate,01-LEC Dynamic,Staff,30,0,30,0,0
3359,Kendall Campus,RLFS  200 - 02   Tennis Clinic for Beginners and Intermediate,02-LEC Dynamic,Staff,30,0,30,0,0
1924,Wolfson Campus,WLFL  200 - 01   Portuguese 4,01-LEC Dynamic,Staff,30,0,30,0,0
2236,Wolfson Campus,WLFL  200 - 02   Portuguese 4,02-LEC Dynamic,Staff,30,0,30,0,0
3577,Wolfson Campus,WTNT  200 - 01   My Tablet and Me – Apple,01-LEC Dynamic,Staff,20,0,20,0,0
3578,Wolfson Campus,WTNT  200 - 02   My Tablet and Me – Apple,02-LEC Dynamic,Staff,20,0,20,0,0
1923,Wolfson Campus,WLFL  199 - 01   Portuguese 3,01-LEC Dynamic,Staff,30,0,30,0,0
2235,Wolfson Campus,WLFL  199 - 02   Portuguese 3,02-LEC Dynamic,Staff,30,0,30,0,0
3373,Kendall Campus,RLFS  198 - 01   Tennis - Beginners,01-LEC Dynamic,Staff,15,0,15,0,0
3375,Kendall Campus,RLFS  198 - 02   Tennis - Beginners,02-LEC Dynamic,Staff,15,0,15,0,0
3376,Kendall Campus,RLFS  198 - 03   Tennis - Beginners,03-LEC Dynamic,Staff,15,0,15,0,0
3377,Kendall Campus,RLFS  198 - 04   Tennis - Beginners,04-LEC Dynamic,Staff,15,0,15,0,0
3777,Homestead Campus,WCTR  198 - 01   Taller para Matrícula Electrónica (DCF),01-LEC Dynamic,Staff,25,0,25,0,0
1922,Wolfson Campus,WLFL  198 - 01   Portuguese 2,01-LEC Dynamic,Staff,30,0,30,0,0
2234,Wolfson Campus,WLFL  198 - 02   Portuguese 2,02-LEC Dynamic,Staff,30,0,30,0,0
3812,Kendall Campus,RLFS  197 - 01   Tennis Beginners/Int (Ages 9 - 16),01-LEC Dynamic,Staff,15,0,15,0,0
3813,Kendall Campus,RLFS  197 - 02   Tennis Beginners/Int (Ages 9 - 16),02-LEC Dynamic,Staff,15,0,15,0,0
3028,Kendall Campus,RLKC  197 - 01   Web Page Design for Teens (Ages 12 - 16),01-LEC Dynamic,Staff,15,0,15,0,0
1921,Wolfson Campus,WLFL  197 - 01   Portuguese 1,01-LEC Dynamic,Staff,30,0,30,0,0
2233,Wolfson Campus,WLFL  197 - 02   Portuguese 1,02-LEC Dynamic,Staff,30,0,30,0,0
2432,Hialeah Campus,WLFL  197 - 03   Portuguese 1,03-LEC Dynamic,Staff,16,0,16,0,0
1041,Homestead Campus,WTNT  197 - 01   Seminario de Computación Básica,01-LEC Dynamic,Staff,25,0,25,0,0
1042,Homestead Campus,WTNT  197 - 02   Seminario de Computación Básica,02-LEC Dynamic,Staff,25,0,25,0,0
3806,Kendall Campus,RLFS  196 - 01   Tennis for Beginners  (Ages 9 - 16),01-LEC Dynamic,Staff,15,0,15,0,0
3807,Kendall Campus,RLFS  196 - 02   Tennis for Beginners  (Ages 9 - 16),02-LEC Dynamic,Staff,15,0,15,0,0
3808,Kendall Campus,RLFS  196 - 03   Tennis for Beginners  (Ages 9 - 16),03-LEC Dynamic,Staff,15,0,15,0,0
3809,Kendall Campus,RLFS  196 - 04   Tennis for Beginners  (Ages 9 - 16),04-LEC Dynamic,Staff,15,0,15,0,0
2125,InterAmerican Campus,WLEP  196 - 01   English Conversation 3,01-LEC Dynamic,Staff,16,0,16,0,0
1877,Wolfson Campus,WTWD  196 - 01   Search Engine Optimization and Placement,01-LEC Dynamic,Staff,20,0,20,0,0
3804,Kendall Campus,RLFS  195 - 01   Tennis for Beginners (Ages 5 - 8),01-LEC Dynamic,Staff,15,0,15,0,0
3805,Kendall Campus,RLFS  195 - 02   Tennis for Beginners (Ages 5 - 8),02-LEC Dynamic,Staff,15,0,15,0,0
1952,InterAmerican Campus,RLMP  195 - 01   Private Music 7 – ½ Hour Guitar           ,01-LEC Dynamic,Staff,16,0,16,0,0
3170,Kendall Campus,RLMP  195 - 02   Private Music 7 – ½ Hour Guitar           ,02-LEC Dynamic,Staff,16,0,16,0,0
3173,Kendall Campus,RLMP  195 - 03   Private Music 7 – ½ Hour Guitar           ,03-LEC Dynamic,Staff,16,0,16,0,0
2088,InterAmerican Campus,WLEP  195 - 01   English Conversation 2,01-LEC Dynamic,Staff,20,0,20,0,0
3830,Homestead Campus,WLEP  195 - 02   English Conversation 2,02-LEC Dynamic,Staff,25,0,25,0,0
2085,InterAmerican Campus,WLEP  194 - 03   English Conversation 1,03-LEC Dynamic,Staff,20,0,20,0,0
2399,North Campus,RLFS  193 - 01   Karate - Shuri Ryu (Ages 6 - 15),01-LEC Dynamic,Staff,15,0,15,10,0
2421,West Campus,WLEP  193 - 01   English Conversation,01-LEC Dynamic,Staff,16,0,16,0,0
2647,West Campus,WLEP  193 - 02   English Conversation,02-LEC Dynamic,Staff,16,0,16,0,0
1309,Kendall Campus,WTAA  193 - 01   QuickBooks 2015 Nivel 2,01-LEC Dynamic,Staff,15,0,15,0,0
2501,West Campus,WTAA  193 - 02   QuickBooks 2015 Nivel 2,02-LEC Dynamic,Staff,16,0,16,0,0
3671,North Campus,WTAA  193 - 03   QuickBooks 2015 Nivel 2,03-LEC Dynamic,Staff,16,0,16,0,0
3302,Kendall Campus,RLFS  192 - 02   Tai Chi For Health,02-LEC Dynamic,Staff,15,0,15,0,0
3305,Kendall Campus,RLFS  192 - 03   Tai Chi For Health,03-LEC Dynamic,Staff,15,0,15,0,0
1950,InterAmerican Campus,RLMP  192 - 01   Private Music 7 – 1 Hour Guitar             ,01-LEC Dynamic,Staff,16,0,16,0,0
3167,Kendall Campus,RLMP  192 - 02   Private Music 7 – 1 Hour Guitar             ,02-LEC Dynamic,Staff,16,0,16,0,0
3172,Kendall Campus,RLMP  192 - 03   Private Music 7 – 1 Hour Guitar             ,03-LEC Dynamic,Staff,16,0,16,0,0
1307,Kendall Campus,WTAA  192 - 01   QuickBooks 2015 Nivel 1,01-LEC Dynamic,Staff,15,0,15,0,0
1308,Kendall Campus,WTAA  192 - 02   QuickBooks 2015 Nivel 1,02-LEC Dynamic,Staff,15,0,15,0,0
2500,West Campus,WTAA  192 - 03   QuickBooks 2015 Nivel 1,03-LEC Dynamic,Staff,35,0,35,0,0
3670,North Campus,WTAA  192 - 04   QuickBooks 2015 Nivel 1,04-LEC Dynamic,Staff,16,0,16,0,0
3131,Hialeah Campus,RLFS  191 - 01   Tai Chi Exercise,01-LEC Dynamic,Staff,30,0,30,0,0
1419,InterAmerican Campus,WTAA  191 - 01,01-LEC Dynamic,Staff,20,0,20,0,0
1504,Kendall Campus,WTAA  191 - 02,02-LEC Dynamic,Staff,15,0,15,0,0
1505,Kendall Campus,WTAA  191 - 03,03-LEC Dynamic,Staff,15,0,15,0,0
1508,Kendall Campus,WTAA  191 - 04,04-LEC Dynamic,Staff,15,0,15,0,0
2984,Hialeah Campus,WTAA  191 - 05,05-LEC Dynamic,Staff,16,0,16,0,0
3160,Kendall Campus,RLMP  190 - 01   Private Music 14 – ½ Hour Guitar        ,01-LEC Dynamic,Staff,16,0,16,0,0
2640,West Campus,WLEP  190 - 01   English Conversation - Advanced,01-LEC Dynamic,Staff,16,0,16,0,0
1290,Kendall Campus,WTAA  190 - 01   QuickBooks 2015 Level 1,01-LEC Dynamic,Staff,15,0,15,0,0
1291,Kendall Campus,WTAA  190 - 02   QuickBooks 2015 Level 1,02-LEC Dynamic,Staff,15,0,15,0,0
1293,Kendall Campus,WTAA  190 - 03   QuickBooks 2015 Level 1,03-LEC Dynamic,Staff,15,0,15,0,0
1418,InterAmerican Campus,WTAA  190 - 04   QuickBooks 2015 Level 1,04-LEC Dynamic,Staff,20,0,20,0,0
2982,Hialeah Campus,WTAA  190 - 05   QuickBooks 2015 Level 1,05-LEC Dynamic,Staff,16,0,16,0,0
2983,Hialeah Campus,WTAA  190 - 06   QuickBooks 2015 Level 1,06-LEC Dynamic,Staff,16,0,16,0,0
3666,North Campus,WTAA  190 - 07   QuickBooks 2015 Level 1,07-LEC Dynamic,Staff,16,0,16,0,0
3667,North Campus,WTAA  190 - 08   QuickBooks 2015 Level 1,08-LEC Dynamic,Staff,16,0,16,0,0
3668,North Campus,WTAA  190 - 09   QuickBooks 2015 Level 1,09-LEC Dynamic,Staff,16,0,16,0,0
3159,Kendall Campus,RLMP  189 - 01   Private Music 14 – 1 Hour Guitar          ,01-LEC Dynamic,Staff,16,0,16,0,0
2209,Wolfson Campus,WLFL  189 - 01   Mandarin Chinese 4 - Intensive,01-LEC Dynamic,Staff,30,0,30,0,0
1039,Homestead Campus,WTAA  189 - 01   QuickBooks 14 Level 2,01-LEC Dynamic,Staff,25,0,25,0,0
1763,Wolfson Campus,WTAA  189 - 07   QuickBooks 14 Level 2,07-LEC Dynamic,Staff,20,0,20,0,0
2499,West Campus,WTAA  189 - 08   QuickBooks 14 Level 2,08-LEC Dynamic,Staff,35,0,35,0,0
2498,West Campus,WTAA  189 - 09   QuickBooks 14 Level 2,09-LEC Dynamic,Staff,35,0,35,0,0
3669,North Campus,WTAA  189 - 10   QuickBooks 14 Level 2,10-LEC Dynamic,Staff,16,0,16,0,0
3770,Wolfson Campus,WTAA  189 - 11   QuickBooks 14 Level 2,11-LEC Dynamic,Staff,30,0,30,0,0
2167,Wolfson Campus,WLEP  188 - 02   Business and Professional English,02-LEC Dynamic,Staff,30,0,30,0,0
2168,Wolfson Campus,WLEP  188 - 03   Business and Professional English,03-LEC Dynamic,Staff,30,0,30,0,0
3002,Hialeah Campus,WLEP  188 - 04   Business and Professional English,04-LEC Dynamic,Staff,30,0,30,0,0
3004,Hialeah Campus,WLEP  188 - 05   Business and Professional English,05-LEC Dynamic,Staff,30,0,30,0,0
1721,Wolfson Campus,WLFL  188 - 01   Mandarin Chinese 3 - Intensive,01-LEC Dynamic,Staff,30,0,30,0,0
1038,Homestead Campus,WTAA  188 - 01   QuickBooks 14 Level 1,01-LEC Dynamic,Staff,25,0,25,0,0
1495,Wolfson Campus,WTAA  188 - 02   QuickBooks 14 Level 1,02-LEC Dynamic,Staff,25,0,25,0,0
1760,Wolfson Campus,WTAA  188 - 03   QuickBooks 14 Level 1,03-LEC Dynamic,Staff,20,0,20,0,0
2496,West Campus,WTAA  188 - 04   QuickBooks 14 Level 1,04-LEC Dynamic,Staff,35,0,35,0,0
2497,West Campus,WTAA  188 - 05   QuickBooks 14 Level 1,05-LEC Dynamic,Staff,35,0,35,0,0
2161,Wolfson Campus,WLEP  187 - 01   Accent Reduction - Intermediate,01-LEC Dynamic,Staff,30,0,30,0,0
1123,Kendall Campus,WLFL  187 - 01   Mandarin Chinese 2 - Intensive,01-LEC Dynamic,Staff,25,0,25,0,0
2927,Hialeah Campus,WTDM  187 - 01   Adobe Photoshop CC for Photographers,01-LEC Dynamic,Staff,16,0,16,0,0
2014,Wolfson Campus,WLEP  186 - 02   Accent Reduction - Beginners,02-LEC Dynamic,Staff,30,0,30,0,0
2428,Hialeah Campus,WLEP  186 - 03   Accent Reduction - Beginners,03-LEC Dynamic,Staff,30,0,30,0,0
1126,Kendall Campus,WLFL  186 - 01   Mandarin Chinese 1 - Intensive,01-LEC Dynamic,Staff,25,0,25,0,0
1717,Wolfson Campus,WLFL  186 - 02   Mandarin Chinese 1 - Intensive,02-LEC Dynamic,Staff,30,0,30,0,0
2207,Wolfson Campus,WLFL  186 - 03   Mandarin Chinese 1 - Intensive,03-LEC Dynamic,Staff,30,0,30,0,0
2083,InterAmerican Campus,WLEP  185 - 01   Accent Reduction - Advanced,01-LEC Dynamic,Staff,20,0,20,0,0
1745,Wolfson Campus,RLMP  184 - 01   Voz y Diccion / Voice and Speech,01-LEC Dynamic,Staff,25,0,25,0,0
2008,Wolfson Campus,WLEP  184 - 02   Accelerated English Conversation Intermediate,02-LEC Dynamic,Staff,30,0,30,0,0
1710,Wolfson Campus,WLFL  184 - 01   Mandarin Chinese 6,01-LEC Dynamic,Staff,30,0,30,0,0
2204,Wolfson Campus,WLFL  184 - 02   Mandarin Chinese 6,02-LEC Dynamic,Staff,30,0,30,0,0
3130,Hialeah Campus,RLKC  183 - 01   Special Effects Makeup,01-LEC Dynamic,Staff,30,0,30,0,0
2007,Wolfson Campus,WLEP  183 - 02   Accelerated English Conversation Beginners,02-LEC Dynamic,Staff,30,0,30,0,0
1576,Kendall Campus,WTWD  183 - 01   Principles of Web Design,01-LEC Dynamic,Staff,15,0,15,0,0
1586,Wolfson Campus,WTWD  183 - 02   Principles of Web Design,02-LEC Dynamic,Staff,25,0,25,0,0
1793,Wolfson Campus,WTWD  183 - 03   Principles of Web Design,03-LEC Dynamic,Staff,20,0,20,0,0
3193,Kendall Campus,RLMP  182 - 01   Private Music 7 – 1 Hour Voice,01-LEC Dynamic,Staff,16,0,16,0,0
3196,Kendall Campus,RLMP  182 - 02   Private Music 7 – 1 Hour Voice,02-LEC Dynamic,Staff,16,0,16,0,0
3606,Homestead Campus,WLEP  182 - 02   Academic and Professional English Level 4,02-LEC Dynamic,Staff,25,0,25,0,0
1709,Wolfson Campus,WLFL  182 - 01   Mandarin Chinese 4,01-LEC Dynamic,Staff,30,0,30,0,0
2203,Wolfson Campus,WLFL  182 - 02   Mandarin Chinese 4,02-LEC Dynamic,Staff,30,0,30,0,0
3194,Kendall Campus,RLMP  181 - 01   Private Music 7 – ½ Hour Voice             ,01-LEC Dynamic,Staff,16,0,16,0,0
3198,Kendall Campus,RLMP  181 - 02   Private Music 7 – ½ Hour Voice             ,02-LEC Dynamic,Staff,16,0,16,0,0
3605,Homestead Campus,WLEP  181 - 02   Academic and Professional English Level 3,02-LEC Dynamic,Staff,26,0,26,0,0
1708,Wolfson Campus,WLFL  181 - 01   Mandarin Chinese 3,01-LEC Dynamic,Staff,30,0,30,0,0
2202,Wolfson Campus,WLFL  181 - 02   Mandarin Chinese 3,02-LEC Dynamic,Staff,30,0,30,0,0
3450,Wolfson Campus,RLMP  180 - 01   Voice 2 Adult Group,01-LEC Dynamic,Staff,30,0,30,0,0
3604,Homestead Campus,WLEP  180 - 02   Academic and Professional English Level 2,02-LEC Dynamic,Staff,25,0,25,0,0
1707,Wolfson Campus,WLFL  180 - 01   Mandarin Chinese 2,01-LEC Dynamic,Staff,30,0,30,0,0
2201,Wolfson Campus,WLFL  180 - 02   Mandarin Chinese 2,02-LEC Dynamic,Staff,30,0,30,0,0
1888,Wolfson Campus,WTMO  180 - 01   Microsoft PowerPoint 2013 Basic,01-LEC Dynamic,Staff,20,0,20,0,0
1907,Wolfson Campus,WTMO  180 - 02   Microsoft PowerPoint 2013 Basic,02-LEC Dynamic,Staff,20,0,20,0,0
3190,Kendall Campus,RLMP  179 - 01   Private Music 14 – ½ Hour Voice          ,01-LEC Dynamic,Staff,16,0,16,0,0
3603,Homestead Campus,WLEP  179 - 02   Academic and Professional English Level 1,02-LEC Dynamic,Staff,25,0,25,0,0
1706,Wolfson Campus,WLFL  179 - 01   Mandarin Chinese 1,01-LEC Dynamic,Staff,30,0,30,0,0
2200,Wolfson Campus,WLFL  179 - 02   Mandarin Chinese 1,02-LEC Dynamic,Staff,30,0,30,0,0
2322,Wolfson Campus,WTMO  179 - 01   Microsoft PowerPoint 2013 - Básico,01-LEC Dynamic,Staff,30,0,30,0,0
3134,Hialeah Campus,WTMO  179 - 02   Microsoft PowerPoint 2013 - Básico,02-LEC Dynamic,Staff,16,0,16,0,0
3136,Hialeah Campus,WTMO  179 - 03   Microsoft PowerPoint 2013 - Básico,03-LEC Dynamic,Staff,16,0,16,0,0
3189,Kendall Campus,RLMP  178 - 01   Private Music 14 – 1 Hour Voice            ,01-LEC Dynamic,Staff,16,0,16,0,0
1711,Wolfson Campus,WLFL  178 - 01   A Living History of Chinese Philosophy and Culture,01-LEC Dynamic,Staff,30,0,30,0,0
2205,Wolfson Campus,WLFL  178 - 02   A Living History of Chinese Philosophy and Culture,02-LEC Dynamic,Staff,30,0,30,0,0
1728,Wolfson Campus,WTDM  178 - 01   Adobe Photoshop Lightroom,01-LEC Dynamic,Staff,20,0,20,0,0
2177,Wolfson Campus,WLEP  176 - 02   Reading and Conversation 3,02-LEC Dynamic,Staff,30,0,30,0,0
2643,West Campus,WLEP  176 - 03   Reading and Conversation 3,03-LEC Dynamic,Staff,16,0,16,0,0
1874,North Campus,WTCR  176 - 01   PC Security Basic,01-LEC Dynamic,Staff,20,0,20,0,0
3619,North Campus,WTCR  176 - 02   PC Security Basic,02-LEC Dynamic,Staff,16,0,16,0,0
2175,Wolfson Campus,WLEP  175 - 02   Reading and Conversation 2,02-LEC Dynamic,Staff,30,0,30,0,0
2642,West Campus,WLEP  175 - 03   Reading and Conversation 2,03-LEC Dynamic,Staff,16,0,16,0,0
1796,North Campus,WTCR  175 - 01   Optimize Your PC,01-LEC Dynamic,Staff,20,0,20,0,0
3618,North Campus,WTCR  175 - 02   Optimize Your PC,02-LEC Dynamic,Staff,16,0,16,0,0
2174,Wolfson Campus,WLEP  174 - 02   Reading and Conversation 1,02-LEC Dynamic,Staff,30,0,30,0,0
2429,Hialeah Campus,WLEP  174 - 03   Reading and Conversation 1,03-LEC Dynamic,Staff,30,0,30,0,0
2641,West Campus,WLEP  174 - 04   Reading and Conversation 1,04-LEC Dynamic,Staff,16,0,16,0,0
2321,Wolfson Campus,WTCT  174 - 01   CompTIA Network+ (N10-005),01-LEC Dynamic,Staff,30,0,30,0,0
3204,Kendall Campus,RLMP  173 - 01   Private Music 7 – 1 Hour Violin              ,01-LEC Dynamic,Staff,16,0,16,0,0
3209,Kendall Campus,RLMP  173 - 02   Private Music 7 – 1 Hour Violin              ,02-LEC Dynamic,Staff,16,0,16,0,0
1314,Kendall Campus,WLEP  173 - 01   Intensive English 5,01-LEC Dynamic,Staff,30,0,30,0,0
1316,Kendall Campus,WLEP  173 - 02   Intensive English 5,02-LEC Dynamic,Staff,30,0,30,0,0
1317,Kendall Campus,WLEP  173 - 03   Intensive English 5,03-LEC Dynamic,Staff,30,0,30,0,0
2761,North Campus,WLEP  173 - 04   Intensive English 5,04-LEC Dynamic,Staff,30,0,30,0,0
2764,North Campus,WLEP  173 - 05   Intensive English 5,05-LEC Dynamic,Staff,30,0,30,0,0
2773,North Campus,WLEP  173 - 06   Intensive English 5,06-LEC Dynamic,Staff,30,0,30,0,0
2775,North Campus,WLEP  173 - 07   Intensive English 5,07-LEC Dynamic,Staff,30,0,30,0,0
1697,Wolfson Campus,WLFL  173 - 01   La Alegria de Leer,01-LEC Dynamic,Staff,30,0,30,0,0
2430,Hialeah Campus,WLFL  173 - 03   La Alegria de Leer,03-LEC Dynamic,Staff,30,0,30,0,0
2431,Hialeah Campus,WLFL  173 - 04   La Alegria de Leer,04-LEC Dynamic,Staff,30,0,30,0,0
1032,Homestead Campus,WTMO  173 - 01   Microsoft Word 2013 Level 2,01-LEC Dynamic,Staff,25,0,25,0,0
2116,Kendall Campus,WTMO  173 - 02   Microsoft Word 2013 Level 2,02-LEC Dynamic,Staff,15,0,15,0,0
3662,North Campus,WTMO  173 - 03   Microsoft Word 2013 Level 2,03-LEC Dynamic,Staff,16,0,16,0,0
3206,Kendall Campus,RLMP  172 - 01   Private Music 7 – ½ Hour Violin            ,01-LEC Dynamic,Staff,16,0,16,0,0
3208,Kendall Campus,RLMP  172 - 02   Private Music 7 – ½ Hour Violin            ,02-LEC Dynamic,Staff,16,0,16,0,0
2423,West Campus,WLEP  172 - 01   Intensive English 1,01-LEC Dynamic,Staff,30,0,30,0,0
1095,Kendall Campus,WLFL  172 - 01   Japanese 2 (21 Hours),01-LEC Dynamic,Staff,25,0,25,0,0
1031,Homestead Campus,WTMO  172 - 01   Microsoft Word 2013 Level 1,01-LEC Dynamic,Staff,25,0,25,0,0
2112,Kendall Campus,WTMO  172 - 02   Microsoft Word 2013 Level 1,02-LEC Dynamic,Staff,15,0,15,0,0
2113,Kendall Campus,WTMO  172 - 03   Microsoft Word 2013 Level 1,03-LEC Dynamic,Staff,15,0,15,0,0
3661,North Campus,WTMO  172 - 04   Microsoft Word 2013 Level 1,04-LEC Dynamic,Staff,16,0,16,0,0
3202,Kendall Campus,RLMP  171 - 01   Private Music 14 – ½ Hour Violin         ,01-LEC Dynamic,Staff,16,0,16,0,0
2644,West Campus,WLEP  171 - 01   Intensive English 2,01-LEC Dynamic,Staff,30,0,30,0,0
1912,Wolfson Campus,WTMO  171 - 01   Microsoft Word 2013 - Basic,01-LEC Dynamic,Staff,20,0,20,0,0
3200,Kendall Campus,RLMP  170 - 01   Private Music 14 – 1 Hour Violin           ,01-LEC Dynamic,Staff,16,0,16,0,0
2645,West Campus,WLEP  170 - 01   Intensive English 3,01-LEC Dynamic,Staff,30,0,30,0,0
1752,Wolfson Campus,WLFL  169 - 01   Japanese 2 (28 Hours),01-LEC Dynamic,Staff,30,0,30,0,0
2222,Wolfson Campus,WLFL  169 - 02   Japanese 2 (28 Hours),02-LEC Dynamic,Staff,30,0,30,0,0
3010,Kendall Campus,RLKC  168 - 01   Microsoft Basic Publisher (Ages 12-16),01-LEC Dynamic,Staff,15,0,15,0,0
1165,Kendall Campus,WLEP  168 - 01   Coffee and Conversation - Intermediate (28 hours),01-LEC Dynamic,Staff,25,0,25,0,0
1166,Kendall Campus,WLEP  168 - 02   Coffee and Conversation - Intermediate (28 hours),02-LEC Dynamic,Staff,25,0,25,0,0
1469,Wolfson Campus,WLEP  168 - 03   Coffee and Conversation - Intermediate (28 hours),03-LEC Dynamic,Staff,16,0,16,0,0
1998,Wolfson Campus,WLEP  168 - 04   Coffee and Conversation - Intermediate (28 hours),04-LEC Dynamic,Staff,30,0,30,0,0
1748,Wolfson Campus,WLFL  168 - 01   Japanese 1 (28 Hours),01-LEC Dynamic,Staff,30,0,30,0,0
2221,Wolfson Campus,WLFL  168 - 02   Japanese 1 (28 Hours),02-LEC Dynamic,Staff,30,0,30,0,0
3631,Kendall Campus,WCTR  167 - 01   Language and Literacy: Best Practices,01-LEC Dynamic,Staff,20,0,20,0,0
1465,Wolfson Campus,WLEP  167 - 01   Coffee and Conversation - Intermediate,01-LEC Dynamic,Staff,16,0,16,0,0
1995,Wolfson Campus,WLEP  167 - 02   Coffee and Conversation - Intermediate,02-LEC Dynamic,Staff,30,0,30,0,0
1094,Kendall Campus,WLFL  167 - 01   Japanese 1 (21 hrs),01-LEC Dynamic,Staff,20,0,20,0,0
2092,Kendall Campus,WTNT  167 - 01   Microsoft Windows 8 - Avanzado,01-LEC Dynamic,Staff,15,0,15,0,0
1461,Wolfson Campus,WLEP  166 - 01   Coffee and Conversation - Beginners (28 hours),01-LEC Dynamic,Staff,16,0,16,0,0
1993,Wolfson Campus,WLEP  166 - 02   Coffee and Conversation - Beginners (28 hours),02-LEC Dynamic,Staff,30,0,30,0,0
2090,Kendall Campus,WTNT  166 - 01   Microsoft Windows 8 - Advanced,01-LEC Dynamic,Staff,15,0,15,0,0
1106,Kendall Campus,WLEP  165 - 01   American Sign Language 2,01-LEC Dynamic,Staff,25,0,25,0,0
2813,North Campus,WLEP  165 - 02   American Sign Language 2,02-LEC Dynamic,Staff,16,0,16,0,0
2815,North Campus,WLEP  165 - 03   American Sign Language 2,03-LEC Dynamic,Staff,16,0,16,0,0
3707,Wolfson Campus,WLEP  165 - 04   American Sign Language 2,04-LEC Dynamic,Staff,30,0,30,0,0
1093,Kendall Campus,WLFL  164 - 01   Italian 5 - Intensive,01-LEC Dynamic,Staff,25,0,25,0,0
1905,Wolfson Campus,WTMO  164 - 01   Microsoft Project 2013 - Basic,01-LEC Dynamic,Staff,20,0,20,0,0
1104,Kendall Campus,WLEP  163 - 01   American Sign Language 1,01-LEC Dynamic,Staff,25,0,25,0,0
1292,Homestead Campus,WLEP  163 - 02   American Sign Language 1,02-LEC Dynamic,Staff,25,0,25,0,0
1935,Wolfson Campus,WLEP  163 - 03   American Sign Language 1,03-LEC Dynamic,Staff,30,0,30,0,0
2266,Wolfson Campus,WLEP  163 - 04   American Sign Language 1,04-LEC Dynamic,Staff,25,0,25,0,0
2811,North Campus,WLEP  163 - 05   American Sign Language 1,05-LEC Dynamic,Staff,16,0,16,0,0
2818,North Campus,WLEP  163 - 06   American Sign Language 1,06-LEC Dynamic,Staff,16,0,16,0,0
1780,Wolfson Campus,WLFL  163 - 01   Italian 4 - Intensive,01-LEC Dynamic,Staff,30,0,30,0,0
2230,Wolfson Campus,WLFL  163 - 02   Italian 4 - Intensive,02-LEC Dynamic,Staff,30,0,30,0,0
1030,Homestead Campus,WTMO  163 - 01   Microsoft PowerPoint 2013,01-LEC Dynamic,Staff,25,0,25,0,0
2110,Kendall Campus,WTMO  163 - 02   Microsoft PowerPoint 2013,02-LEC Dynamic,Staff,15,0,15,0,0
3660,North Campus,WTMO  163 - 03   Microsoft PowerPoint 2013,03-LEC Dynamic,Staff,16,0,16,0,0
1092,Kendall Campus,WLFL  162 - 01   Italian 3 - Intensive,01-LEC Dynamic,Staff,25,0,25,0,0
1777,Wolfson Campus,WLFL  162 - 02   Italian 3 - Intensive,02-LEC Dynamic,Staff,30,0,30,0,0
2229,Wolfson Campus,WLFL  162 - 03   Italian 3 - Intensive,03-LEC Dynamic,Staff,30,0,30,0,0
1029,Homestead Campus,WTMO  162 - 01   Microsoft Outlook 2013,01-LEC Dynamic,Staff,25,0,25,0,0
2107,Kendall Campus,WTMO  162 - 02   Microsoft Outlook 2013,02-LEC Dynamic,Staff,15,0,15,0,0
3659,North Campus,WTMO  162 - 03   Microsoft Outlook 2013,03-LEC Dynamic,Staff,16,0,16,0,0
2988,Kendall Campus,RLKC  161 - 01   Dynamic Presentation Using MS PowerPoint (Ages 7 - 11),01-LEC Dynamic,Staff,16,0,16,0,0
2991,Kendall Campus,RLKC  161 - 02   Dynamic Presentation Using MS PowerPoint (Ages 7 - 11),02-LEC Dynamic,Staff,16,0,16,0,0
1083,Kendall Campus,WLEP  161 - 01   Advanced Listening and Speaking Skills,01-LEC Dynamic,Staff,16,0,16,0,0
1128,Kendall Campus,WLEP  161 - 02   Advanced Listening and Speaking Skills,02-LEC Dynamic,Staff,25,0,25,0,0
1091,Kendall Campus,WLFL  161 - 01   Italian 2 - Intensive,01-LEC Dynamic,Staff,25,0,25,0,0
1774,Wolfson Campus,WLFL  161 - 02   Italian 2 - Intensive,02-LEC Dynamic,Staff,30,0,30,0,0
2228,Wolfson Campus,WLFL  161 - 03   Italian 2 - Intensive,03-LEC Dynamic,Staff,30,0,30,0,0
1892,Wolfson Campus,WTMO  161 - 01   Microsoft Office 2013 Intermediate: Word· Excel and PowerPoint,01-LEC Dynamic,Staff,20,0,20,0,0
1914,Wolfson Campus,WTMO  161 - 02   Microsoft Office 2013 Intermediate: Word· Excel and PowerPoint,02-LEC Dynamic,Staff,20,0,20,0,0
3651,North Campus,WTMO  161 - 03   Microsoft Office 2013 Intermediate: Word· Excel and PowerPoint,03-LEC Dynamic,Staff,16,0,16,0,0
3652,North Campus,WTMO  161 - 04   Microsoft Office 2013 Intermediate: Word· Excel and PowerPoint,04-LEC Dynamic,Staff,16,0,16,0,0
3653,North Campus,WTMO  161 - 05   Microsoft Office 2013 Intermediate: Word· Excel and PowerPoint,05-LEC Dynamic,Staff,16,0,16,0,0
2400,North Campus,RLFS  160 - 01   Soccer Beginners (Ages 4 - 6),01-LEC Dynamic,Staff,16,0,16,5,0
2401,North Campus,RLFS  160 - 02   Soccer Beginners (Ages 4 - 6),02-LEC Dynamic,Staff,16,0,16,0,0
3215,Kendall Campus,RLMP  160 - 01   Private Music 7 – 1 Hour Sibling            ,01-LEC Dynamic,Staff,16,0,16,0,0
3219,Kendall Campus,RLMP  160 - 02   Private Music 7 – 1 Hour Sibling            ,02-LEC Dynamic,Staff,16,0,16,0,0
2164,Wolfson Campus,WLEP  160 - 01   Advanced Listening and Conversation 2 - 42 hr,01-LEC Dynamic,Staff,30,0,30,0,0
2165,Wolfson Campus,WLEP  160 - 02   Advanced Listening and Conversation 2 - 42 hr,02-LEC Dynamic,Staff,30,0,30,0,0
1090,Kendall Campus,WLFL  160 - 01   Italian 1 - Intensive,01-LEC Dynamic,Staff,25,0,25,0,0
1768,Wolfson Campus,WLFL  160 - 02   Italian 1 - Intensive,02-LEC Dynamic,Staff,30,0,30,0,0
2227,Wolfson Campus,WLFL  160 - 03   Italian 1 - Intensive,03-LEC Dynamic,Staff,30,0,30,0,0
1904,Wolfson Campus,WTMO  160 - 01   Microsoft Office 2013 Basic: Word· Excel and PowerPoint,01-LEC Dynamic,Staff,20,0,20,0,0
1913,Wolfson Campus,WTMO  160 - 02   Microsoft Office 2013 Basic: Word· Excel and PowerPoint,02-LEC Dynamic,Staff,20,0,20,0,0
2529,West Campus,WTMO  160 - 03   Microsoft Office 2013 Basic: Word· Excel and PowerPoint,03-LEC Dynamic,Staff,35,0,35,0,0
2530,West Campus,WTMO  160 - 04   Microsoft Office 2013 Basic: Word· Excel and PowerPoint,04-LEC Dynamic,Staff,35,0,35,0,0
3275,Kendall Campus,WTMO  160 - 05   Microsoft Office 2013 Basic: Word· Excel and PowerPoint,05-LEC Dynamic,Staff,16,0,16,0,0
3276,Kendall Campus,WTMO  160 - 06   Microsoft Office 2013 Basic: Word· Excel and PowerPoint,06-LEC Dynamic,Staff,16,0,16,0,0
3295,North Campus,RLFS  159 - 01   Karate – Shuri Ryu (16-Adult),01-LEC Dynamic,Staff,30,0,30,10,0
3216,Kendall Campus,RLMP  159 - 01   Private Music 7 – ½ Hour Sibling          ,01-LEC Dynamic,Staff,16,0,16,0,0
3220,Kendall Campus,RLMP  159 - 02   Private Music 7 – ½ Hour Sibling          ,02-LEC Dynamic,Staff,16,0,16,0,0
2398,North Campus,RLFS  158 - 01   Karate – Shuri Ryu (Ages 16 - Adult),01-LEC Dynamic,Staff,30,0,30,10,0
3212,Kendall Campus,RLMP  158 - 01   Private Music 14 – ½ Hour Sibling        ,01-LEC Dynamic,Staff,16,0,16,0,0
3011,Hialeah Campus,WLEP  158 - 01   Advanced Listening and Conversation 2 - 56 hr,01-LEC Dynamic,Staff,30,0,30,0,0
3013,Hialeah Campus,WLEP  158 - 02   Advanced Listening and Conversation 2 - 56 hr,02-LEC Dynamic,Staff,16,0,16,0,0
1916,Wolfson Campus,WTMO  158 - 01   Microsoft Office 2013 Básico: Word· Excel y PowerPoint,01-LEC Dynamic,Staff,20,0,20,0,0
2568,West Campus,WTMO  158 - 02   Microsoft Office 2013 Básico: Word· Excel y PowerPoint,02-LEC Dynamic,Staff,35,0,35,0,0
2570,West Campus,WTMO  158 - 03   Microsoft Office 2013 Básico: Word· Excel y PowerPoint,03-LEC Dynamic,Staff,16,0,16,0,0
2970,Hialeah Campus,WTMO  158 - 04   Microsoft Office 2013 Básico: Word· Excel y PowerPoint,04-LEC Dynamic,Staff,16,0,16,0,0
2971,Hialeah Campus,WTMO  158 - 05   Microsoft Office 2013 Básico: Word· Excel y PowerPoint,05-LEC Dynamic,Staff,16,0,16,0,0
3331,Kendall Campus,WTMO  158 - 06   Microsoft Office 2013 Básico: Word· Excel y PowerPoint,06-LEC Dynamic,Staff,16,0,16,0,0
3340,Kendall Campus,WTMO  158 - 07   Microsoft Office 2013 Básico: Word· Excel y PowerPoint,07-LEC Dynamic,Staff,16,0,16,0,0
3341,Kendall Campus,WTMO  158 - 08   Microsoft Office 2013 Básico: Word· Excel y PowerPoint,08-LEC Dynamic,Staff,16,0,16,0,0
3628,North Campus,WTMO  158 - 09   Microsoft Office 2013 Básico: Word· Excel y PowerPoint,09-LEC Dynamic,Staff,16,0,16,0,0
3629,North Campus,WTMO  158 - 10   Microsoft Office 2013 Básico: Word· Excel y PowerPoint,10-LEC Dynamic,Staff,16,0,16,0,0
3630,North Campus,WTMO  158 - 11   Microsoft Office 2013 Básico: Word· Excel y PowerPoint,11-LEC Dynamic,Staff,16,0,16,0,0
1261,Homestead Campus,RLFS  157 - 01   Self Defense,01-LEC Dynamic,Staff,25,0,25,0,0
2985,Kendall Campus,RLKC  156 - 01   Microsoft Basic Excel (Ages 7-11),01-LEC Dynamic,Staff,15,0,15,0,0
3009,Kendall Campus,RLKC  156 - 02   Microsoft Basic Excel (Ages 7-11),02-LEC Dynamic,Staff,15,0,15,0,0
1491,Wolfson Campus,WLEP  156 - 01   Advanced Listening and Conversation 1- 42hr,01-LEC Dynamic,Staff,16,0,16,0,0
1494,Wolfson Campus,WLEP  156 - 02   Advanced Listening and Conversation 1- 42hr,02-LEC Dynamic,Staff,16,0,16,0,0
1766,Wolfson Campus,WLFL  156 - 01   Italian 4,01-LEC Dynamic,Staff,30,0,30,0,0
2226,Wolfson Campus,WLFL  156 - 02   Italian 4,02-LEC Dynamic,Staff,30,0,30,0,0
1676,Kendall Campus,WCIS  155 - 01   CDA National Prep,01-LEC Dynamic,Staff,25,0,25,0,0
3007,Hialeah Campus,WLEP  155 - 01   Advanced Listening and Conversation 1 - 56 hr,01-LEC Dynamic,Staff,30,0,30,0,0
3008,Hialeah Campus,WLEP  155 - 02   Advanced Listening and Conversation 1 - 56 hr,02-LEC Dynamic,Staff,16,0,16,0,0
1764,Wolfson Campus,WLFL  155 - 01   Italian 3,01-LEC Dynamic,Staff,30,0,30,0,0
2225,Wolfson Campus,WLFL  155 - 02   Italian 3,02-LEC Dynamic,Staff,30,0,30,0,0
2123,Kendall Campus,WTMO  155 - 01   Microsoft Excel 2013 - Nivel 1,01-LEC Dynamic,Staff,15,0,15,0,0
3030,Hialeah Campus,WCIS  154 - 01   Aplicaciones Practicas de los Requisitos de VPK,01-LEC Dynamic,Staff,30,0,30,0,0
1082,Kendall Campus,WLEP  154 - 01   Intensive English 6 - 56 hrs,01-LEC Dynamic,Staff,30,0,30,0,0
1160,Kendall Campus,WLEP  154 - 02   Intensive English 6 - 56 hrs,02-LEC Dynamic,Staff,30,0,30,0,0
2805,North Campus,WLEP  154 - 03   Intensive English 6 - 56 hrs,03-LEC Dynamic,Staff,30,0,30,0,0
2807,North Campus,WLEP  154 - 04   Intensive English 6 - 56 hrs,04-LEC Dynamic,Staff,30,0,30,0,0
1762,Wolfson Campus,WLFL  154 - 01   Italian 2,01-LEC Dynamic,Staff,30,0,30,0,0
2224,Wolfson Campus,WLFL  154 - 02   Italian 2,02-LEC Dynamic,Staff,30,0,30,0,0
1028,Homestead Campus,WTMO  154 - 01   Microsoft Excel 2013 Level 2,01-LEC Dynamic,Staff,25,0,25,0,0
2104,Kendall Campus,WTMO  154 - 02   Microsoft Excel 2013 Level 2,02-LEC Dynamic,Staff,15,0,15,0,0
3658,North Campus,WTMO  154 - 04   Microsoft Excel 2013 Level 2,04-LEC Dynamic,Staff,16,0,16,0,0
3177,Kendall Campus,RLMP  153 - 01   Private Music 7 – ½ Hour Piano            ,01-LEC Dynamic,Staff,16,0,16,0,0
3180,Kendall Campus,RLMP  153 - 02   Private Music 7 – ½ Hour Piano            ,02-LEC Dynamic,Staff,16,0,16,0,0
3187,Kendall Campus,RLMP  153 - 03   Private Music 7 – ½ Hour Piano            ,03-LEC Dynamic,Staff,16,0,16,0,0
1081,Kendall Campus,WLEP  153 - 01   Intensive English 4 - 56 hrs,01-LEC Dynamic,Staff,30,0,30,0,0
1156,Kendall Campus,WLEP  153 - 02   Intensive English 4 - 56 hrs,02-LEC Dynamic,Staff,30,0,30,0,0
1157,Kendall Campus,WLEP  153 - 03   Intensive English 4 - 56 hrs,03-LEC Dynamic,Staff,30,0,30,0,0
2745,North Campus,WLEP  153 - 04   Intensive English 4 - 56 hrs,04-LEC Dynamic,Staff,30,0,30,0,0
2748,North Campus,WLEP  153 - 05   Intensive English 4 - 56 hrs,05-LEC Dynamic,Staff,30,0,30,0,0
2750,North Campus,WLEP  153 - 06   Intensive English 4 - 56 hrs,06-LEC Dynamic,Staff,30,0,30,0,0
2752,North Campus,WLEP  153 - 07   Intensive English 4 - 56 hrs,07-LEC Dynamic,Staff,30,0,30,0,0
1927,Wolfson Campus,WLFL  153 - 01   Italian 1,01-LEC Dynamic,Staff,30,0,30,0,0
2223,Wolfson Campus,WLFL  153 - 02   Italian 1,02-LEC Dynamic,Staff,30,0,30,0,0
1027,Homestead Campus,WTMO  153 - 01   Microsoft Excel 2013 Level 1,01-LEC Dynamic,Staff,25,0,25,0,0
2096,Kendall Campus,WTMO  153 - 02   Microsoft Excel 2013 Level 1,02-LEC Dynamic,Staff,15,0,15,0,0
2099,Kendall Campus,WTMO  153 - 03   Microsoft Excel 2013 Level 1,03-LEC Dynamic,Staff,15,0,15,0,0
2100,Kendall Campus,WTMO  153 - 04   Microsoft Excel 2013 Level 1,04-LEC Dynamic,Staff,15,0,15,0,0
2101,Kendall Campus,WTMO  153 - 05   Microsoft Excel 2013 Level 1,05-LEC Dynamic,Staff,16,0,16,0,0
3657,North Campus,WTMO  153 - 06   Microsoft Excel 2013 Level 1,06-LEC Dynamic,Staff,16,0,16,0,0
3387,Kendall Campus,RLFS  152 - 01   Ice Skating Beginning,01-LEC Dynamic,Staff,15,0,15,0,0
3388,Kendall Campus,RLFS  152 - 02   Ice Skating Beginning,02-LEC Dynamic,Staff,15,0,15,0,0
3389,Kendall Campus,RLFS  152 - 03   Ice Skating Beginning,03-LEC Dynamic,Staff,15,0,15,0,0
3390,Kendall Campus,RLFS  152 - 04   Ice Skating Beginning,04-LEC Dynamic,Staff,15,0,15,0,0
3175,Kendall Campus,RLMP  152 - 01   Private Music 14 – 1 Hour Piano            ,01-LEC Dynamic,Staff,16,0,16,0,0
1080,Kendall Campus,WLEP  152 - 01   Intensive English 3 - 56 hrs,01-LEC Dynamic,Staff,30,0,30,0,0
1151,Kendall Campus,WLEP  152 - 02   Intensive English 3 - 56 hrs,02-LEC Dynamic,Staff,30,0,30,0,0
1152,Kendall Campus,WLEP  152 - 03   Intensive English 3 - 56 hrs,03-LEC Dynamic,Staff,30,0,30,0,0
2727,North Campus,WLEP  152 - 04   Intensive English 3 - 56 hrs,04-LEC Dynamic,Staff,30,0,30,0,0
2728,North Campus,WLEP  152 - 05   Intensive English 3 - 56 hrs,05-LEC Dynamic,Staff,30,0,30,0,0
2731,North Campus,WLEP  152 - 06   Intensive English 3 - 56 hrs,06-LEC Dynamic,Staff,30,0,30,0,0
2736,North Campus,WLEP  152 - 07   Intensive English 3 - 56 hrs,07-LEC Dynamic,Staff,30,0,30,0,0
1919,Wolfson Campus,WLFL  152 - 01   Italian - Quick for Travelers,01-LEC Dynamic,Staff,30,0,30,0,0
1920,Wolfson Campus,WLFL  152 - 02   Italian - Quick for Travelers,02-LEC Dynamic,Staff,30,0,30,0,0
2231,Wolfson Campus,WLFL  152 - 03   Italian - Quick for Travelers,03-LEC Dynamic,Staff,30,0,30,0,0
2232,Wolfson Campus,WLFL  152 - 04   Italian - Quick for Travelers,04-LEC Dynamic,Staff,30,0,30,0,0
2968,Hialeah Campus,WTMO  152 - 01   Microsoft Excel 2013 Intermedio,01-LEC Dynamic,Staff,16,0,16,0,0
2969,Hialeah Campus,WTMO  152 - 02   Microsoft Excel 2013 Intermedio,02-LEC Dynamic,Staff,16,0,16,0,0
1079,Kendall Campus,WLEP  151 - 01   Intensive English 2 - 56 hr,01-LEC Dynamic,Staff,30,0,30,0,0
1150,Kendall Campus,WLEP  151 - 02   Intensive English 2 - 56 hr,02-LEC Dynamic,Staff,30,0,30,0,0
2382,North Campus,WLEP  151 - 03   Intensive English 2 - 56 hr,03-LEC Dynamic,Staff,30,0,30,0,0
2383,North Campus,WLEP  151 - 04   Intensive English 2 - 56 hr,04-LEC Dynamic,Staff,30,0,30,0,0
2384,North Campus,WLEP  151 - 05   Intensive English 2 - 56 hr,05-LEC Dynamic,Staff,30,0,30,0,0
2385,North Campus,WLEP  151 - 06   Intensive English 2 - 56 hr,06-LEC Dynamic,Staff,30,0,30,0,0
3765,Kendall Campus,WLFL  151 - 01   Storia Della Cucina Italiana,01-LEC Dynamic,Staff,20,0,20,0,0
3767,Kendall Campus,WLFL  151 - 02   Storia Della Cucina Italiana,02-LEC Dynamic,Staff,16,0,16,0,0
1906,Wolfson Campus,WTMO  151 - 01   Microsoft Excel 2013 Basic,01-LEC Dynamic,Staff,20,0,20,0,0
1915,Wolfson Campus,WTMO  151 - 02   Microsoft Excel 2013 Basic,02-LEC Dynamic,Staff,20,0,20,0,0
3794,Kendall Campus,RLFS  150 - 01   Horseback Riding for Kids (Ages 6-12),01-LEC Dynamic,Staff,15,0,15,0,0
3795,Kendall Campus,RLFS  150 - 02   Horseback Riding for Kids (Ages 6-12),02-LEC Dynamic,Staff,15,0,15,0,0
3179,Kendall Campus,RLMP  150 - 01   Private Music 7 – 1 Hour Piano              ,01-LEC Dynamic,Staff,16,0,16,0,0
3183,Kendall Campus,RLMP  150 - 02   Private Music 7 – 1 Hour Piano              ,02-LEC Dynamic,Staff,16,0,16,0,0
1698,Kendall Campus,WCIS  150 - 01   Tecnología para Profesionales que Trabajan en Centros de Cuidado de Niños - Principiantes,01-LEC Dynamic,Staff,15,0,15,0,0
2551,Hialeah Campus,WCIS  150 - 02   Tecnología para Profesionales que Trabajan en Centros de Cuidado de Niños - Principiantes,02-LEC Dynamic,Staff,16,0,16,0,0
1078,Kendall Campus,WLEP  150 - 01   Intensive English 1 - 56 hr,01-LEC Dynamic,Staff,30,0,30,0,0
1133,Kendall Campus,WLEP  150 - 02   Intensive English 1 - 56 hr,02-LEC Dynamic,Staff,30,0,30,0,0
1145,Kendall Campus,WLEP  150 - 03   Intensive English 1 - 56 hr,03-LEC Dynamic,Staff,30,0,30,0,0
2373,North Campus,WLEP  150 - 04   Intensive English 1 - 56 hr,04-LEC Dynamic,Staff,30,0,30,0,0
2374,North Campus,WLEP  150 - 05   Intensive English 1 - 56 hr,05-LEC Dynamic,Staff,30,0,30,0,0
2808,North Campus,WLEP  150 - 06   Intensive English 1 - 56 hr,06-LEC Dynamic,Staff,30,0,30,0,0
2809,North Campus,WLEP  150 - 07   Intensive English 1 - 56 hr,07-LEC Dynamic,Staff,30,0,30,0,0
1909,Wolfson Campus,WTMO  150 - 01   Microsoft Excel 2013 Intermediate,01-LEC Dynamic,Staff,20,0,20,0,0
3624,North Campus,WTMO  150 - 02   Microsoft Excel 2013 Intermediate,02-LEC Dynamic,Staff,16,0,16,0,0
1431,Wolfson Campus,WLEP  149 - 03   Intensive English 7 - 84 hrs,03-LEC Dynamic,Staff,30,0,30,0,0
1432,Wolfson Campus,WLEP  149 - 04   Intensive English 7 - 84 hrs,04-LEC Dynamic,Staff,30,0,30,0,0
1972,Wolfson Campus,WLEP  149 - 05   Intensive English 7 - 84 hrs,05-LEC Dynamic,Staff,30,0,30,0,0
1974,Wolfson Campus,WLEP  149 - 06   Intensive English 7 - 84 hrs,06-LEC Dynamic,Staff,30,0,30,0,0
1975,Wolfson Campus,WLEP  149 - 07   Intensive English 7 - 84 hrs,07-LEC Dynamic,Staff,30,0,30,0,0
1430,West Campus,WLEP  149 - 08   Intensive English 7 - 84 hrs,08-LEC Dynamic,Staff,30,0,30,0,0
1429,West Campus,WLEP  149 - 09   Intensive English 7 - 84 hrs,09-LEC Dynamic,Staff,30,0,30,0,0
1163,West Campus,WLEP  148 - 02   Intensive English 6 - 84 hrs,02-LEC Dynamic,Staff,30,0,30,0,0
1425,Wolfson Campus,WLEP  148 - 03   Intensive English 6 - 84 hrs,03-LEC Dynamic,Staff,30,0,30,0,0
1426,Wolfson Campus,WLEP  148 - 04   Intensive English 6 - 84 hrs,04-LEC Dynamic,Staff,30,0,30,0,0
1427,Wolfson Campus,WLEP  148 - 05   Intensive English 6 - 84 hrs,05-LEC Dynamic,Staff,30,0,30,0,0
1428,Wolfson Campus,WLEP  148 - 06   Intensive English 6 - 84 hrs,06-LEC Dynamic,Staff,30,0,30,0,0
1960,Wolfson Campus,WLEP  148 - 07   Intensive English 6 - 84 hrs,07-LEC Dynamic,Staff,30,0,30,0,0
1970,Wolfson Campus,WLEP  148 - 08   Intensive English 6 - 84 hrs,08-LEC Dynamic,Staff,30,0,30,0,0
1971,Wolfson Campus,WLEP  148 - 09   Intensive English 6 - 84 hrs,09-LEC Dynamic,Staff,30,0,30,0,0
1076,West Campus,WLEP  148 - 10   Intensive English 6 - 84 hrs,10-LEC Dynamic,Staff,30,0,30,0,0
2094,Kendall Campus,WTMO  148 - 01   Microsoft Access 2013 Level 2,01-LEC Dynamic,Staff,15,0,15,0,0
3538,Kendall Campus,WLEP  147 - 02   Intensive English 5 - 84 hrs,02-LEC Dynamic,Staff,30,0,30,0,0
1233,Wolfson Campus,WLEP  147 - 03   Intensive English 5 - 84 hrs,03-LEC Dynamic,Staff,30,0,30,0,0
1235,Wolfson Campus,WLEP  147 - 04   Intensive English 5 - 84 hrs,04-LEC Dynamic,Staff,30,0,30,0,0
1236,Wolfson Campus,WLEP  147 - 05   Intensive English 5 - 84 hrs,05-LEC Dynamic,Staff,30,0,30,0,0
1475,InterAmerican Campus,WLEP  147 - 06   Intensive English 5 - 84 hrs,06-LEC Dynamic,Staff,30,0,30,0,0
1953,Wolfson Campus,WLEP  147 - 07   Intensive English 5 - 84 hrs,07-LEC Dynamic,Staff,30,0,30,0,0
1957,Wolfson Campus,WLEP  147 - 08   Intensive English 5 - 84 hrs,08-LEC Dynamic,Staff,30,0,30,0,0
1959,Wolfson Campus,WLEP  147 - 09   Intensive English 5 - 84 hrs,09-LEC Dynamic,Staff,30,0,30,0,0
2443,Hialeah Campus,WLEP  147 - 10   Intensive English 5 - 84 hrs,10-LEC Dynamic,Staff,30,0,30,0,0
2778,North Campus,WLEP  147 - 11   Intensive English 5 - 84 hrs,11-LEC Dynamic,Staff,30,0,30,0,0
2781,North Campus,WLEP  147 - 12   Intensive English 5 - 84 hrs,12-LEC Dynamic,Staff,30,0,30,0,0
3720,Wolfson Campus,WLEP  147 - 14   Intensive English 5 - 84 hrs,14-LEC Dynamic,Staff,30,0,30,0,0
3539,Kendall Campus,WLEP  147 - 15   Intensive English 5 - 84 hrs,15-LEC Dynamic,Staff,30,0,30,0,0
1231,West Campus,WLEP  147 - 16   Intensive English 5 - 84 hrs,16-LEC Dynamic,Staff,30,0,30,0,0
1075,West Campus,WLEP  147 - 17   Intensive English 5 - 84 hrs,17-LEC Dynamic,Staff,30,0,30,0,0
2093,Kendall Campus,WTMO  147 - 01   Microsoft Access 2013 Level 1,01-LEC Dynamic,Staff,15,0,15,0,0
3656,North Campus,WTMO  147 - 02   Microsoft Access 2013 Level 1,02-LEC Dynamic,Staff,16,0,16,0,0
3000,Kendall Campus,RLKC  146 - 01   Microsoft Basic Excel (Ages 12-16),01-LEC Dynamic,Staff,15,0,15,0,0
3003,Kendall Campus,RLKC  146 - 02   Microsoft Basic Excel (Ages 12-16),02-LEC Dynamic,Staff,15,0,15,0,0
2638,West Campus,WLEP  146 - 01   Intensive English 4 - 84 hrs,01-LEC Dynamic,Staff,30,0,30,0,0
1159,Kendall Campus,WLEP  146 - 02   Intensive English 4 - 84 hrs,02-LEC Dynamic,Staff,30,0,30,0,0
1220,Wolfson Campus,WLEP  146 - 03   Intensive English 4 - 84 hrs,03-LEC Dynamic,Staff,30,0,30,0,0
1221,Wolfson Campus,WLEP  146 - 04   Intensive English 4 - 84 hrs,04-LEC Dynamic,Staff,30,0,30,0,0
1225,Wolfson Campus,WLEP  146 - 05   Intensive English 4 - 84 hrs,05-LEC Dynamic,Staff,30,0,30,0,0
1228,Wolfson Campus,WLEP  146 - 06   Intensive English 4 - 84 hrs,06-LEC Dynamic,Staff,30,0,30,0,0
1230,Wolfson Campus,WLEP  146 - 07   Intensive English 4 - 84 hrs,07-LEC Dynamic,Staff,30,0,30,0,0
1471,InterAmerican Campus,WLEP  146 - 08   Intensive English 4 - 84 hrs,08-LEC Dynamic,Staff,30,0,30,0,0
1473,InterAmerican Campus,WLEP  146 - 09   Intensive English 4 - 84 hrs,09-LEC Dynamic,Staff,30,0,30,0,0
1947,Wolfson Campus,WLEP  146 - 10   Intensive English 4 - 84 hrs,10-LEC Dynamic,Staff,30,0,30,0,0
1948,Wolfson Campus,WLEP  146 - 11   Intensive English 4 - 84 hrs,11-LEC Dynamic,Staff,30,0,30,0,0
1949,Wolfson Campus,WLEP  146 - 12   Intensive English 4 - 84 hrs,12-LEC Dynamic,Staff,30,0,30,0,0
1951,Wolfson Campus,WLEP  146 - 13   Intensive English 4 - 84 hrs,13-LEC Dynamic,Staff,30,0,30,0,0
2442,Hialeah Campus,WLEP  146 - 14   Intensive English 4 - 84 hrs,14-LEC Dynamic,Staff,30,0,30,0,0
2754,North Campus,WLEP  146 - 16   Intensive English 4 - 84 hrs,16-LEC Dynamic,Staff,30,0,30,0,0
2755,North Campus,WLEP  146 - 17   Intensive English 4 - 84 hrs,17-LEC Dynamic,Staff,30,0,30,0,0
3529,Kendall Campus,WLEP  146 - 18   Intensive English 4 - 84 hrs,18-LEC Dynamic,Staff,30,0,30,0,0
3532,Kendall Campus,WLEP  146 - 19   Intensive English 4 - 84 hrs,19-LEC Dynamic,Staff,30,0,30,0,0
3719,Wolfson Campus,WLEP  146 - 20   Intensive English 4 - 84 hrs,20-LEC Dynamic,Staff,30,0,30,0,0
1074,West Campus,WLEP  146 - 22   Intensive English 4 - 84 hrs,22-LEC Dynamic,Staff,30,0,30,0,0
1371,Wolfson Campus,WTCA  146 - 01   SketchUp for Interior Decorating - Intermediate,01-LEC Dynamic,Staff,20,0,20,0,0
1883,Wolfson Campus,WTMO  146 - 01   Microsoft Access 2013 Basic,01-LEC Dynamic,Staff,20,0,20,0,0
1910,Wolfson Campus,WTMO  146 - 02   Microsoft Access 2013 Basic,02-LEC Dynamic,Staff,20,0,20,0,0
2636,West Campus,WLEP  145 - 01   Intensive English 3 - 84 hrs,01-LEC Dynamic,Staff,30,0,30,0,0
2637,West Campus,WLEP  145 - 02   Intensive English 3 - 84 hrs,02-LEC Dynamic,Staff,30,0,30,0,0
1205,West Campus,WLEP  145 - 03   Intensive English 3 - 84 hrs,03-LEC Dynamic,Staff,30,0,30,0,0
1206,Wolfson Campus,WLEP  145 - 04   Intensive English 3 - 84 hrs,04-LEC Dynamic,Staff,30,0,30,0,0
1208,Wolfson Campus,WLEP  145 - 05   Intensive English 3 - 84 hrs,05-LEC Dynamic,Staff,30,0,30,0,0
1210,Wolfson Campus,WLEP  145 - 06   Intensive English 3 - 84 hrs,06-LEC Dynamic,Staff,30,0,30,0,0
1219,Wolfson Campus,WLEP  145 - 07   Intensive English 3 - 84 hrs,07-LEC Dynamic,Staff,30,0,30,0,0
1466,InterAmerican Campus,WLEP  145 - 08   Intensive English 3 - 84 hrs,08-LEC Dynamic,Staff,30,0,30,0,0
1468,InterAmerican Campus,WLEP  145 - 09   Intensive English 3 - 84 hrs,09-LEC Dynamic,Staff,30,0,30,0,0
1943,Wolfson Campus,WLEP  145 - 10   Intensive English 3 - 84 hrs,10-LEC Dynamic,Staff,30,0,30,0,0
1944,Wolfson Campus,WLEP  145 - 11   Intensive English 3 - 84 hrs,11-LEC Dynamic,Staff,30,0,30,0,0
1945,Wolfson Campus,WLEP  145 - 12   Intensive English 3 - 84 hrs,12-LEC Dynamic,Staff,30,0,30,0,0
1946,Wolfson Campus,WLEP  145 - 13   Intensive English 3 - 84 hrs,13-LEC Dynamic,Staff,30,0,30,0,0
2440,Hialeah Campus,WLEP  145 - 14   Intensive English 3 - 84 hrs,14-LEC Dynamic,Staff,30,0,30,0,0
2441,Hialeah Campus,WLEP  145 - 15   Intensive English 3 - 84 hrs,15-LEC Dynamic,Staff,30,0,30,0,0
1073,West Campus,WLEP  145 - 19   Intensive English 3 - 84 hrs,19-LEC Dynamic,Staff,30,0,30,0,0
2740,North Campus,WLEP  145 - 20   Intensive English 3 - 84 hrs,20-LEC Dynamic,Staff,30,0,30,0,0
2742,North Campus,WLEP  145 - 21   Intensive English 3 - 84 hrs,21-LEC Dynamic,Staff,30,0,30,0,0
3527,Kendall Campus,WLEP  145 - 22   Intensive English 3 - 84 hrs,22-LEC Dynamic,Staff,30,0,30,0,0
3528,Kendall Campus,WLEP  145 - 23   Intensive English 3 - 84 hrs,23-LEC Dynamic,Staff,30,0,30,0,0
1154,West Campus,WLEP  145 - 27   Intensive English 3 - 84 hrs,27-LEC Dynamic,Staff,30,0,30,0,0
2634,West Campus,WLEP  145 - 28   Intensive English 3 - 84 hrs,28-LEC Dynamic,Staff,30,0,30,0,0
2635,West Campus,WLEP  145 - 29   Intensive English 3 - 84 hrs,29-LEC Dynamic,Staff,30,0,30,0,0
1370,Wolfson Campus,WTCA  145 - 01   SketchUp for Interior Decorating - Basics,01-LEC Dynamic,Staff,25,0,25,0,0
1052,Homestead Campus,WCIS  144 - 01   Operación de un Centro Infantil (Credencial de Director),01-LEC Dynamic,Staff,25,0,25,0,0
1565,InterAmerican Campus,WCIS  144 - 02   Operación de un Centro Infantil (Credencial de Director),02-LEC Dynamic,Staff,25,0,25,0,0
1681,Kendall Campus,WCIS  144 - 03   Operación de un Centro Infantil (Credencial de Director),03-LEC Dynamic,Staff,25,0,25,0,0
2549,Hialeah Campus,WCIS  144 - 04   Operación de un Centro Infantil (Credencial de Director),04-LEC Dynamic,Staff,30,0,30,0,0
1072,West Campus,WLEP  144 - 01   Intensive English 2 - 84 hrs,01-LEC Dynamic,Staff,30,0,30,0,0
1148,West Campus,WLEP  144 - 02   Intensive English 2 - 84 hrs,02-LEC Dynamic,Staff,30,0,30,0,0
1186,Wolfson Campus,WLEP  144 - 03   Intensive English 2 - 84 hrs,03-LEC Dynamic,Staff,30,0,30,0,0
1189,Wolfson Campus,WLEP  144 - 04   Intensive English 2 - 84 hrs,04-LEC Dynamic,Staff,30,0,30,0,0
1192,Wolfson Campus,WLEP  144 - 05   Intensive English 2 - 84 hrs,05-LEC Dynamic,Staff,30,0,30,0,0
1196,Wolfson Campus,WLEP  144 - 06   Intensive English 2 - 84 hrs,06-LEC Dynamic,Staff,30,0,30,0,0
1200,Wolfson Campus,WLEP  144 - 07   Intensive English 2 - 84 hrs,07-LEC Dynamic,Staff,30,0,30,0,0
1457,InterAmerican Campus,WLEP  144 - 08   Intensive English 2 - 84 hrs,08-LEC Dynamic,Staff,30,0,30,0,0
1459,InterAmerican Campus,WLEP  144 - 09   Intensive English 2 - 84 hrs,09-LEC Dynamic,Staff,30,0,30,0,0
1939,Wolfson Campus,WLEP  144 - 10   Intensive English 2 - 84 hrs,10-LEC Dynamic,Staff,30,0,30,0,0
1940,Wolfson Campus,WLEP  144 - 11   Intensive English 2 - 84 hrs,11-LEC Dynamic,Staff,30,0,30,0,0
1941,Wolfson Campus,WLEP  144 - 12   Intensive English 2 - 84 hrs,12-LEC Dynamic,Staff,30,0,30,0,0
1942,Wolfson Campus,WLEP  144 - 13   Intensive English 2 - 84 hrs,13-LEC Dynamic,Staff,30,0,30,0,0
2438,Hialeah Campus,WLEP  144 - 14   Intensive English 2 - 84 hrs,14-LEC Dynamic,Staff,30,0,30,0,0
2439,Hialeah Campus,WLEP  144 - 15   Intensive English 2 - 84 hrs,15-LEC Dynamic,Staff,30,0,30,0,0
2785,North Campus,WLEP  144 - 18   Intensive English 2 - 84 hrs,18-LEC Dynamic,Staff,30,0,30,0,0
2788,North Campus,WLEP  144 - 19   Intensive English 2 - 84 hrs,19-LEC Dynamic,Staff,30,0,30,0,0
2632,West Campus,WLEP  144 - 20   Intensive English 2 - 84 hrs,20-LEC Dynamic,Staff,30,0,30,0,0
3524,Kendall Campus,WLEP  144 - 21   Intensive English 2 - 84 hrs,21-LEC Dynamic,Staff,30,0,30,0,0
3525,Kendall Campus,WLEP  144 - 22   Intensive English 2 - 84 hrs,22-LEC Dynamic,Staff,30,0,30,0,0
2633,West Campus,WLEP  144 - 26   Intensive English 2 - 84 hrs,26-LEC Dynamic,Staff,30,0,30,0,0
1089,Kendall Campus,WLFL  144 - 01   German 2 - Intensive,01-LEC Dynamic,Staff,25,0,25,0,0
1771,Wolfson Campus,WTCA  144 - 01   Lumion - Basic,01-LEC Dynamic,Staff,20,0,20,0,0
1627,InterAmerican Campus,RLKC  143 - 01   Mixed-Media Art,01-LEC Dynamic,Staff,16,0,16,0,0
2020,Wolfson Campus,WBIE  143 - 01   Tools for International Trading,01-LEC Dynamic,Staff,20,0,20,0,0
1147,West Campus,WLEP  143 - 01   Intensive English 1 84 hrs,01-LEC Dynamic,Staff,30,0,30,0,0
1071,West Campus,WLEP  143 - 03   Intensive English 1 84 hrs,03-LEC Dynamic,Staff,30,0,30,0,0
1162,Wolfson Campus,WLEP  143 - 04   Intensive English 1 84 hrs,04-LEC Dynamic,Staff,30,0,30,0,0
1174,Wolfson Campus,WLEP  143 - 05   Intensive English 1 84 hrs,05-LEC Dynamic,Staff,30,0,30,0,0
1177,Wolfson Campus,WLEP  143 - 06   Intensive English 1 84 hrs,06-LEC Dynamic,Staff,30,0,30,0,0
1182,Wolfson Campus,WLEP  143 - 07   Intensive English 1 84 hrs,07-LEC Dynamic,Staff,30,0,30,0,0
1456,InterAmerican Campus,WLEP  143 - 08   Intensive English 1 84 hrs,08-LEC Dynamic,Staff,30,0,30,0,0
1936,Wolfson Campus,WLEP  143 - 09   Intensive English 1 84 hrs,09-LEC Dynamic,Staff,30,0,30,0,0
1937,Wolfson Campus,WLEP  143 - 10   Intensive English 1 84 hrs,10-LEC Dynamic,Staff,30,0,30,0,0
1938,Wolfson Campus,WLEP  143 - 11   Intensive English 1 84 hrs,11-LEC Dynamic,Staff,30,0,30,0,0
2376,North Campus,WLEP  143 - 12   Intensive English 1 84 hrs,12-LEC Dynamic,Staff,30,0,30,0,0
2377,North Campus,WLEP  143 - 13   Intensive English 1 84 hrs,13-LEC Dynamic,Staff,30,0,30,0,0
2378,North Campus,WLEP  143 - 14   Intensive English 1 84 hrs,14-LEC Dynamic,Staff,30,0,30,0,0
2379,North Campus,WLEP  143 - 15   Intensive English 1 84 hrs,15-LEC Dynamic,Staff,30,0,30,0,0
1412,West Campus,WLEP  143 - 16   Intensive English 1 84 hrs,16-LEC Dynamic,Staff,30,0,30,0,0
2436,Hialeah Campus,WLEP  143 - 17   Intensive English 1 84 hrs,17-LEC Dynamic,Staff,30,0,30,0,0
2437,Hialeah Campus,WLEP  143 - 18   Intensive English 1 84 hrs,18-LEC Dynamic,Staff,30,0,30,0,0
2422,West Campus,WLEP  143 - 19   Intensive English 1 84 hrs,19-LEC Dynamic,Staff,30,0,30,0,0
3521,Kendall Campus,WLEP  143 - 21   Intensive English 1 84 hrs,21-LEC Dynamic,Staff,30,0,30,0,0
3522,Kendall Campus,WLEP  143 - 22   Intensive English 1 84 hrs,22-LEC Dynamic,Staff,30,0,30,0,0
2631,West Campus,WLEP  143 - 24   Intensive English 1 84 hrs,24-LEC Dynamic,Staff,30,0,30,0,0
2355,Kendall Campus,WBIE  142 - 01   Normas de Aduana: Derechos e Impuestos II,01-LEC Dynamic,Staff,25,0,25,0,0
2166,Wolfson Campus,WLEP  142 - 01   Public Speaking for ESL 2 - 42 hrs,01-LEC Dynamic,Staff,30,0,30,0,0
2354,Kendall Campus,WBIE  141 - 01   Normas de Aduana: Derechos e Impuestos I,01-LEC Dynamic,Staff,25,0,25,0,0
1054,Homestead Campus,WCIS  141 - 01   Mente en Formación (4.5 CEU's),01-LEC Dynamic,Staff,25,0,25,0,0
1678,Kendall Campus,WCIS  141 - 02   Mente en Formación (4.5 CEU's),02-LEC Dynamic,Staff,25,0,25,0,0
1498,Wolfson Campus,WLEP  141 - 01   Public Speaking for ESL 1 - 42 hrs,01-LEC Dynamic,Staff,30,0,30,0,0
2427,Hialeah Campus,WLEP  141 - 02   Public Speaking for ESL 1 - 42 hrs,02-LEC Dynamic,Staff,30,0,30,0,0
3332,Kendall Campus,WTNT  141 - 01   Introducción a la Computadora con Windows 8,01-LEC Dynamic,Staff,16,0,16,0,0
3334,Kendall Campus,WTNT  141 - 02   Introducción a la Computadora con Windows 8,02-LEC Dynamic,Staff,16,0,16,0,0
2312,Kendall Campus,WBIE  140 - 01   Mercadeando su Negocio de Importación y Exportación,01-LEC Dynamic,Staff,25,0,25,0,0
3601,Wolfson Campus,WBIE  140 - 02   Mercadeando su Negocio de Importación y Exportación,02-LEC Dynamic,Staff,25,0,25,0,0
3031,Hialeah Campus,WCIS  140 - 01   Manejo del Niño Autista,01-LEC Dynamic,Staff,30,0,30,0,0
3137,Hialeah Campus,WTNT  140 - 01   Introducción a la Computadora con Windows 7,01-LEC Dynamic,Staff,16,0,16,0,0
3139,Hialeah Campus,WTNT  140 - 02   Introducción a la Computadora con Windows 7,02-LEC Dynamic,Staff,16,0,16,0,0
3141,Hialeah Campus,WTNT  140 - 03   Introducción a la Computadora con Windows 7,03-LEC Dynamic,Staff,16,0,16,0,0
3037,Kendall Campus,RLKC  139 - 01   LEGO® EV3: Robotics Engineering Level 2,01-LEC Dynamic,Staff,15,0,15,0,0
2939,Kendall Campus,RLMP  139 - 01   Guitar Kids Group (Ages 8 - 15),01-LEC Dynamic,Staff,20,0,20,0,0
2370,Kendall Campus,WBFI  139 - 01   Wills & Trusts: The Financial Planning Aspect,01-LAB Dynamic,Staff,25,0,25,0,0
2298,Kendall Campus,WBIE  139 - 01   Marketing your Import and Export Business,01-LEC Dynamic,Staff,16,0,16,0,0
3788,Wolfson Campus,WBIE  139 - 02   Marketing your Import and Export Business,02-LEC Dynamic,Staff,30,0,30,0,0
3329,Hialeah Campus,WCIS  139 - 01   Classroom Management Techniques for Child Care Center,01-LEC Dynamic,Staff,16,0,16,0,0
3383,Kendall Campus,RLFS  138 - 01   Karate Tae Kwon Do All Levels (Ages 6 and up),01-LEC Dynamic,Staff,16,0,16,0,0
3384,Kendall Campus,RLFS  138 - 02   Karate Tae Kwon Do All Levels (Ages 6 and up),02-LEC Dynamic,Staff,16,0,16,0,0
3385,Kendall Campus,RLFS  138 - 03   Karate Tae Kwon Do All Levels (Ages 6 and up),03-LEC Dynamic,Staff,16,0,16,0,0
3386,Kendall Campus,RLFS  138 - 04   Karate Tae Kwon Do All Levels (Ages 6 and up),04-LEC Dynamic,Staff,16,0,16,0,0
3040,Kendall Campus,RLKC  138 - 01   LEGO® EV3 Robotics: Engineering and Design Level 2,01-LEC Dynamic,Staff,15,0,15,0,0
2679,Kendall Campus,WBFI  138 - 01   Técnicas de Inversión en el Mercado de Valores,01-LEC Dynamic,Staff,20,0,20,0,0
2309,Kendall Campus,WBIE  138 - 01   Logistics Management II,01-LEC Dynamic,Staff,25,0,25,0,0
1060,Homestead Campus,WCTR  138 - 01   DCF Make-up: Identifying Child Abuse and Neglect,01-LEC Dynamic,Staff,25,0,25,0,0
1666,Wolfson Campus,WLEP  138 - 01   ESL Placement Exam,01-LEC Dynamic,Staff,30,0,30,0,0
2433,Hialeah Campus,WLEP  138 - 02   ESL Placement Exam,02-LEC Dynamic,Staff,30,0,30,0,0
2434,Hialeah Campus,WLEP  138 - 03   ESL Placement Exam,03-LEC Dynamic,Staff,30,0,30,0,0
2435,Hialeah Campus,WLEP  138 - 04   ESL Placement Exam,04-LEC Dynamic,Staff,30,0,30,0,0
3582,Kendall Campus,WLEP  138 - 05   ESL Placement Exam,05-LEC Dynamic,Staff,30,0,30,0,0
1758,Wolfson Campus,WTWD  138 - 01   HTML5 and CSS3 Techniques,01-LEC Dynamic,Staff,20,0,20,0,0
1890,Kendall Campus,WTWD  138 - 02   HTML5 and CSS3 Techniques,02-LEC Dynamic,Staff,15,0,15,0,0
1656,InterAmerican Campus,RLDA  137 - 01   Salsa· Merengue and Bachata Series,01-LEC Dynamic,Staff,25,0,25,0,0
3444,Kendall Campus,RLFS  137 - 01   Karate Shotokan All Levels,01-LEC Dynamic,Staff,16,0,16,0,0
3446,Kendall Campus,RLFS  137 - 02   Karate Shotokan All Levels,02-LEC Dynamic,Staff,16,0,16,0,0
3036,Kendall Campus,RLKC  137 - 01   LEGO® EV3: Robotics Engineering Level 1,01-LEC Dynamic,Staff,15,0,15,0,0
2677,Kendall Campus,WBFI  137 - 01   Retirement Workshop: Utilizing Long Term Care and Life Insurance,01-LEC Dynamic,Staff,20,0,20,0,0
3263,Wolfson Campus,WBFI  137 - 02   Retirement Workshop: Utilizing Long Term Care and Life Insurance,02-LEC Dynamic,Staff,30,0,30,0,0
3581,Kendall Campus,WLEP  137 - 01   ESL Orientation,01-LEC Dynamic,Staff,30,0,30,0,0
1746,Wolfson Campus,WLFL  137 - 01   German 2,01-LEC Dynamic,Staff,30,0,30,0,0
2220,Wolfson Campus,WLFL  137 - 02   German 2,02-LEC Dynamic,Staff,30,0,30,0,0
1879,Wolfson Campus,WTCA  137 - 01   Google SketchUp Intermediate,01-LEC Dynamic,Staff,20,0,20,0,0
1917,Wolfson Campus,WTCA  137 - 02   Google SketchUp Intermediate,02-LEC Dynamic,Staff,20,0,20,0,0
3014,Kendall Campus,RLDA  136 - 01   Flamenco for Youth (Ages 10 - 16),01-LEC Dynamic,Staff,20,0,20,0,0
3015,Kendall Campus,RLDA  136 - 02   Flamenco for Youth (Ages 10 - 16),02-LEC Dynamic,Staff,20,0,20,0,0
2678,Kendall Campus,WBFI  136 - 01   Retirement Workshop: Solving the Annuity Puzzle,01-LEC Dynamic,Staff,20,0,20,0,0
3262,Wolfson Campus,WBFI  136 - 02   Retirement Workshop: Solving the Annuity Puzzle,02-LEC Dynamic,Staff,30,0,30,0,0
2356,Kendall Campus,WBIE  136 - 01   Importing and Exporting Professional Certificate,01-LEC Dynamic,Staff,25,0,25,0,0
1059,Homestead Campus,WCTR  136 - 01   DCF Make-up:  Behavioral Observation and Screening (BOSR),01-LEC Dynamic,Staff,25,0,25,0,0
1741,Wolfson Campus,WLFL  136 - 01   German 1,01-LEC Dynamic,Staff,30,0,30,0,0
2219,Wolfson Campus,WLFL  136 - 02   German 1,02-LEC Dynamic,Staff,30,0,30,0,0
1864,Wolfson Campus,WTCA  136 - 01   Google SketchUp Basics,01-LEC Dynamic,Staff,20,0,20,0,0
1900,Wolfson Campus,WTCA  136 - 02   Google SketchUp Basics,02-LEC Dynamic,Staff,20,0,20,0,0
2960,Hialeah Campus,WTCA  136 - 03   Google SketchUp Basics,03-LEC Dynamic,Staff,16,0,16,0,0
2846,Kendall Campus,RLDA  135 - 01   Flamenco for Adults - Beginner/Refresher,01-LEC Dynamic,Staff,20,0,20,0,0
2848,Kendall Campus,RLDA  135 - 02   Flamenco for Adults - Beginner/Refresher,02-LEC Dynamic,Staff,20,0,20,0,0
2391,North Campus,RLFS  135 - 01   Judo - Kodokan / Jiu-Jitsu (Ages 6 - 15),01-LEC Dynamic,Staff,30,0,30,10,0
2397,North Campus,RLFS  135 - 02   Judo - Kodokan / Jiu-Jitsu (Ages 6 - 15),02-LEC Dynamic,Staff,30,0,30,10,0
2676,Kendall Campus,WBFI  135 - 01   Retirement Workshop: Optimizing Social Security,01-LEC Dynamic,Staff,20,0,20,0,0
3261,Wolfson Campus,WBFI  135 - 02   Retirement Workshop: Optimizing Social Security,02-LEC Dynamic,Staff,30,0,30,0,0
3431,Wolfson Campus,WBIE  135 - 01   Importando y Exportando desde Estados Unidos,01-LEC Dynamic,Staff,30,0,30,0,0
1127,Homestead Campus,WCTR  135 - 01   DCF Make-up: Reglas y Regulaciones en el Hogar,01-LEC Dynamic,Staff,25,0,25,0,0
2588,Hialeah Campus,WCTR  135 - 02   DCF Make-up: Reglas y Regulaciones en el Hogar,02-LEC Dynamic,Staff,30,0,30,0,0
3632,Kendall Campus,WCTR  135 - 03   DCF Make-up: Reglas y Regulaciones en el Hogar,03-LEC Dynamic,Staff,20,0,20,0,0
1077,Kendall Campus,WLEP  135 - 01   ESL Fundamentals,01-LEC Dynamic,Staff,16,0,16,0,0
1129,Kendall Campus,WLEP  135 - 02   ESL Fundamentals,02-LEC Dynamic,Staff,25,0,25,0,0
2380,North Campus,WLEP  135 - 03   ESL Fundamentals,03-LEC Dynamic,Staff,16,0,16,0,0
2381,North Campus,WLEP  135 - 04   ESL Fundamentals,04-LEC Dynamic,Staff,16,0,16,0,0
3855,North Campus,WLFL  135 - 01   French Conversation - Intermediate (42 Hours),01-LEC Dynamic,Staff,16,0,16,0,0
2137,InterAmerican Campus,RLAR  134 - 01   Joyería Hecha a Mano - Nivel 1,01-LEC Dynamic,Staff,30,0,30,0,0
3126,Hialeah Campus,RLAR  134 - 02   Joyería Hecha a Mano - Nivel 1,02-LEC Dynamic,Staff,30,0,30,0,0
3017,Kendall Campus,RLDA  134 - 01   Belly Dancing for Kids ( Ages 6-11),01-LEC Dynamic,Staff,15,0,15,0,0
3018,Kendall Campus,RLDA  134 - 02   Belly Dancing for Kids ( Ages 6-11),02-LEC Dynamic,Staff,15,0,15,0,0
3703,Wolfson Campus,RLFL  134 - 01   Portuguese Conversation-Intermediate,01-LEC Dynamic,Staff,30,0,30,0,0
3279,North Campus,RLFS  134 - 01   Judo - Kodokan / Jiu-Jitsu (Ages 16 - adult),01-LEC Dynamic,Staff,30,0,30,10,0
3284,North Campus,RLFS  134 - 02   Judo - Kodokan / Jiu-Jitsu (Ages 16 - adult),02-LEC Dynamic,Staff,30,0,30,10,0
3286,North Campus,RLFS  134 - 03   Judo - Kodokan / Jiu-Jitsu (Ages 16 - adult),03-LEC Dynamic,Staff,30,0,30,10,0
3288,North Campus,RLFS  134 - 04   Judo - Kodokan / Jiu-Jitsu (Ages 16 - adult),04-LEC Dynamic,Staff,30,0,30,10,0
2675,Kendall Campus,WBFI  134 - 01   Retirement Workshop: IRAs vs Roth IRAs,01-LEC Dynamic,Staff,20,0,20,0,0
3260,Wolfson Campus,WBFI  134 - 02   Retirement Workshop: IRAs vs Roth IRAs,02-LEC Dynamic,Staff,30,0,30,0,0
3838,Kendall Campus,WBIE  134 - 01   How to Set up an Import/Export Business,01-LEC Dynamic,Staff,16,0,16,0,0
1312,Kendall Campus,WLEP  134 - 01   ESL Fundamentals,01-LEC Dynamic,Staff,25,0,25,0,0
1313,Kendall Campus,WLEP  134 - 02   ESL Fundamentals,02-LEC Dynamic,Staff,25,0,25,0,0
1367,Wolfson Campus,RLAR  133 - 01   Jewelry Making 2 - Wire Wrapping Techniques,01-LEC Dynamic,Staff,20,0,20,0,0
3019,Kendall Campus,RLDA  133 - 01   Belly Dance for Teens (Ages 12 - 16),01-LEC Dynamic,Staff,15,0,15,0,0
3020,Kendall Campus,RLDA  133 - 02   Belly Dance for Teens (Ages 12 - 16),02-LEC Dynamic,Staff,15,0,15,0,0
2674,Kendall Campus,WBFI  133 - 01   Retirement Workshop: Choosing Mutual Funds and ETFs,01-LEC Dynamic,Staff,20,0,20,0,0
3259,Wolfson Campus,WBFI  133 - 02   Retirement Workshop: Choosing Mutual Funds and ETFs,02-LEC Dynamic,Staff,30,0,30,0,0
2247,Wolfson Campus,WBIE  133 - 01   Doing Business with Latin America,01-LEC Dynamic,Staff,20,0,20,0,0
1639,InterAmerican Campus,WBRE  133 - 01   Post-Licencia de Bienes Raíces (Real Estate Post Licensing),01-LEC Dynamic,Staff,25,0,25,0,0
1056,Homestead Campus,WCIS  133 - 01   Florida Child Care Professional Credential (FCCPCII),01-LEC Dynamic,Staff,25,0,25,0,0
1585,Kendall Campus,WCIS  133 - 02   Florida Child Care Professional Credential (FCCPCII),02-LEC Dynamic,Staff,25,0,25,0,0
1616,InterAmerican Campus,WCIS  133 - 03   Florida Child Care Professional Credential (FCCPCII),03-LEC Dynamic,Staff,25,0,25,0,0
2534,Hialeah Campus,WCIS  133 - 04   Florida Child Care Professional Credential (FCCPCII),04-LEC Dynamic,Staff,30,0,30,0,0
3599,Kendall Campus,WCIS  133 - 06   Florida Child Care Professional Credential (FCCPCII),06-LEC Dynamic,Staff,20,0,20,0,0
3600,Kendall Campus,WCIS  133 - 07   Florida Child Care Professional Credential (FCCPCII),07-LEC Dynamic,Staff,16,0,16,0,0
2138,InterAmerican Campus,RLAR  132 - 01   Serie de Joyería Hecha a Mano,01-LEC Dynamic,Staff,20,0,20,0,0
3027,Kendall Campus,RLDA  132 - 01   Acro-Ballet Intermediate (Ages 7 - 9),01-LEC Dynamic,Staff,10,0,10,0,0
3029,Kendall Campus,RLDA  132 - 02   Acro-Ballet Intermediate (Ages 7 - 9),02-LEC Dynamic,Staff,10,0,10,0,0
3300,North Campus,RLFS  132 - 01   Judo - Kodokan / Jiu-Jitsu (Ages 16 - adult),01-LEC Dynamic,Staff,16,0,16,8,0
3544,Wolfson Campus,WBCI  132 - 01   Intermediate Venetian Plaster Application Techniques,01-LEC Dynamic,Staff,25,0,25,0,0
2367,Kendall Campus,WBFI  132 - 01   Investment Strategies Boot Camp,01-LEC Dynamic,Staff,25,0,25,0,0
2958,Hialeah Campus,WBIE  132 - 01   Como Financiar su Empresa de Importación y Exportación,01-LEC Dynamic,Staff,30,0,30,0,0
3350,Kendall Campus,WBIE  132 - 02   Como Financiar su Empresa de Importación y Exportación,02-LEC Dynamic,Staff,16,0,16,0,0
1088,Kendall Campus,WLFL  132 - 01   French 4 - Intensive,01-LEC Dynamic,Staff,25,0,25,0,0
1736,Wolfson Campus,WLFL  132 - 02   French 4 - Intensive,02-LEC Dynamic,Staff,30,0,30,0,0
2218,Wolfson Campus,WLFL  132 - 03   French 4 - Intensive,03-LEC Dynamic,Staff,30,0,30,0,0
1918,Wolfson Campus,WTCP  132 - 01   Visual Basic 2013 Programming – Level 1,01-LEC Dynamic,Staff,20,0,20,0,0
3033,Kendall Campus,RLDA  131 - 01   Acro-Ballet Beginners (Ages 4 - 6),01-LEC Dynamic,Staff,10,0,10,0,0
3034,Kendall Campus,RLDA  131 - 02   Acro-Ballet Beginners (Ages 4 - 6),02-LEC Dynamic,Staff,10,0,10,0,0
1365,Wolfson Campus,RLFD  131 - 01   Introduction to Floral Design,01-LEC Dynamic,Staff,20,0,20,0,0
2702,Kendall Campus,RLFD  131 - 02   Introduction to Floral Design,02-LEC Dynamic,Staff,12,0,12,0,0
2704,Kendall Campus,RLFD  131 - 03   Introduction to Floral Design,03-LEC Dynamic,Staff,12,0,12,0,0
3797,Kendall Campus,RLFS  131 - 01   Ice Skating (Ages 7 - 15),01-LEC Dynamic,Staff,16,0,16,0,0
3798,Kendall Campus,RLFS  131 - 02   Ice Skating (Ages 7 - 15),02-LEC Dynamic,Staff,16,0,16,0,0
3799,Kendall Campus,RLFS  131 - 03   Ice Skating (Ages 7 - 15),03-LEC Dynamic,Staff,16,0,16,0,0
3801,Kendall Campus,RLFS  131 - 04   Ice Skating (Ages 7 - 15),04-LEC Dynamic,Staff,16,0,16,0,0
3569,Kendall Campus,RLKC  131 - 01   Kids/Teen College Spring Break Camp (Ages 7 - 12),01-LEC Dynamic,Staff,16,0,16,0,0
1954,InterAmerican Campus,RLMP  131 - 01   Guitar Adult Group,01-LEC Dynamic,Staff,16,0,16,0,0
1955,InterAmerican Campus,RLMP  131 - 02   Guitar Adult Group,02-LEC Dynamic,Staff,16,0,16,0,0
2934,Kendall Campus,RLMP  131 - 03   Guitar Adult Group,03-LEC Dynamic,Staff,20,0,20,0,0
1632,InterAmerican Campus,RLPD  131 - 01   Painting with Acrylics,01-LEC Dynamic,Staff,20,0,20,0,0
1633,InterAmerican Campus,RLPD  131 - 02   Painting with Acrylics,02-LEC Dynamic,Staff,20,0,20,0,0
1634,InterAmerican Campus,RLPD  131 - 03   Painting with Acrylics,03-LEC Dynamic,Staff,20,0,20,0,0
1635,InterAmerican Campus,RLPD  131 - 04   Painting with Acrylics,04-LEC Dynamic,Staff,20,0,20,0,0
1636,InterAmerican Campus,RLPD  131 - 05   Painting with Acrylics,05-LEC Dynamic,Staff,20,0,20,0,0
1637,InterAmerican Campus,RLPD  131 - 06   Painting with Acrylics,06-LEC Dynamic,Staff,20,0,20,0,0
3541,Wolfson Campus,WBCI  131 - 01   Beginning Venetian Plaster Application Techniques,01-LEC Dynamic,Staff,20,0,20,0,0
2511,West Campus,WBEB  131 - 01   Preston Bailey Signature Wedding and Event Design,01-LEC Dynamic,Staff,16,0,16,0,0
2016,Wolfson Campus,WBFI  131 - 01   Introduction to Trading Currencies,01-LEC Dynamic,Staff,20,0,20,0,0
2245,Wolfson Campus,WBIE  131 - 01   Logistics Management Professional Cetificate,01-LEC Dynamic,Staff,25,0,25,0,0
3105,Kendall Campus,WBRE  131 - 01   Home Inspection: A Career From Home,01-LEC Dynamic,Staff,16,0,16,0,0
1055,Homestead Campus,WCIS  131 - 01   Florida Child Care Professional Credential (FCCPCI),01-LEC Dynamic,Staff,25,0,25,0,0
1580,Kendall Campus,WCIS  131 - 02   Florida Child Care Professional Credential (FCCPCI),02-LEC Dynamic,Staff,25,0,25,0,0
1582,Kendall Campus,WCIS  131 - 03   Florida Child Care Professional Credential (FCCPCI),03-LEC Dynamic,Staff,25,0,25,0,0
1615,InterAmerican Campus,WCIS  131 - 04   Florida Child Care Professional Credential (FCCPCI),04-LEC Dynamic,Staff,25,0,25,0,0
2533,Hialeah Campus,WCIS  131 - 05   Florida Child Care Professional Credential (FCCPCI),05-LEC Dynamic,Staff,16,0,16,0,0
2627,West Campus,WCIS  131 - 06   Florida Child Care Professional Credential (FCCPCI),06-LEC Dynamic,Staff,25,0,25,0,0
1087,Kendall Campus,WLFL  131 - 01   French 3 - Intensive,01-LEC Dynamic,Staff,25,0,25,0,0
1734,Wolfson Campus,WLFL  131 - 02   French 3 - Intensive,02-LEC Dynamic,Staff,30,0,30,0,0
2217,Wolfson Campus,WLFL  131 - 03   French 3 - Intensive,03-LEC Dynamic,Staff,30,0,30,0,0
2884,Kendall Campus,RLDA  130 - 01   Oriental Technique and Stylization Through the Ages,01-LEC Dynamic,Staff,40,0,40,0,0
2886,Kendall Campus,RLDA  130 - 02   Oriental Technique and Stylization Through the Ages,02-LEC Dynamic,Staff,40,0,40,0,0
1671,Wolfson Campus,RLFD  130 - 01   Intermediate Floral Design,01-LEC Dynamic,Staff,20,0,20,0,0
1718,Wolfson Campus,RLFL  130 - 01   Mandarin Chinese 2 - Intensive,01-LEC Dynamic,Staff,30,0,30,0,0
2208,Wolfson Campus,RLFL  130 - 02   Mandarin Chinese 2 - Intensive,02-LEC Dynamic,Staff,30,0,30,0,0
3546,Wolfson Campus,WBCI  130 - 01   Advanced Venetian Plaster Application Techniques,01-LEC Dynamic,Staff,25,0,25,0,0
2006,Wolfson Campus,WBEB  130 - 01   Event Planning,01-LEC Dynamic,Staff,25,0,25,0,0
2144,Kendall Campus,WBFI  130 - 01   Introduction to the Stock Market,01-LEC Dynamic,Staff,16,0,16,0,0
1086,Kendall Campus,WLFL  130 - 01   French 2 - Intensive,01-LEC Dynamic,Staff,25,0,25,0,0
1732,Wolfson Campus,WLFL  130 - 02   French 2 - Intensive,02-LEC Dynamic,Staff,30,0,30,0,0
2216,Wolfson Campus,WLFL  130 - 03   French 2 - Intensive,03-LEC Dynamic,Staff,30,0,30,0,0
1421,InterAmerican Campus,WTCP  130 - 01   Game Development Essentials Level 2,01-LEC Dynamic,Staff,25,0,25,0,0
1251,Wolfson Campus,RLCP  129 - 01   SAT Test Preparation-Math (12 Hours),01-LEC Dynamic,Staff,25,0,25,0,0
1256,Wolfson Campus,RLCP  129 - 02   SAT Test Preparation-Math (12 Hours),02-LEC Dynamic,Staff,25,0,25,0,0
2411,North Campus,RLCP  129 - 03   SAT Test Preparation-Math (12 Hours),03-LEC Dynamic,Staff,15,0,15,5,0
2412,North Campus,RLCP  129 - 04   SAT Test Preparation-Math (12 Hours),04-LEC Dynamic,Staff,15,0,15,5,0
2855,Kendall Campus,RLDA  129 - 01   Belly Dance Level 1 - Beginner Techniques,01-LEC Dynamic,Staff,40,0,40,0,0
2858,Kendall Campus,RLDA  129 - 02   Belly Dance Level 1 - Beginner Techniques,02-LEC Dynamic,Staff,40,0,40,0,0
2945,Kendall Campus,RLMP  129 - 01   Piano Group (Ages 8 - 15) (18 Hours),01-LEC Dynamic,Staff,20,0,20,0,0
1363,Wolfson Campus,RLPD  129 - 01   Oil Painting,01-LEC Dynamic,Staff,25,0,25,0,0
1631,InterAmerican Campus,RLPD  129 - 02   Oil Painting,02-LEC Dynamic,Staff,20,0,20,0,0
2965,Hialeah Campus,WBFI  129 - 01   Introducción Sobre Como Obtener Financiamiento para Su Negocio,01-LEC Dynamic,Staff,16,0,16,0,0
2066,Kendall Campus,WBRE  129 - 01   Wind Mitigation· 4 Point and Roof Certification· (Course ID 0000046) and (CIBL ID#0609132),01-LEC Dynamic,Staff,15,0,15,0,0
1420,InterAmerican Campus,WTCP  129 - 01   Game Development Essentials Level 1,01-LEC Dynamic,Staff,25,0,25,0,0
1655,InterAmerican Campus,RLDA  128 - 01   Salsa· Merengue· and Bachata - Intermediate,01-LEC Dynamic,Staff,25,0,25,0,0
3379,Kendall Campus,RLFS  128 - 01   Golf,01-LEC Dynamic,Staff,15,0,15,0,0
3380,Kendall Campus,RLFS  128 - 02   Golf,02-LEC Dynamic,Staff,15,0,15,0,0
3381,Kendall Campus,RLFS  128 - 03   Golf,03-LEC Dynamic,Staff,15,0,15,0,0
3382,Kendall Campus,RLFS  128 - 04   Golf,04-LEC Dynamic,Staff,15,0,15,0,0
1965,Wolfson Campus,WBEB  128 - 01   Your Own Franchise,01-LEC Dynamic,Staff,20,0,20,0,0
1966,Wolfson Campus,WBEB  128 - 02   Your Own Franchise,02-LEC Dynamic,Staff,20,0,20,0,0
2673,Kendall Campus,WBFI  128 - 01   Introducción al Análisis Técnico,01-LEC Dynamic,Staff,20,0,20,0,0
2032,Kendall Campus,WBRE  128 - 01   Uniform Standards of Professional Appraisal Practice (USPAP),01-LEC Dynamic,Staff,15,0,15,0,0
3540,Kendall Campus,WLEP  128 - 01   English Conversation 6,01-LEC Dynamic,Staff,16,0,16,0,0
3542,Kendall Campus,WLEP  128 - 02   English Conversation 6,02-LEC Dynamic,Staff,16,0,16,0,0
3854,North Campus,WLFL  128 - 01   French Conversation - Beginners,01-LEC Dynamic,Staff,16,0,16,0,0
1573,Kendall Campus,WTVE  128 - 01   Final Cut Pro Level 2: Color Correction and Effects,01-LEC Dynamic,Staff,15,0,15,0,0
2946,Kendall Campus,RLMP  127 - 01   The Civic Chorale of Greater Miami,01-LEC Dynamic,Staff,20,0,20,0,0
1903,Kendall Campus,WBAB  127 - 01   Payroll Using QuickBooks,01-LEC Dynamic,Staff,15,0,15,0,0
1967,Wolfson Campus,WBEB  127 - 01   Why People Buy,01-LEC Dynamic,Staff,20,0,20,0,0
2680,Kendall Campus,WBFI  127 - 01   Fundamentos de la Compra-Venta Activa de Acciones,01-LEC Dynamic,Staff,20,0,20,0,0
2898,Kendall Campus,WBRE  127 - 01   Repeat: Registered Trainee Appraiser,01-LEC Dynamic,Staff,16,0,16,0,0
1610,InterAmerican Campus,WCTR  127 - 01   Taller para Matricula Electronica,01-LEC Dynamic,Staff,25,0,25,0,0
1611,InterAmerican Campus,WCTR  127 - 02   Taller para Matricula Electronica,02-LEC Dynamic,Staff,25,0,25,0,0
1612,InterAmerican Campus,WCTR  127 - 03   Taller para Matricula Electronica,03-LEC Dynamic,Staff,25,0,25,0,0
1613,InterAmerican Campus,WCTR  127 - 04   Taller para Matricula Electronica,04-LEC Dynamic,Staff,25,0,25,0,0
1614,InterAmerican Campus,WCTR  127 - 05   Taller para Matricula Electronica,05-LEC Dynamic,Staff,25,0,25,0,0
2664,Hialeah Campus,WCTR  127 - 06   Taller para Matricula Electronica,06-LEC Dynamic,Staff,30,0,30,0,0
2665,Hialeah Campus,WCTR  127 - 07   Taller para Matricula Electronica,07-LEC Dynamic,Staff,30,0,30,0,0
2666,Hialeah Campus,WCTR  127 - 08   Taller para Matricula Electronica,08-LEC Dynamic,Staff,30,0,30,0,0
2667,Hialeah Campus,WCTR  127 - 09   Taller para Matricula Electronica,09-LEC Dynamic,Staff,30,0,30,0,0
2668,Hialeah Campus,WCTR  127 - 10   Taller para Matricula Electronica,10-LEC Dynamic,Staff,30,0,30,0,0
2669,Hialeah Campus,WCTR  127 - 11   Taller para Matricula Electronica,11-LEC Dynamic,Staff,30,0,30,0,0
1437,Wolfson Campus,WLEP  127 - 01   English Conversation 5,01-LEC Dynamic,Staff,16,0,16,0,0
1983,Wolfson Campus,WLEP  127 - 02   English Conversation 5,02-LEC Dynamic,Staff,30,0,30,0,0
2133,InterAmerican Campus,WTCA  127 - 01   Revit Certification Exam,01-LEC Dynamic,Staff,16,0,16,0,0
1040,Homestead Campus,WTCP  127 - 01   SQL - Structured Query Language,01-LEC Dynamic,Staff,25,0,25,0,0
1568,Kendall Campus,WTVE  127 - 01   Final Cut Pro Level 1: Editing Professional Video,01-LEC Dynamic,Staff,15,0,15,0,0
1654,InterAmerican Campus,RLDA  126 - 01   Salsa· Merengue and Bachata - Beginner,01-LEC Dynamic,Staff,15,0,15,0,0
2418,North Campus,RLFD  126 - 01   Creative Floral Design for Home or Office,01-LEC Dynamic,Staff,16,0,16,8,0
3124,Hialeah Campus,RLPH  126 - 01   Fotografía de Viaje,01-LEC Dynamic,Staff,30,0,30,0,0
2888,Hialeah Campus,RLSC  126 - 01   55+ Conocimientos Básicos en Computación,01-LEC Dynamic,Staff,16,0,16,0,0
2047,Kendall Campus,WBAB  126 - 01   Payroll,01-LEC Dynamic,Staff,16,0,16,0,0
2492,West Campus,WBAB  126 - 02   Payroll,02-LEC Dynamic,Staff,16,0,16,0,0
2493,West Campus,WBAB  126 - 03   Payroll,03-LEC Dynamic,Staff,16,0,16,0,0
2847,North Campus,WBCI  126 - 01   Skid Steer Loader Operator,01-LEC Dynamic,Staff,30,0,30,0,0
2849,North Campus,WBCI  126 - 02   Skid Steer Loader Operator,02-LEC Dynamic,Staff,30,0,30,0,0
1968,Wolfson Campus,WBEB  126 - 01   Using Experiential Retail to Beat the Competition,01-LEC Dynamic,Staff,20,0,20,0,0
2111,Kendall Campus,WBFI  126 - 01   Financial Strategies for Successful Retirement,01-LEC Dynamic,Staff,16,0,16,0,0
2028,Kendall Campus,WBRE  126 - 01   Registered Trainee Appraiser,01-LEC Dynamic,Staff,15,0,15,0,0
1188,Kendall Campus,WLEP  126 - 01   English Conversation 4 - 56 hrs,01-LEC Dynamic,Staff,25,0,25,0,0
1190,Kendall Campus,WLEP  126 - 02   English Conversation 4 - 56 hrs,02-LEC Dynamic,Staff,25,0,25,0,0
1416,InterAmerican Campus,WTCA  126 - 01   Revit MEP - Mechanical· Electrical and Plumbing,01-LEC Dynamic,Staff,20,0,20,0,0
1329,Kendall Campus,WTMO  126 - 01   Microsoft Excel for Small Businesses,01-LEC Dynamic,Staff,16,0,16,0,0
1645,InterAmerican Campus,RLAR  125 - 01   Joyería Hecha a Mano - Nivel 2,01-LEC Dynamic,Staff,20,0,20,0,0
3319,Kendall Campus,RLSC  125 - 01   55+ The Internet· Email and Social Media,01-LEC Dynamic,Staff,16,0,16,0,0
2490,West Campus,WBAB  125 - 01   Nómina (Payroll),01-LEC Dynamic,Staff,16,0,16,0,0
1991,Wolfson Campus,WBEB  125 - 01   Risk Management in Starting and Operating a Business,01-LEC Dynamic,Staff,20,0,20,0,0
2060,Kendall Campus,WBEB  125 - 02   Risk Management in Starting and Operating a Business,02-LEC Dynamic,Staff,16,0,16,0,0
3274,Wolfson Campus,WBIE  125 - 01   Professional Freight Forwarding,01-LEC Dynamic,Staff,30,0,30,0,0
2139,Kendall Campus,WBRE  125 - 01   Real Estate Salesperson State Exam Review,01-LEC Dynamic,Staff,15,0,15,0,0
1436,Wolfson Campus,WLEP  125 - 01   English Conversation 4 - 42 hrs,01-LEC Dynamic,Staff,16,0,16,0,0
1981,Wolfson Campus,WLEP  125 - 02   English Conversation 4 - 42 hrs,02-LEC Dynamic,Staff,30,0,30,0,0
2562,West Campus,WTBT  125 - 01   eBay - Vender y Ganar,01-LEC Dynamic,Staff,35,0,35,0,0
2564,West Campus,WTBT  125 - 02   eBay - Vender y Ganar,02-LEC Dynamic,Staff,35,0,35,0,0
1783,Wolfson Campus,WTCA  125 - 01   REVIT - Level 3,01-LEC Dynamic,Staff,20,0,20,0,0
1902,Kendall Campus,WTCA  125 - 02   REVIT - Level 3,02-LEC Dynamic,Staff,15,0,15,0,0
2555,West Campus,WTCA  125 - 03   REVIT - Level 3,03-LEC Dynamic,Staff,15,0,15,0,0
1688,Wolfson Campus,RLDA  124 - 01   Salsa - Intermediate,01-LEC Dynamic,Staff,20,0,20,0,0
1019,Homestead Campus,RLFL  124 - 01   Japanese Conversation 1,01-LEC Dynamic,Staff,25,0,25,0,0
2051,Wolfson Campus,RLSC  124 - 01   55+ The Basics of Digital Imaging and the Internet,01-LEC Dynamic,Staff,20,0,20,0,0
2103,Wolfson Campus,RLSC  124 - 02   55+ The Basics of Digital Imaging and the Internet,02-LEC Dynamic,Staff,20,0,20,0,0
3456,Kendall Campus,RLSC  124 - 03   55+ The Basics of Digital Imaging and the Internet,03-LEC Dynamic,Staff,16,0,16,0,0
3787,Wolfson Campus,RLSC  124 - 04   55+ The Basics of Digital Imaging and the Internet,04-LEC Dynamic,Staff,30,0,30,0,0
2106,Wolfson Campus,WBAB  124 - 01   Keyboarding/Typing I,01-LEC Dynamic,Staff,20,0,20,0,0
2108,Wolfson Campus,WBAB  124 - 02   Keyboarding/Typing I,02-LEC Dynamic,Staff,25,0,25,0,0
3756,Homestead Campus,WBAB  124 - 03   Keyboarding/Typing I,03-LEC Dynamic,Staff,25,0,25,0,0
2851,North Campus,WBCI  124 - 01   OSHA 30 for Construction Industry,01-LEC Dynamic,Staff,30,0,30,0,0
2852,North Campus,WBCI  124 - 02   OSHA 30 for Construction Industry,02-LEC Dynamic,Staff,30,0,30,0,0
3584,Homestead Campus,WBEB  124 - 01   Marketing 101 - GHFC and EDC,01-LEC Dynamic,Staff,25,0,25,0,0
1343,Wolfson Campus,WBIE  124 - 01   Professional Customs Processing,01-LEC Dynamic,Staff,20,0,20,0,0
2909,Kendall Campus,WBRE  124 - 01   Repeat - Real Estate Sales Associate License Exam Preparation,01-LEC Dynamic,Staff,30,0,30,0,0
2948,Kendall Campus,WBRE  124 - 02   Repeat - Real Estate Sales Associate License Exam Preparation,02-LEC Dynamic,Staff,30,0,30,0,0
2955,Kendall Campus,WBRE  124 - 03   Repeat - Real Estate Sales Associate License Exam Preparation,03-LEC Dynamic,Staff,30,0,30,0,0
1213,Kendall Campus,WLEP  124 - 01   English Conversation 3 - 21 hrs,01-LEC Dynamic,Staff,25,0,25,0,0
1214,Kendall Campus,WLEP  124 - 02   English Conversation 3 - 21 hrs,02-LEC Dynamic,Staff,25,0,25,0,0
1215,Kendall Campus,WLEP  124 - 03   English Conversation 3 - 21 hrs,03-LEC Dynamic,Staff,25,0,25,0,0
1217,Kendall Campus,WLEP  124 - 04   English Conversation 3 - 21 hrs,04-LEC Dynamic,Staff,25,0,25,0,0
1743,Wolfson Campus,WTBT  124 - 01   eBay for Sellers,01-LEC Dynamic,Staff,20,0,20,0,0
1800,Wolfson Campus,WTBT  124 - 02   eBay for Sellers,02-LEC Dynamic,Staff,20,0,20,0,0
1036,Homestead Campus,WTCA  124 - 01   REVIT - Level 2,01-LEC Dynamic,Staff,25,0,25,0,0
1776,Wolfson Campus,WTCA  124 - 02   REVIT - Level 2,02-LEC Dynamic,Staff,20,0,20,0,0
1781,Wolfson Campus,WTCA  124 - 03   REVIT - Level 2,03-LEC Dynamic,Staff,20,0,20,0,0
1896,Kendall Campus,WTCA  124 - 04   REVIT - Level 2,04-LEC Dynamic,Staff,15,0,15,0,0
2552,West Campus,WTCA  124 - 05   REVIT - Level 2,05-LEC Dynamic,Staff,20,0,20,0,0
2553,West Campus,WTCA  124 - 06   REVIT - Level 2,06-LEC Dynamic,Staff,20,0,20,0,0
3688,North Campus,WTCA  124 - 07   REVIT - Level 2,07-LEC Dynamic,Staff,15,0,15,0,0
1742,Wolfson Campus,WTDM  124 - 01   Rhino - Level 1,01-LEC Dynamic,Staff,20,0,20,0,0
1366,Wolfson Campus,RLAR  123 - 01   Basic Jewelry Making,01-LEC Dynamic,Staff,30,0,30,0,0
3327,North Campus,RLAR  123 - 02   Basic Jewelry Making,02-LEC Dynamic,Staff,30,0,30,10,0
3330,North Campus,RLAR  123 - 03   Basic Jewelry Making,03-LEC Dynamic,Staff,30,0,30,0,0
1683,Wolfson Campus,RLDA  123 - 01   Salsa for Beginners,01-LAB Dynamic,Staff,20,0,20,0,0
3281,Kendall Campus,RLFS  123 - 02   Fat Burning· Low Impact Group Exercise,02-LEC Dynamic,Staff,15,0,15,0,0
3282,Kendall Campus,RLFS  123 - 03   Fat Burning· Low Impact Group Exercise,03-LEC Dynamic,Staff,15,0,15,0,0
1379,Wolfson Campus,RLPH  123 - 01   Photography in Black and White,01-LEC Dynamic,Staff,20,0,20,0,0
3128,Hialeah Campus,RLPH  123 - 02   Photography in Black and White,02-LEC Dynamic,Staff,30,0,30,0,0
2000,Kendall Campus,RLSC  123 - 01   55+ Navegando la Computadora con Windows 8,01-LEC Dynamic,Staff,15,0,15,0,0
2010,Kendall Campus,RLSC  123 - 02   55+ Navegando la Computadora con Windows 8,02-LEC Dynamic,Staff,15,0,15,0,0
2041,Kendall Campus,WBAB  123 - 01   Keyboarding I,01-LEC Dynamic,Staff,16,0,16,0,0
1333,Wolfson Campus,WBCI  123 - 01   OSHA 10 for Construction Industry,01-LEC Dynamic,Staff,30,0,30,0,0
2660,North Campus,WBCI  123 - 02   OSHA 10 for Construction Industry,02-LEC Dynamic,Staff,30,0,30,0,0
2661,North Campus,WBCI  123 - 03   OSHA 10 for Construction Industry,03-LEC Dynamic,Staff,30,0,30,0,0
3580,Homestead Campus,WBEB  123 - 01   HR 101 Policies and Procedures - GHFC and EDC,01-LEC Dynamic,Staff,25,0,25,0,0
1962,InterAmerican Campus,WBIE  123 - 01   Haciendo Negocios con Latinoamérica,01-LEC Dynamic,Staff,16,0,16,0,0
1017,Homestead Campus,WBRE  123 - 01   Real Estate Sales Associate License Exam Preparation,01-LEC Dynamic,Staff,25,0,25,0,0
2149,Kendall Campus,WBRE  123 - 02   Real Estate Sales Associate License Exam Preparation,02-LEC Dynamic,Staff,0,0,0,0,0
2152,Kendall Campus,WBRE  123 - 03   Real Estate Sales Associate License Exam Preparation,03-LEC Dynamic,Staff,15,0,15,0,0
3573,Wolfson Campus,WBRE  123 - 04   Real Estate Sales Associate License Exam Preparation,04-LEC Dynamic,Staff,25,0,25,0,0
3574,Wolfson Campus,WBRE  123 - 05   Real Estate Sales Associate License Exam Preparation,05-LEC Dynamic,Staff,25,0,25,0,0
1563,InterAmerican Campus,WCIS  123 - 01   Familia-Escuela y Comunidad,01-LEC Dynamic,Staff,25,0,25,0,0
1684,Kendall Campus,WCIS  123 - 02   Familia-Escuela y Comunidad,02-LEC Dynamic,Staff,25,0,25,0,0
2546,Hialeah Campus,WCIS  123 - 03   Familia-Escuela y Comunidad,03-LEC Dynamic,Staff,30,0,30,0,0
1183,Kendall Campus,WLEP  123 - 01   English Conversation 3 - 56 hrs,01-LEC Dynamic,Staff,16,0,16,0,0
1185,Kendall Campus,WLEP  123 - 02   English Conversation 3 - 56 hrs,02-LEC Dynamic,Staff,25,0,25,0,0
2448,Hialeah Campus,WLEP  123 - 03   English Conversation 3 - 56 hrs,03-LEC Dynamic,Staff,16,0,16,0,0
2449,Hialeah Campus,WLEP  123 - 04   English Conversation 3 - 56 hrs,04-LEC Dynamic,Staff,16,0,16,0,0
2450,Hialeah Campus,WLEP  123 - 05   English Conversation 3 - 56 hrs,05-LEC Dynamic,Staff,16,0,16,0,0
1727,Wolfson Campus,WLFL  123 - 01   French 4,01-LEC Dynamic,Staff,30,0,30,0,0
2214,Wolfson Campus,WLFL  123 - 02   French 4,02-LEC Dynamic,Staff,30,0,30,0,0
1973,Kendall Campus,WTCA  123 - 01   Dibujo Técnico (Drafting),01-LEC Dynamic,Staff,15,0,15,0,0
2248,Wolfson Campus,WTDM  123 - 01   Graphic Design Specialist - Series,01-LEC Dynamic,Staff,20,0,20,0,0
3021,Kendall Campus,RLDA  122 - 01   Modern Dance - All levels,01-LEC Dynamic,Staff,15,0,15,0,0
3023,Kendall Campus,RLDA  122 - 02   Modern Dance - All levels,02-LEC Dynamic,Staff,15,0,15,0,0
3290,Kendall Campus,RLFS  122 - 01   Fencing - Intermediate/Advanced - Ages 8 & up,01-LEC Dynamic,Staff,15,0,15,0,0
3291,Kendall Campus,RLFS  122 - 02   Fencing - Intermediate/Advanced - Ages 8 & up,02-LEC Dynamic,Staff,15,0,15,0,0
3152,Kendall Campus,RLMP  122 - 01   Private Music 7 – ½ Hour Drums          ,01-LEC Dynamic,Staff,16,0,16,0,0
3157,Kendall Campus,RLMP  122 - 02   Private Music 7 – ½ Hour Drums          ,02-LEC Dynamic,Staff,16,0,16,0,0
3122,Hialeah Campus,RLPD  122 - 01   Dibujo Básico,01-LEC Dynamic,Staff,30,0,30,0,0
2091,Kendall Campus,RLSC  122 - 01   55+ El Internet· Correo Electrónico y las Redes Sociales,01-LEC Dynamic,Staff,15,0,15,0,0
2095,Kendall Campus,RLSC  122 - 02   55+ El Internet· Correo Electrónico y las Redes Sociales,02-LEC Dynamic,Staff,15,0,15,0,0
2143,InterAmerican Campus,WBAB  122 - 01   Fundamentos De Contabilidad,01-LEC Dynamic,Staff,20,0,20,0,0
3115,North Campus,WBCI  122 - 01   Mold Assessors,01-LEC Dynamic,Staff,30,0,30,0,0
3116,North Campus,WBCI  122 - 02   Mold Assessors,02-LEC Dynamic,Staff,30,0,30,0,0
3579,Homestead Campus,WBEB  122 - 01   How to Write a Business Plan - GHFC and EDC,01-LEC Dynamic,Staff,25,0,25,0,0
2243,Wolfson Campus,WBFI  122 - 01   Trade in the FOREX,01-LEC Dynamic,Staff,25,0,25,0,0
2308,Kendall Campus,WBIE  122 - 01   Logistics Management I,01-LEC Dynamic,Staff,25,0,25,0,0
1016,Homestead Campus,WBRE  122 - 01   Real Estate Sales Associate 63 Hours and Cram Course (Book Included),01-LEC Dynamic,Staff,25,0,25,0,0
2147,Kendall Campus,WBRE  122 - 02   Real Estate Sales Associate 63 Hours and Cram Course (Book Included),02-LEC Dynamic,Staff,15,0,15,0,0
3552,North Campus,WBRE  122 - 03   Real Estate Sales Associate 63 Hours and Cram Course (Book Included),03-LEC Dynamic,Staff,16,0,16,0,0
3553,North Campus,WBRE  122 - 04   Real Estate Sales Associate 63 Hours and Cram Course (Book Included),04-LEC Dynamic,Staff,16,0,16,0,0
3554,North Campus,WBRE  122 - 05   Real Estate Sales Associate 63 Hours and Cram Course (Book Included),05-LEC Dynamic,Staff,16,0,16,0,0
3571,Wolfson Campus,WBRE  122 - 06   Real Estate Sales Associate 63 Hours and Cram Course (Book Included),06-LEC Dynamic,Staff,25,0,25,0,0
1435,Wolfson Campus,WLEP  122 - 01   English Conversation 3 - 42 hrs,01-LEC Dynamic,Staff,16,0,16,0,0
1980,Wolfson Campus,WLEP  122 - 02   English Conversation 3 - 42 hrs,02-LEC Dynamic,Staff,30,0,30,0,0
2363,North Campus,WLEP  122 - 03   English Conversation 3 - 42 hrs,03-LEC Dynamic,Staff,16,0,16,0,0
2364,North Campus,WLEP  122 - 04   English Conversation 3 - 42 hrs,04-LEC Dynamic,Staff,16,0,16,0,0
1725,Wolfson Campus,WLFL  122 - 01   French 3,01-LEC Dynamic,Staff,30,0,30,0,0
2213,Wolfson Campus,WLFL  122 - 02   French 3,02-LEC Dynamic,Staff,30,0,30,0,0
2557,West Campus,WTDM  122 - 01   Developing a Successful Social Media Campaign for Your Business,01-LEC Dynamic,Staff,16,0,16,0,0
3439,Wolfson Campus,WTDM  122 - 02   Developing a Successful Social Media Campaign for Your Business,02-LEC Dynamic,Staff,30,0,30,0,0
1795,Wolfson Campus,WTNT  122 - 01   My Tablet and Me - Android,01-LEC Dynamic,Staff,20,0,20,0,0
1876,Wolfson Campus,WTNT  122 - 02   My Tablet and Me - Android,02-LEC Dynamic,Staff,20,0,20,0,0
1787,Wolfson Campus,WTWD  122 - 01   CSS Techniques (Cascading Style Sheets),01-LEC Dynamic,Staff,20,0,20,0,0
1247,Wolfson Campus,RLCP  121 - 01   SAT Test Preparation,01-LEC Dynamic,Staff,30,0,30,0,0
1250,Wolfson Campus,RLCP  121 - 02   SAT Test Preparation,02-LEC Dynamic,Staff,30,0,30,0,0
2887,Kendall Campus,RLCP  121 - 03   SAT Test Preparation,03-LEC Dynamic,Staff,30,0,30,0,0
2890,Kendall Campus,RLCP  121 - 04   SAT Test Preparation,04-LEC Dynamic,Staff,30,0,30,0,0
2893,Kendall Campus,RLCP  121 - 05   SAT Test Preparation,05-LEC Dynamic,Staff,30,0,30,0,0
2894,Kendall Campus,RLCP  121 - 06   SAT Test Preparation,06-LEC Dynamic,Staff,30,0,30,0,0
3778,Wolfson Campus,RLCP  121 - 07   SAT Test Preparation,07-LEC Dynamic,Staff,30,0,30,0,0
2994,Kendall Campus,RLKC  121 - 01   Keyboarding and Microsoft Office Basics for Kids (Ages 7-11),01-LEC Dynamic,Staff,15,0,15,0,0
2997,Kendall Campus,RLKC  121 - 02   Keyboarding and Microsoft Office Basics for Kids (Ages 7-11),02-LEC Dynamic,Staff,15,0,15,0,0
3151,Kendall Campus,RLMP  121 - 01   Private Music 7 – 1 Hour Drums            ,01-LEC Dynamic,Staff,16,0,16,0,0
3153,Kendall Campus,RLMP  121 - 02   Private Music 7 – 1 Hour Drums            ,02-LEC Dynamic,Staff,16,0,16,0,0
2105,Kendall Campus,RLOS  121 - 01   Credit Repair,01-LEC Dynamic,Staff,16,0,16,0,0
2089,Kendall Campus,RLSC  121 - 01   55+ Comuníquese utilizando WhatsApp y Skype,01-LEC Dynamic,Staff,15,0,15,0,0
2023,Kendall Campus,WBAB  121 - 01   Administrative Assistant,01-LEC Dynamic,Staff,20,0,20,0,0
2924,Hialeah Campus,WBAB  121 - 02   Administrative Assistant,02-LEC Dynamic,Staff,16,0,16,0,0
3586,Homestead Campus,WBAB  121 - 03   Administrative Assistant,03-LEC Dynamic,Staff,25,0,25,0,0
2959,Hialeah Campus,WBEB  121 - 01   Estrategias Exitosas para Nuevos Negocios,01-LEC Dynamic,Staff,35,0,35,0,0
1142,Wolfson Campus,WBFI  121 - 01   The World of Investing,01-LEC Dynamic,Staff,16,0,16,0,0
2353,Kendall Campus,WBIE  121 - 01   Logística Administrativa II,01-LEC Dynamic,Staff,25,0,25,0,0
1315,Wolfson Campus,WBRE  121 - 01   Buying Distressed Properties,01-LEC Dynamic,Staff,30,0,30,0,0
2142,Kendall Campus,WBRE  121 - 02   Buying Distressed Properties,02-LEC Dynamic,Staff,30,0,30,0,0
1201,Kendall Campus,WLEP  121 - 01   English Conversation 2 - 21 hrs,01-LEC Dynamic,Staff,25,0,25,0,0
1203,Kendall Campus,WLEP  121 - 02   English Conversation 2 - 21 hrs,02-LEC Dynamic,Staff,25,0,25,0,0
1207,Kendall Campus,WLEP  121 - 03   English Conversation 2 - 21 hrs,03-LEC Dynamic,Staff,25,0,25,0,0
1209,Kendall Campus,WLEP  121 - 04   English Conversation 2 - 21 hrs,04-LEC Dynamic,Staff,25,0,25,0,0
1724,Wolfson Campus,WLFL  121 - 01   French 2,01-LEC Dynamic,Staff,30,0,30,0,0
2212,Wolfson Campus,WLFL  121 - 02   French 2,02-LEC Dynamic,Staff,30,0,30,0,0
3672,North Campus,WTDM  121 - 01   Amazon for Sellers,01-LEC Dynamic,Staff,16,0,16,0,0
3342,Kendall Campus,WTWI  121 - 01   Configuring Windows 8.1 - 70-687,01-LEC Dynamic,Staff,16,0,16,0,0
1253,Homestead Campus,RLCP  120 - 01   SAT Read/Write,01-LEC Dynamic,Staff,30,0,30,0,0
1262,Wolfson Campus,RLCP  120 - 02   SAT Read/Write,02-LEC Dynamic,Staff,30,0,30,0,0
1263,Wolfson Campus,RLCP  120 - 03   SAT Read/Write,03-LEC Dynamic,Staff,30,0,30,0,0
2459,Hialeah Campus,RLCP  120 - 04   SAT Read/Write,04-LEC Dynamic,Staff,30,0,30,0,0
2591,West Campus,RLCP  120 - 05   SAT Read/Write,05-LEC Dynamic,Staff,30,0,30,0,0
2592,West Campus,RLCP  120 - 06   SAT Read/Write,06-LEC Dynamic,Staff,30,0,30,0,0
3592,Kendall Campus,RLEC  120 - 01   Service Learning,01-LEC Dynamic,Staff,15,0,15,0,0
3149,Kendall Campus,RLMP  120 - 01   Private Music 14 – 1 Hour Drums          ,01-LEC Dynamic,Staff,16,0,16,0,0
2109,Kendall Campus,RLOS  120 - 01   Aprenda a Reparar Su Crédito,01-LEC Dynamic,Staff,16,0,16,0,0
1989,Kendall Campus,RLSC  120 - 01   55+ Internet and Email,01-LEC Dynamic,Staff,15,0,15,0,0
1994,Kendall Campus,RLSC  120 - 02   55+ Internet and Email,02-LEC Dynamic,Staff,15,0,15,0,0
2741,Kendall Campus,RLTH  120 - 01   Teatro para Principiantes,01-LEC Dynamic,Staff,20,0,20,0,0
2744,Kendall Campus,RLTH  120 - 02   Teatro para Principiantes,02-LEC Dynamic,Staff,20,0,20,0,0
3576,Homestead Campus,WBEB  120 - 01   Customer Service - GHFC and EDC,01-LEC Dynamic,Staff,25,0,25,0,0
1140,Wolfson Campus,WBFI  120 - 01   Technical Analysis,01-LEC Dynamic,Staff,20,0,20,0,0
2352,Kendall Campus,WBIE  120 - 01   Logística Administrativa I,01-LEC Dynamic,Staff,25,0,25,0,0
3425,Wolfson Campus,WBIE  120 - 02   Logística Administrativa I,02-LEC Dynamic,Staff,30,0,30,0,0
1018,Homestead Campus,WBRE  120 - 01   Real Estate Sales Associate Pre-License and State Exam Prep - Hybrid Course,01-LEC Dynamic,Staff,30,0,30,0,0
1179,Kendall Campus,WLEP  120 - 01   English Conversation 2 - 56 hrs,01-LEC Dynamic,Staff,25,0,25,0,0
1181,Kendall Campus,WLEP  120 - 02   English Conversation 2 - 56 hrs,02-LEC Dynamic,Staff,25,0,25,0,0
2446,Hialeah Campus,WLEP  120 - 03   English Conversation 2 - 56 hrs,03-LEC Dynamic,Staff,16,0,16,0,0
2447,Hialeah Campus,WLEP  120 - 04   English Conversation 2 - 56 hrs,04-LEC Dynamic,Staff,16,0,16,0,0
1723,Wolfson Campus,WLFL  120 - 01   French 1,01-LEC Dynamic,Staff,30,0,30,0,0
2211,Wolfson Campus,WLFL  120 - 02   French 1,02-LEC Dynamic,Staff,30,0,30,0,0
1516,Wolfson Campus,WTCA  120 - 01   Construction Drafting Series,01-LEC Dynamic,Staff,25,0,25,0,0
2537,West Campus,WTDM  120 - 01   Adobe Photoshop CS6 Level 1,01-LEC Dynamic,Staff,16,0,16,0,0
2536,West Campus,WTDM  120 - 02   Adobe Photoshop CS6 Level 1,02-LEC Dynamic,Staff,16,0,16,0,0
1470,Kendall Campus,WTNT  120 - 01   Computers and Windows 8,01-LEC Dynamic,Staff,15,0,15,0,0
1512,Kendall Campus,WTNT  120 - 02   Computers and Windows 8,02-LEC Dynamic,Staff,15,0,15,0,0
1587,Wolfson Campus,WTNT  120 - 03   Computers and Windows 8,03-LEC Dynamic,Staff,20,0,20,0,0
1753,Wolfson Campus,WTNT  120 - 04   Computers and Windows 8,04-LEC Dynamic,Staff,20,0,20,0,0
3752,Homestead Campus,WTNT  120 - 05   Computers and Windows 8,05-LEC Dynamic,Staff,25,0,25,0,0
3753,Homestead Campus,WTNT  120 - 06   Computers and Windows 8,06-LEC Dynamic,Staff,25,0,25,0,0
3754,Homestead Campus,WTNT  120 - 07   Computers and Windows 8,07-LEC Dynamic,Staff,25,0,25,0,0
3755,Homestead Campus,WTNT  120 - 08   Computers and Windows 8,08-LEC Dynamic,Staff,25,0,25,0,0
3474,Kendall Campus,WTWI  120 - 01   Configuring Advanced Windows Server 2012 Services (70-412),01-LEC Dynamic,Staff,16,0,16,0,0
2323,Kendall Campus,RLAC  119 - 01   Swimming Placement Test,01-LEC Dynamic,Staff,8,0,8,0,0
2324,Kendall Campus,RLAC  119 - 02   Swimming Placement Test,02-LEC Dynamic,Staff,8,0,8,0,0
2325,Kendall Campus,RLAC  119 - 03   Swimming Placement Test,03-LEC Dynamic,Staff,8,0,8,0,0
1252,Homestead Campus,RLCP  119 - 01   SAT Math,01-LEC Dynamic,Staff,30,0,30,0,0
2458,Hialeah Campus,RLCP  119 - 02   SAT Math,02-LEC Dynamic,Staff,30,0,30,0,0
2589,West Campus,RLCP  119 - 03   SAT Math,03-LEC Dynamic,Staff,30,0,30,0,0
2590,West Campus,RLCP  119 - 04   SAT Math,04-LEC Dynamic,Staff,30,0,30,0,0
2843,Kendall Campus,RLDA  119 - 01   Latin Dancing (Salsa· Casino· Rueda),01-LEC Dynamic,Staff,40,0,40,0,0
3591,Kendall Campus,RLEC  119 - 01   Service Learning,01-LEC Dynamic,Staff,15,0,15,0,0
3287,Kendall Campus,RLFS  119 - 01   Fencing - Beginners (Ages 8 and up),01-LEC Dynamic,Staff,15,0,15,0,0
3289,Kendall Campus,RLFS  119 - 02   Fencing - Beginners (Ages 8 and up),02-LEC Dynamic,Staff,15,0,15,0,0
3150,Kendall Campus,RLMP  119 - 01   Private Music 14 – ½ Hour Drums        ,01-LEC Dynamic,Staff,16,0,16,0,0
3547,Kendall Campus,RLPH  119 - 01   The Night  and Architecture - Digital Photography,01-LEC Dynamic,Staff,16,0,16,0,0
1006,Homestead Campus,WBAB  119 - 01   Small Business Accounting,01-LEC Dynamic,Staff,25,0,25,0,0
2506,West Campus,WBEB  119 - 01   Creating the Future,01-LEC Dynamic,Staff,16,0,16,0,0
3226,North Campus,WBEB  119 - 02   Creating the Future,02-LEC Dynamic,Staff,16,0,16,0,0
2369,Kendall Campus,WBFI  119 - 01   Options Plain and Simple Part II,01-LEC Dynamic,Staff,25,0,25,0,0
3572,Wolfson Campus,WBRE  119 - 01   Real Estate Sales Essentials 101,01-LEC Dynamic,Staff,25,0,25,0,0
1434,Wolfson Campus,WLEP  119 - 01   English Conversation 2 - 42 hrs,01-LEC Dynamic,Staff,16,0,16,0,0
1979,Wolfson Campus,WLEP  119 - 02   English Conversation 2 - 42 hrs,02-LEC Dynamic,Staff,30,0,30,0,0
2361,North Campus,WLEP  119 - 03   English Conversation 2 - 42 hrs,03-LEC Dynamic,Staff,16,0,16,0,0
2362,North Campus,WLEP  119 - 04   English Conversation 2 - 42 hrs,04-LEC Dynamic,Staff,16,0,16,0,0
1035,Homestead Campus,WTCA  119 - 01   REVIT - Level 1,01-LEC Dynamic,Staff,25,0,25,0,0
1415,InterAmerican Campus,WTCA  119 - 02   REVIT - Level 1,02-LEC Dynamic,Staff,20,0,20,0,0
1589,Wolfson Campus,WTCA  119 - 03   REVIT - Level 1,03-LEC Dynamic,Staff,20,0,20,0,0
1778,Wolfson Campus,WTCA  119 - 04   REVIT - Level 1,04-LEC Dynamic,Staff,20,0,20,0,0
1898,Kendall Campus,WTCA  119 - 05   REVIT - Level 1,05-LEC Dynamic,Staff,15,0,15,0,0
3038,Hialeah Campus,WTCA  119 - 06   REVIT - Level 1,06-LEC Dynamic,Staff,16,0,16,0,0
2550,West Campus,WTCA  119 - 07   REVIT - Level 1,07-LEC Dynamic,Staff,20,0,20,0,0
3687,North Campus,WTCA  119 - 08   REVIT - Level 1,08-LEC Dynamic,Staff,15,0,15,0,0
1523,Wolfson Campus,WTCP  119 - 01   Create iPhone Applications - Level 1,01-LEC Dynamic,Staff,20,0,20,0,0
1560,Kendall Campus,WTDM  119 - 01   Adobe Photoshop CC Nivel 1,01-LEC Dynamic,Staff,15,0,15,0,0
2933,Hialeah Campus,WTDM  119 - 02   Adobe Photoshop CC Nivel 1,02-LEC Dynamic,Staff,16,0,16,0,0
1023,Homestead Campus,WTNT  119 - 01   Computers and Windows 7,01-LEC Dynamic,Staff,25,0,25,0,0
1024,Homestead Campus,WTNT  119 - 02   Computers and Windows 7,02-LEC Dynamic,Staff,25,0,25,0,0
1025,Homestead Campus,WTNT  119 - 03   Computers and Windows 7,03-LEC Dynamic,Staff,25,0,25,0,0
1026,Homestead Campus,WTNT  119 - 04   Computers and Windows 7,04-LEC Dynamic,Staff,25,0,25,0,0
3590,Kendall Campus,RLEC  118 - 01   Service Learning,01-LEC Dynamic,Staff,15,0,15,0,0
3046,Kendall Campus,RLKC  118 - 01   LEGO® EV3 Robotics: Engineering and Design Level 1,01-LEC Dynamic,Staff,15,0,15,0,0
1380,Wolfson Campus,RLPH  118 - 01   Light-up the Night: Photography,01-LEC Dynamic,Staff,20,0,20,0,0
3786,Wolfson Campus,RLSC  118 - 01   55+ Microsoft Office 2013 Basic: Word· Excel· and PowerPoint,01-LEC Dynamic,Staff,30,0,30,0,0
3853,North Campus,RLSP  118 - 01   Textile 101,01-LEC Dynamic,Staff,16,0,16,0,0
3567,Kendall Campus,RLTH  118 - 01   Learn Stand-Up Comedy,01-LEC Dynamic,Staff,20,0,20,0,0
3568,Kendall Campus,RLTH  118 - 02   Learn Stand-Up Comedy,02-LEC Dynamic,Staff,20,0,20,0,0
1323,Wolfson Campus,WBCI  118 - 01   General Construction Estimating,01-LEC Dynamic,Staff,30,0,30,0,0
1330,Wolfson Campus,WBCI  118 - 02   General Construction Estimating,02-LEC Dynamic,Staff,30,0,30,0,0
2017,Wolfson Campus,WBFI  118 - 01   Options Plain and Simple Part I,01-LEC Dynamic,Staff,20,0,20,0,0
2368,Kendall Campus,WBFI  118 - 02   Options Plain and Simple Part I,02-LEC Dynamic,Staff,25,0,25,0,0
2158,Kendall Campus,WBIE  118 - 01   Introducción a Importar y Exportar,01-LEC Dynamic,Staff,16,0,16,0,0
1180,Wolfson Campus,WBRE  118 - 01   Real Estate Exam Retake,01-LEC Dynamic,Staff,20,0,20,0,0
1184,Wolfson Campus,WBRE  118 - 02   Real Estate Exam Retake,02-LEC Dynamic,Staff,20,0,20,0,0
1193,Kendall Campus,WLEP  118 - 01   English Conversation 1 - 21 hrs,01-LEC Dynamic,Staff,25,0,25,0,0
1195,Kendall Campus,WLEP  118 - 02   English Conversation 1 - 21 hrs,02-LEC Dynamic,Staff,25,0,25,0,0
1197,Kendall Campus,WLEP  118 - 03   English Conversation 1 - 21 hrs,03-LEC Dynamic,Staff,25,0,25,0,0
1199,Kendall Campus,WLEP  118 - 04   English Conversation 1 - 21 hrs,04-LEC Dynamic,Staff,25,0,25,0,0
1524,Wolfson Campus,WTCA  118 - 01   Drafting Fundamentals,01-LEC Dynamic,Staff,20,0,20,0,0
1895,Kendall Campus,WTCA  118 - 02   Drafting Fundamentals,02-LEC Dynamic,Staff,15,0,15,0,0
1044,North Campus,WTCR  118 - 01   Computer Repair Level 2,01-LEC Dynamic,Staff,25,0,25,0,0
1747,Wolfson Campus,WTCR  118 - 02   Computer Repair Level 2,02-LEC Dynamic,Staff,20,0,20,0,0
1750,Wolfson Campus,WTCR  118 - 03   Computer Repair Level 2,03-LEC Dynamic,Staff,20,0,20,0,0
3617,North Campus,WTCR  118 - 04   Computer Repair Level 2,04-LEC Dynamic,Staff,16,0,16,0,0
1522,North Campus,WTDM  118 - 01   Adobe Photoshop CC Level 2,01-LEC Dynamic,Staff,15,0,15,0,0
1699,North Campus,WTDM  118 - 02   Adobe Photoshop CC Level 2,02-LEC Dynamic,Staff,20,0,20,0,0
1705,Wolfson Campus,WTDM  118 - 03   Adobe Photoshop CC Level 2,03-LEC Dynamic,Staff,20,0,20,0,0
3679,North Campus,WTDM  118 - 04   Adobe Photoshop CC Level 2,04-LEC Dynamic,Staff,16,0,16,0,0
3680,North Campus,WTDM  118 - 05   Adobe Photoshop CC Level 2,05-LEC Dynamic,Staff,16,0,16,0,0
2885,Kendall Campus,RLCP  117 - 01   SAT Boot Camp,01-LEC Dynamic,Staff,20,0,20,0,0
3589,Kendall Campus,RLEC  117 - 01   Service Learning,01-LEC Dynamic,Staff,15,0,15,0,0
2388,North Campus,RLFA  117 - 01   Reading Essentials - 5th and 6th Grade,01-LEC Dynamic,Staff,15,0,15,5,0
2389,North Campus,RLFA  117 - 02   Reading Essentials - 5th and 6th Grade,02-LEC Dynamic,Staff,15,0,15,5,0
3831,Kendall Campus,RLFS  117 - 01   Cross Training,01-LEC Dynamic,Staff,30,0,30,0,0
2986,Kendall Campus,RLKT  117 - 01   Adobe Illustrator for Teens (Ages 12-16),01-LEC Dynamic,Staff,15,0,15,0,0
1630,InterAmerican Campus,RLPD  117 - 01   Charcoal Drawing,01-LEC Dynamic,Staff,30,0,30,0,0
2912,Hialeah Campus,RLSC  117 - 01   55+ El Internet,01-LEC Dynamic,Staff,16,0,16,0,0
2725,Kendall Campus,RLSP  117 - 01   Sewing – Intermediate/Advanced,01-LEC Dynamic,Staff,15,0,15,0,0
2801,Kendall Campus,RLTH  117 - 01   An Introduction to Voiceovers,01-LEC Dynamic,Staff,20,0,20,0,0
1240,Wolfson Campus,WBCI  117 - 01   Fundamentals of Blueprint Reading,01-LEC Dynamic,Staff,30,0,30,0,0
1242,Wolfson Campus,WBCI  117 - 02   Fundamentals of Blueprint Reading,02-LEC Dynamic,Staff,30,0,30,0,0
2657,North Campus,WBCI  117 - 03   Fundamentals of Blueprint Reading,03-LEC Dynamic,Staff,30,0,30,0,0
2658,North Campus,WBCI  117 - 04   Fundamentals of Blueprint Reading,04-LEC Dynamic,Staff,30,0,30,0,0
1964,Wolfson Campus,WBEB  117 - 01   Branding Your Products and Services,01-LEC Dynamic,Staff,20,0,20,0,0
1141,Wolfson Campus,WBFI  117 - 01   Stock Market for Beginners,01-LEC Dynamic,Staff,16,0,16,0,0
2244,Wolfson Campus,WBFI  117 - 02   Stock Market for Beginners,02-LEC Dynamic,Staff,20,0,20,0,0
2296,Kendall Campus,WBIE  117 - 01   Introduction to Importing and Exporting,01-LEC Dynamic,Staff,25,0,25,0,0
2318,Wolfson Campus,WBIE  117 - 02   Introduction to Importing and Exporting,02-LEC Dynamic,Staff,30,0,30,0,0
3277,Wolfson Campus,WBIE  117 - 03   Introduction to Importing and Exporting,03-LEC Dynamic,Staff,30,0,30,0,0
1176,Kendall Campus,WLEP  117 - 01   English Conversation 1 - 56 hrs,01-LEC Dynamic,Staff,25,0,25,0,0
1178,Kendall Campus,WLEP  117 - 02   English Conversation 1 - 56 hrs,02-LEC Dynamic,Staff,25,0,25,0,0
2444,Hialeah Campus,WLEP  117 - 03   English Conversation 1 - 56 hrs,03-LEC Dynamic,Staff,16,0,16,0,0
2445,Hialeah Campus,WLEP  117 - 04   English Conversation 1 - 56 hrs,04-LEC Dynamic,Staff,16,0,16,0,0
1885,Kendall Campus,WTCA  117 - 01   AutoCAD 3D 2014 For Interior Designers,01-LEC Dynamic,Staff,15,0,15,0,0
3348,Kendall Campus,WTCI  117 - 01   Cisco CCNA 2013 (200-101 ICND2 v2.0) Part 2,01-LEC Dynamic,Staff,16,0,16,0,0
1043,North Campus,WTCR  117 - 01   Computer Repair Level 1,01-LEC Dynamic,Staff,25,0,25,0,0
1744,Wolfson Campus,WTCR  117 - 02   Computer Repair Level 1,02-LEC Dynamic,Staff,20,0,20,0,0
1749,Wolfson Campus,WTCR  117 - 03   Computer Repair Level 1,03-LEC Dynamic,Staff,20,0,20,0,0
3616,North Campus,WTCR  117 - 04   Computer Repair Level 1,04-LEC Dynamic,Staff,16,0,16,0,0
2349,Kendall Campus,RLAC  116 - 01   Scuba Certification - 30 hrs,01-LEC Dynamic,Staff,20,0,20,0,0
2350,Kendall Campus,RLAC  116 - 02   Scuba Certification - 30 hrs,02-LEC Dynamic,Staff,20,0,20,0,0
2585,West Campus,RLCP  116 - 01   PERT Verbal Review,01-LEC Dynamic,Staff,20,0,20,0,0
2586,West Campus,RLCP  116 - 02   PERT Verbal Review,02-LEC Dynamic,Staff,20,0,20,0,0
2587,West Campus,RLCP  116 - 03   PERT Verbal Review,03-LEC Dynamic,Staff,20,0,20,0,0
2881,Kendall Campus,RLCP  116 - 04   PERT Verbal Review,04-LEC Dynamic,Staff,20,0,20,0,0
2386,North Campus,RLFA  116 - 01   Reading Essentials - 3rd and 4th Grade,01-LEC Dynamic,Staff,15,0,15,5,0
2387,North Campus,RLFA  116 - 02   Reading Essentials - 3rd and 4th Grade,02-LEC Dynamic,Staff,15,0,15,5,0
2698,Kendall Campus,RLFD  116 - 01   Bridal Floral Design,01-LEC Dynamic,Staff,12,0,12,0,0
2701,Kendall Campus,RLFD  116 - 02   Bridal Floral Design,02-LEC Dynamic,Staff,12,0,12,0,0
2417,North Campus,RLFD  116 - 03   Bridal Floral Design,03-LEC Dynamic,Staff,16,0,16,8,0
3278,Kendall Campus,RLFS  116 - 01   Core Basics - Strengthen & Stretch,01-LEC Dynamic,Staff,16,0,16,0,0
3280,Kendall Campus,RLFS  116 - 02   Core Basics - Strengthen & Stretch,02-LEC Dynamic,Staff,16,0,16,0,0
3229,North Campus,WBEB  116 - 01   Starting Your Floral Business,01-LEC Dynamic,Staff,16,0,16,0,0
2246,Wolfson Campus,WBIE  116 - 01   Importing to and Exporting from the United States,01-LEC Dynamic,Staff,20,0,20,0,0
2317,Wolfson Campus,WBIE  116 - 02   Importing to and Exporting from the United States,02-LEC Dynamic,Staff,30,0,30,0,0
3244,North Campus,WBIE  116 - 03   Importing to and Exporting from the United States,03-LEC Dynamic,Staff,16,0,16,0,0
2069,Kendall Campus,WBRE  116 - 01   Mold Inspection Remediation,01-LEC Dynamic,Staff,15,0,15,0,0
2061,Kendall Campus,WBWA  116 - 01   Introduction to Writing Novels and Short Stories,01-LEC Dynamic,Staff,25,0,25,0,0
2293,Kendall Campus,WCIS  116 - 02   Understanding Developmentally Appropriate Practice (UDAP),02-LEC Dynamic,Staff,25,0,25,0,0
2294,Kendall Campus,WCIS  116 - 03   Understanding Developmentally Appropriate Practice (UDAP),03-LEC Dynamic,Staff,25,0,25,0,0
2297,Kendall Campus,WCIS  116 - 04   Understanding Developmentally Appropriate Practice (UDAP),04-LEC Dynamic,Staff,25,0,25,0,0
3626,Kendall Campus,WCIS  116 - 05   Understanding Developmentally Appropriate Practice (UDAP),05-LEC Dynamic,Staff,20,0,20,0,0
3627,Kendall Campus,WCIS  116 - 06   Understanding Developmentally Appropriate Practice (UDAP),06-LEC Dynamic,Staff,20,0,20,0,0
1433,Wolfson Campus,WLEP  116 - 01   English Conversation 1 - 42 hrs,01-LEC Dynamic,Staff,16,0,16,0,0
1977,Wolfson Campus,WLEP  116 - 02   English Conversation 1 - 42 hrs,02-LEC Dynamic,Staff,30,0,30,0,0
2359,North Campus,WLEP  116 - 03   English Conversation 1 - 42 hrs,03-LEC Dynamic,Staff,16,0,16,0,0
2360,North Campus,WLEP  116 - 04   English Conversation 1 - 42 hrs,04-LEC Dynamic,Staff,16,0,16,0,0
1969,Kendall Campus,WTCA  116 - 01   AutoCAD 2014 - Nivel 2,01-LEC Dynamic,Staff,15,0,15,0,0
3347,Kendall Campus,WTCI  116 - 01   Cisco CCNA 2013 (100-101 ICND1 v2.0) Part 1,01-LEC Dynamic,Staff,16,0,16,0,0
1564,Kendall Campus,WTDM  116 - 01   Adobe Illustrator CC Nivel 1,01-LEC Dynamic,Staff,15,0,15,0,0
3490,Kendall Campus,WTDM  116 - 02   Adobe Illustrator CC Nivel 1,02-LEC Dynamic,Staff,16,0,16,0,0
1364,Wolfson Campus,RLAR  115 - 01   Beginning Drawing,01-LEC Dynamic,Staff,20,0,20,0,0
1618,InterAmerican Campus,RLAR  115 - 02   Beginning Drawing,02-LEC Dynamic,Staff,15,0,15,0,0
1619,InterAmerican Campus,RLAR  115 - 03   Beginning Drawing,03-LEC Dynamic,Staff,15,0,15,0,0
1265,Wolfson Campus,RLCP  115 - 01   PERT Math Review,01-LEC Dynamic,Staff,25,0,25,0,0
1268,Wolfson Campus,RLCP  115 - 02   PERT Math Review,02-LEC Dynamic,Staff,25,0,25,0,0
1424,InterAmerican Campus,RLCP  115 - 03   PERT Math Review,03-LEC Dynamic,Staff,25,0,25,0,0
2579,West Campus,RLCP  115 - 04   PERT Math Review,04-LEC Dynamic,Staff,16,0,16,0,0
2580,West Campus,RLCP  115 - 05   PERT Math Review,05-LEC Dynamic,Staff,16,0,16,0,0
2581,West Campus,RLCP  115 - 06   PERT Math Review,06-LEC Dynamic,Staff,16,0,16,0,0
2878,Kendall Campus,RLCP  115 - 07   PERT Math Review,07-LEC Dynamic,Staff,20,0,20,0,0
2375,North Campus,RLFA  115 - 01   Reading Essentials - 1st and 2nd Grade,01-LEC Dynamic,Staff,15,0,15,5,0
2390,North Campus,RLFA  115 - 02   Reading Essentials - 1st and 2nd Grade,02-LEC Dynamic,Staff,15,0,15,0,0
1410,InterAmerican Campus,RLFD  115 - 01   Basic Floral Design,01-LEC Dynamic,Staff,16,0,16,0,0
3293,Kendall Campus,RLFS  115 - 01   Horseback Riding Care and Maintenance,01-LEC Dynamic,Staff,15,0,15,0,0
3294,Kendall Campus,RLFS  115 - 02   Horseback Riding Care and Maintenance,02-LEC Dynamic,Staff,15,0,15,0,0
2141,InterAmerican Campus,RLID  115 - 01   Decoración de Interiores: Intensivo Parte 2,01-LEC Dynamic,Staff,16,0,16,0,0
2714,Kendall Campus,RLPD  115 - 01   Painting with Pastels,01-LEC Dynamic,Staff,5,0,5,0,0
2716,Kendall Campus,RLPD  115 - 02   Painting with Pastels,02-LEC Dynamic,Staff,5,0,5,0,0
3851,North Campus,RLSP  115 - 01   Sewing 3,01-LEC Dynamic,Staff,16,0,16,0,0
3852,North Campus,RLSP  115 - 02   Sewing 3,02-LEC Dynamic,Staff,16,0,16,0,0
1515,InterAmerican Campus,RSPE  115 - 01   FTCE: Subject Area Exam: Mathematics (6-12),01-LEC Dynamic,Staff,16,0,16,0,0
1005,Homestead Campus,WBEB  115 - 01   Writing an Effective Business Plan,01-LEC Dynamic,Staff,25,0,25,0,0
1310,Wolfson Campus,WBEB  115 - 02   Writing an Effective Business Plan,02-LEC Dynamic,Staff,16,0,16,0,0
2062,Kendall Campus,WBEB  115 - 03   Writing an Effective Business Plan,03-LEC Dynamic,Staff,16,0,16,0,0
2157,Kendall Campus,WBIE  115 - 01   Importar y Exportar (Certificado),01-LEC Dynamic,Staff,16,0,16,0,0
1411,InterAmerican Campus,WBRE  115 - 01   Repaso para el Examen de la Licencia de Bienes Raíces,01-LEC Dynamic,Staff,25,0,25,0,0
2136,Kendall Campus,WBRE  115 - 02   Repaso para el Examen de la Licencia de Bienes Raíces,02-LEC Dynamic,Staff,15,0,15,0,0
2063,Kendall Campus,WBWA  115 - 01   Writing Novels and Short Stories - Intermediate level,01-LEC Dynamic,Staff,25,0,25,0,0
3411,Medical Campus,WHPH  115 - 01   Phlebotomy Review,01-LEC Dynamic,Staff,20,0,20,0,0
1875,Wolfson Campus,WTBT  115 - 01   Amazon for Sellers,01-LEC Dynamic,Staff,20,0,20,0,0
1037,Homestead Campus,WTCA  115 - 01   AutoCAD 2014 - Nivel 1,01-LEC Dynamic,Staff,25,0,25,0,0
1417,InterAmerican Campus,WTCA  115 - 02   AutoCAD 2014 - Nivel 1,02-LEC Dynamic,Staff,20,0,20,0,0
1963,Kendall Campus,WTCA  115 - 03   AutoCAD 2014 - Nivel 1,03-LEC Dynamic,Staff,15,0,15,0,0
3583,Wolfson Campus,WTDM  115 - 01   Adobe Crash Course - Ps· Ai & Id "All-in-one" - Level 1 (30 Hours),01-LEC Dynamic,Staff,20,0,20,0,0
1786,Wolfson Campus,WTVE  115 - 01   Record· Edit· and Share,01-LEC Dynamic,Staff,20,0,20,0,0
2402,North Campus,RLAC  114 - 01   Private Swim Classes,01-LEC Dynamic,Staff,8,0,8,5,0
3745,Kendall Campus,RLAC  114 - 03   Private Swim Classes,03-LEC Dynamic,Staff,8,0,8,0,0
3747,Kendall Campus,RLAC  114 - 04   Private Swim Classes,04-LEC Dynamic,Staff,8,0,8,0,0
1212,Homestead Campus,RLAR  114 - 01   Beginners Painting and Drawing (24 Hours),01-LEC Dynamic,Staff,25,0,25,0,0
1272,Wolfson Campus,RLCP  114 - 01   PERT English Review,01-LEC Dynamic,Staff,25,0,25,0,0
1301,Wolfson Campus,RLCP  114 - 02   PERT English Review,02-LEC Dynamic,Staff,25,0,25,0,0
2410,North Campus,RLCP  114 - 03   PERT English Review,03-LEC Dynamic,Staff,20,0,20,10,0
2409,North Campus,RLCP  114 - 05   PERT English Review,05-LEC Dynamic,Staff,20,0,20,10,0
2455,Hialeah Campus,RLCP  114 - 06   PERT English Review,06-LEC Dynamic,Staff,20,0,20,0,0
2426,North Campus,RLEC  114 - 01   Organic Gardening,01-LEC Dynamic,Staff,15,0,15,5,0
2371,North Campus,RLFA  114 - 01   Math Review - 1st and 2nd Grades,01-LEC Dynamic,Staff,15,0,15,5,0
2372,North Campus,RLFA  114 - 02   Math Review - 1st and 2nd Grades,02-LEC Dynamic,Staff,15,0,15,5,0
3283,Kendall Campus,RLFS  114 - 01   Fitness Series,01-LEC Dynamic,Staff,30,0,30,0,0
3285,Kendall Campus,RLFS  114 - 02   Fitness Series,02-LEC Dynamic,Staff,30,0,30,0,0
2140,InterAmerican Campus,RLID  114 - 01   Decoración de Interiores: Intensivo Parte 1,01-LEC Dynamic,Staff,16,0,16,0,0
2987,Kendall Campus,RLKC  114 - 01   Digital Cartooning (Ages 12-16),01-LEC Dynamic,Staff,15,0,15,0,0
1383,Wolfson Campus,RLPH  114 - 01   Fotografia Intermedia,01-LEC Dynamic,Staff,20,0,20,0,0
1384,Wolfson Campus,RLPH  114 - 02   Fotografia Intermedia,02-LEC Dynamic,Staff,20,0,20,0,0
1643,InterAmerican Campus,RLPH  114 - 03   Fotografia Intermedia,03-LEC Dynamic,Staff,16,0,16,0,0
3165,Hialeah Campus,RLPH  114 - 04   Fotografia Intermedia,04-LEC Dynamic,Staff,30,0,30,0,0
3145,Hialeah Campus,RLSC  114 - 01   55+ All About Windows,01-LEC Dynamic,Staff,16,0,16,0,0
3849,North Campus,RLSP  114 - 01   Sewing 2,01-LEC Dynamic,Staff,16,0,16,0,0
3850,North Campus,RLSP  114 - 02   Sewing 2,02-LEC Dynamic,Staff,16,0,16,0,0
1751,Wolfson Campus,RLTH  114 - 01   Prometeo - Professional Track Application,01-LEC Dynamic,Staff,50,0,50,0,0
2957,Hialeah Campus,WBAB  114 - 01   Certified Bookkeeper Test Preparation: Payroll,01-LEC Dynamic,Staff,30,0,30,0,0
3057,Hialeah Campus,WBEB  114 - 01   Simple Steps to Start Your Own Business Series,01-LEC Dynamic,Staff,30,0,30,0,0
3090,Kendall Campus,WBIE  114 - 01   How to Finance your Import/Export Business,01-LEC Dynamic,Staff,16,0,16,0,0
3346,Wolfson Campus,WBIE  114 - 02   How to Finance your Import/Export Business,02-LEC Dynamic,Staff,30,0,30,0,0
2064,Kendall Campus,WBRE  114 - 01   Principles of Home Inspection – Field Inspections Provider #0002375 (ID# 0000031),01-LEC Dynamic,Staff,15,0,15,0,0
3750,Wolfson Campus,WBRE  114 - 02   Principles of Home Inspection – Field Inspections Provider #0002375 (ID# 0000031),02-LEC Dynamic,Staff,30,0,30,0,0
1658,Wolfson Campus,WBWA  114 - 01   Writing and Composition 1,01-LEC Dynamic,Staff,15,0,15,0,0
2173,Wolfson Campus,WBWA  114 - 02   Writing and Composition 1,02-LEC Dynamic,Staff,30,0,30,0,0
3049,Hialeah Campus,WCCP  114 - 01   Currículo Creativo Preescolar:  Literatura (4.5 CEUs),01-LEC Dynamic,Staff,30,0,30,0,0
3371,Medical Campus,WHEP  114 - 01   TABE Test Review - Math,01-LEC Dynamic,Staff,25,0,25,0,0
1881,Kendall Campus,WTCA  114 - 01   AutoCAD 2014 - Level 4,01-LEC Dynamic,Staff,15,0,15,0,0
3686,North Campus,WTCA  114 - 02   AutoCAD 2014 - Level 4,02-LEC Dynamic,Staff,15,0,15,0,0
3133,Hialeah Campus,WTDM  114 - 01   Adobe Crash Course - Ps· Ai & Id "All-in-one" - Level 1 (15 hours),01-LEC Dynamic,Staff,16,0,16,0,0
3099,Kendall Campus,RLAC  113 - 01   Pre-swim Team (16 Hours),01-LEC Dynamic,Staff,10,0,10,0,0
3102,Kendall Campus,RLAC  113 - 02   Pre-swim Team (16 Hours),02-LEC Dynamic,Staff,10,0,10,0,0
3104,Kendall Campus,RLAC  113 - 03   Pre-swim Team (16 Hours),03-LEC Dynamic,Staff,10,0,10,0,0
2425,North Campus,RLEC  113 - 01   Organic Composting,01-LEC Dynamic,Staff,16,0,16,8,0
2703,Kendall Campus,RLFA  113 - 01   FSA - 8th Grade Reading Review,01-LEC Dynamic,Staff,20,0,20,0,0
1730,Wolfson Campus,RLFL  113 - 01   French 1 Intensive,01-LEC Dynamic,Staff,30,0,30,0,0
2215,Wolfson Campus,RLFL  113 - 02   French 1 Intensive,02-LEC Dynamic,Staff,30,0,30,0,0
2705,Kendall Campus,RLPD  113 - 01   Basic Drawing,01-LEC Dynamic,Staff,20,0,20,0,0
2706,Kendall Campus,RLPD  113 - 02   Basic Drawing,02-LEC Dynamic,Staff,20,0,20,0,0
2419,North Campus,RLPD  113 - 03   Basic Drawing,03-LEC Dynamic,Staff,15,0,15,5,0
2420,North Campus,RLPD  113 - 04   Basic Drawing,04-LEC Dynamic,Staff,15,0,15,8,0
1381,Wolfson Campus,RLPH  113 - 01   Fotografía Basica,01-LEC Dynamic,Staff,20,0,20,0,0
1382,Wolfson Campus,RLPH  113 - 02   Fotografía Basica,02-LEC Dynamic,Staff,20,0,20,0,0
1644,InterAmerican Campus,RLPH  113 - 03   Fotografía Basica,03-LEC Dynamic,Staff,16,0,16,0,0
3847,North Campus,RLSP  113 - 01   Sewing 1,01-LEC Dynamic,Staff,16,0,16,0,0
3848,North Campus,RLSP  113 - 02   Sewing 1,02-LEC Dynamic,Staff,16,0,16,0,0
1756,Wolfson Campus,RLTH  113 - 01   Los Prometeítos,01-LEC Dynamic,Staff,30,0,30,0,0
1510,InterAmerican Campus,RSPE  113 - 01   FTCE: Subject Area Exam Middle Grades Mathematics (5-9),01-LAB Dynamic,Staff,16,0,16,0,0
2954,Hialeah Campus,WBAB  113 - 01   Certified Bookkeeper Test Preparation: Inventory and Internal Controls,01-LEC Dynamic,Staff,30,0,30,0,0
1653,InterAmerican Campus,WBCI  113 - 01   General Contractor License Exam Preparation,01-LEC Dynamic,Staff,30,0,30,0,0
2650,West Campus,WBCI  113 - 02   General Contractor License Exam Preparation,02-LEC Dynamic,Staff,30,0,30,0,0
2659,North Campus,WBCI  113 - 03   General Contractor License Exam Preparation,03-LEC Dynamic,Staff,30,0,30,0,0
3537,Wolfson Campus,WBCI  113 - 04   General Contractor License Exam Preparation,04-LEC Dynamic,Staff,32,0,32,0,0
2240,Wolfson Campus,WBEB  113 - 01   Starting and Operating Your Own Business,01-LEC Dynamic,Staff,20,0,20,0,0
1460,Wolfson Campus,WBIE  113 - 01   Global Logistics Associate Certification,01-LEC Dynamic,Staff,25,0,25,0,0
2351,Kendall Campus,WBIE  113 - 02   Global Logistics Associate Certification,02-LEC Dynamic,Staff,25,0,25,0,0
3242,North Campus,WBIE  113 - 03   Global Logistics Associate Certification,03-LEC Dynamic,Staff,16,0,16,0,0
2065,Kendall Campus,WBRE  113 - 01   Home Inspector Continuing Education (14 Hours),01-LEC Dynamic,Staff,15,0,15,0,0
3203,North Campus,WCTR  113 - 02   5 Hours School-Age Appropriate Practices,02-LEC Dynamic,Staff,16,0,16,8,0
3205,North Campus,WCTR  113 - 03   5 Hours School-Age Appropriate Practices,03-LEC Dynamic,Staff,16,0,16,8,0
3207,North Campus,WCTR  113 - 04   5 Hours School-Age Appropriate Practices,04-LEC Dynamic,Staff,16,0,16,8,0
3758,Homestead Campus,WCTR  113 - 05   5 Hours School-Age Appropriate Practices,05-LEC Dynamic,Staff,25,0,25,0,0
3370,Medical Campus,WHEP  113 - 01   TABE Test Review - Language,01-LEC Dynamic,Staff,25,0,25,0,0
3406,Medical Campus,WHNC  113 - 01   Nursing Skills Update,01-LEC Dynamic,Staff,16,0,16,0,0
3407,Medical Campus,WHNC  113 - 02   Nursing Skills Update,02-LEC Dynamic,Staff,16,0,16,0,0
3408,Medical Campus,WHNC  113 - 03   Nursing Skills Update,03-LEC Dynamic,Staff,16,0,16,0,0
2639,West Campus,WLEP  113 - 01   English Conversation 2A (70 Hours),01-LEC Dynamic,Staff,16,0,16,0,0
1862,Wolfson Campus,WTCA  113 - 01   AutoCAD 2014 - Level 3,01-LEC Dynamic,Staff,20,0,20,0,0
1901,Kendall Campus,WTCA  113 - 02   AutoCAD 2014 - Level 3,02-LEC Dynamic,Staff,15,0,15,0,0
2943,Hialeah Campus,WTCA  113 - 03   AutoCAD 2014 - Level 3,03-LEC Dynamic,Staff,16,0,16,0,0
3685,North Campus,WTCA  113 - 04   AutoCAD 2014 - Level 3,04-LEC Dynamic,Staff,15,0,15,0,0
1339,North Campus,WTDM  113 - 01   Adobe Photoshop CC Level 1,01-LEC Dynamic,Staff,15,0,15,0,0
1342,North Campus,WTDM  113 - 02   Adobe Photoshop CC Level 1,02-LEC Dynamic,Staff,15,0,15,0,0
1414,InterAmerican Campus,WTDM  113 - 03   Adobe Photoshop CC Level 1,03-LEC Dynamic,Staff,20,0,20,0,0
1588,Wolfson Campus,WTDM  113 - 04   Adobe Photoshop CC Level 1,04-LEC Dynamic,Staff,20,0,20,0,0
1696,Wolfson Campus,WTDM  113 - 05   Adobe Photoshop CC Level 1,05-LEC Dynamic,Staff,25,0,25,0,0
2531,West Campus,WTDM  113 - 06   Adobe Photoshop CC Level 1,06-LEC Dynamic,Staff,35,0,35,0,0
3677,North Campus,WTDM  113 - 07   Adobe Photoshop CC Level 1,07-LEC Dynamic,Staff,16,0,16,0,0
3678,North Campus,WTDM  113 - 08   Adobe Photoshop CC Level 1,08-LEC Dynamic,Staff,16,0,16,0,0
2794,Kendall Campus,RLAC  112 - 01,01-LEC Dynamic,Staff,5,0,5,0,0
1620,InterAmerican Campus,RLAR  112 - 01   Arte de Arcilla,01-LEC Dynamic,Staff,30,0,30,0,0
2408,North Campus,RLCP  112 - 02   PERT Algebra Review,02-LEC Dynamic,Staff,16,0,16,8,0
2456,Hialeah Campus,RLCP  112 - 03   PERT Algebra Review,03-LEC Dynamic,Staff,20,0,20,0,0
2407,North Campus,RLCP  112 - 04   PERT Algebra Review,04-LEC Dynamic,Staff,16,0,16,8,0
2874,Kendall Campus,RLCP  112 - 05   PERT Algebra Review,05-LEC Dynamic,Staff,20,0,20,0,0
2457,Hialeah Campus,RLCP  112 - 06   PERT Algebra Review,06-LEC Dynamic,Staff,20,0,20,0,0
2696,Kendall Campus,RLFA  112 - 01   FSA - 8th Grade Math Review (12 Hours),01-LEC Dynamic,Staff,20,0,20,0,0
2862,Kendall Campus,RLGE  112 - 01   LSAT Test Review,01-LEC Dynamic,Staff,20,0,20,0,0
1713,Kendall Campus,RLPF  112 - 01   Parent Education and Family Stabilization Course (CODP),01-LEC Dynamic,Staff,30,0,30,0,0
1714,Kendall Campus,RLPF  112 - 02   Parent Education and Family Stabilization Course (CODP),02-LEC Dynamic,Staff,30,0,30,0,0
1715,Kendall Campus,RLPF  112 - 03   Parent Education and Family Stabilization Course (CODP),03-LEC Dynamic,Staff,30,0,30,0,0
1716,Kendall Campus,RLPF  112 - 04   Parent Education and Family Stabilization Course (CODP),04-LEC Dynamic,Staff,30,0,30,0,0
1719,Kendall Campus,RLPF  112 - 05   Parent Education and Family Stabilization Course (CODP),05-LEC Dynamic,Staff,30,0,30,0,0
1720,Kendall Campus,RLPF  112 - 06   Parent Education and Family Stabilization Course (CODP),06-LEC Dynamic,Staff,30,0,30,0,0
2253,Wolfson Campus,RLPF  112 - 07   Parent Education and Family Stabilization Course (CODP),07-LEC Dynamic,Staff,30,0,30,0,0
2254,Wolfson Campus,RLPF  112 - 08   Parent Education and Family Stabilization Course (CODP),08-LEC Dynamic,Staff,30,0,30,0,0
2255,Wolfson Campus,RLPF  112 - 09   Parent Education and Family Stabilization Course (CODP),09-LEC Dynamic,Staff,30,0,30,0,0
2256,Wolfson Campus,RLPF  112 - 10   Parent Education and Family Stabilization Course (CODP),10-LEC Dynamic,Staff,30,0,30,0,0
2916,Hialeah Campus,RLSC  112 - 01   55+ Navegando Windows 7 - Nivel 2,01-LEC Dynamic,Staff,16,0,16,0,0
1754,Wolfson Campus,RLTH  112 - 01   Preparando al Actor,01-LEC Dynamic,Staff,25,0,25,0,0
2953,Hialeah Campus,WBAB  112 - 01   Certified Bookkeeper Test Preparation: Depreciation,01-LEC Dynamic,Staff,30,0,30,0,0
1321,Wolfson Campus,WBCI  112 - 01   Contract Administration and Management,01-LEC Dynamic,Staff,30,0,30,0,0
1187,Wolfson Campus,WBEB  112 - 01   Starting a Small Business,01-LEC Dynamic,Staff,25,0,25,0,0
2019,Kendall Campus,WBEB  112 - 02   Starting a Small Business,02-LEC Dynamic,Staff,20,0,20,0,0
3227,North Campus,WBEB  112 - 03   Starting a Small Business,03-LEC Dynamic,Staff,16,0,16,0,0
3228,North Campus,WBEB  112 - 04   Starting a Small Business,04-LEC Dynamic,Staff,16,0,16,0,0
1996,Wolfson Campus,WBEP  112 - 01   National Retail Federation Foundation (NRFF) Customer Service & Sales Certification Exam Preparation,01-LEC Dynamic,Staff,20,0,20,0,0
2649,West Campus,WBEP  112 - 02   National Retail Federation Foundation (NRFF) Customer Service & Sales Certification Exam Preparation,02-LEC Dynamic,Staff,16,0,16,0,0
2366,Kendall Campus,WBFI  112 - 01   Investment for Beginners,01-LEC Dynamic,Staff,25,0,25,0,0
1347,Wolfson Campus,WBIE  112 - 01   Freight Broker Essentials,01-LEC Dynamic,Staff,25,0,25,0,0
2652,West Campus,WBIE  112 - 02   Freight Broker Essentials,02-LEC Dynamic,Staff,16,0,16,0,0
3246,North Campus,WBIE  112 - 03   Freight Broker Essentials,03-LEC Dynamic,Staff,16,0,16,0,0
1015,Homestead Campus,WBRE  112 - 01   Home Inspection Pre Licensing Provider #0002375 (State Course ID No. 0000004),01-LEC Dynamic,Staff,25,0,25,0,0
1246,Wolfson Campus,WBRE  112 - 02   Home Inspection Pre Licensing Provider #0002375 (State Course ID No. 0000004),02-LEC Dynamic,Staff,25,0,25,0,0
2059,Kendall Campus,WBRE  112 - 03   Home Inspection Pre Licensing Provider #0002375 (State Course ID No. 0000004),03-LEC Dynamic,Staff,15,0,15,0,0
1058,Homestead Campus,WCTR  112 - 01   5 Hours Infant-Toddler Appropriate Practices,01-LEC Dynamic,Staff,25,0,25,0,0
3192,North Campus,WCTR  112 - 04   5 Hours Infant-Toddler Appropriate Practices,04-LEC Dynamic,Staff,16,0,16,8,0
1249,Kendall Campus,WCTR  112 - 05   5 Hours Infant-Toddler Appropriate Practices,05-LEC Dynamic,Staff,25,0,25,0,0
2914,North Campus,WCTR  112 - 06   5 Hours Infant-Toddler Appropriate Practices,06-LEC Dynamic,Staff,21,0,21,8,0
2911,North Campus,WCTR  112 - 07   5 Hours Infant-Toddler Appropriate Practices,07-LEC Dynamic,Staff,21,0,21,8,0
2928,North Campus,WCTR  112 - 08   5 Hours Infant-Toddler Appropriate Practices,08-LEC Dynamic,Staff,16,0,16,8,0
2917,North Campus,WCTR  112 - 09   5 Hours Infant-Toddler Appropriate Practices,09-LEC Dynamic,Staff,16,0,16,8,0
3195,North Campus,WCTR  112 - 10   5 Hours Infant-Toddler Appropriate Practices,10-LEC Dynamic,Staff,16,0,16,8,0
3199,North Campus,WCTR  112 - 11   5 Hours Infant-Toddler Appropriate Practices,11-LEC Dynamic,Staff,16,0,16,8,0
3368,Medical Campus,WHEP  112 - 01   HESI A2 Exam Review: The Sciences,01-LEC Dynamic,Staff,25,0,25,0,0
3369,Medical Campus,WHEP  112 - 02   HESI A2 Exam Review: The Sciences,02-LEC Dynamic,Staff,25,0,25,0,0
1458,Wolfson Campus,WLEP  112 - 01   English Conversation 3A,01-LEC Dynamic,Staff,30,0,30,0,0
1992,Wolfson Campus,WLEP  112 - 02   English Conversation 3A,02-LEC Dynamic,Staff,30,0,30,0,0
1034,Homestead Campus,WTCA  112 - 01   AutoCAD 2014 - Level 2,01-LEC Dynamic,Staff,25,0,25,0,0
1788,Wolfson Campus,WTCA  112 - 02   AutoCAD 2014 - Level 2,02-LEC Dynamic,Staff,20,0,20,0,0
1790,Wolfson Campus,WTCA  112 - 03   AutoCAD 2014 - Level 2,03-LEC Dynamic,Staff,20,0,20,0,0
1899,Kendall Campus,WTCA  112 - 04   AutoCAD 2014 - Level 2,04-LEC Dynamic,Staff,15,0,15,0,0
2941,Hialeah Campus,WTCA  112 - 05   AutoCAD 2014 - Level 2,05-LEC Dynamic,Staff,16,0,16,0,0
2548,West Campus,WTCA  112 - 06   AutoCAD 2014 - Level 2,06-LEC Dynamic,Staff,15,0,15,0,0
3683,North Campus,WTCA  112 - 07   AutoCAD 2014 - Level 2,07-LEC Dynamic,Staff,15,0,15,0,0
3684,North Campus,WTCA  112 - 08   AutoCAD 2014 - Level 2,08-LEC Dynamic,Staff,15,0,15,0,0
1557,Kendall Campus,WTDM  112 - 01   Adobe InDesign CC Level 1,01-LEC Dynamic,Staff,15,0,15,0,0
1726,Wolfson Campus,WTDM  112 - 02   Adobe InDesign CC Level 1,02-LEC Dynamic,Staff,20,0,20,0,0
2535,West Campus,WTDM  112 - 03   Adobe InDesign CC Level 1,03-LEC Dynamic,Staff,35,0,35,0,0
2326,Kendall Campus,RLAC  111 - 01   Parent and Child Aquatics 1 (Ages 2 - 3),01-LEC Dynamic,Staff,10,0,10,0,0
2327,Kendall Campus,RLAC  111 - 02   Parent and Child Aquatics 1 (Ages 2 - 3),02-LEC Dynamic,Staff,10,0,10,0,0
2415,North Campus,RLAC  111 - 03   Parent and Child Aquatics 1 (Ages 2 - 3),03-LEC Dynamic,Staff,10,0,10,5,0
2416,North Campus,RLAC  111 - 04   Parent and Child Aquatics 1 (Ages 2 - 3),04-LEC Dynamic,Staff,10,0,10,5,0
2844,Kendall Campus,RLDA  111 - 01   Bollywood Indian Style Dance,01-LEC Dynamic,Staff,30,0,30,0,0
2845,Kendall Campus,RLDA  111 - 02   Bollywood Indian Style Dance,02-LEC Dynamic,Staff,30,0,30,0,0
2695,Kendall Campus,RLFA  111 - 01   FSA - 7th Grade Reading Review,01-LEC Dynamic,Staff,20,0,20,0,0
3123,Hialeah Campus,RLFD  111 - 01   Diseños Florales Exóticos,01-LEC Dynamic,Staff,30,0,30,0,0
3845,North Campus,RLFI  111 - 01   Pattern Making 3,01-LEC Dynamic,Staff,16,0,16,0,0
3846,North Campus,RLFI  111 - 02   Pattern Making 3,02-LEC Dynamic,Staff,16,0,16,0,0
1722,Wolfson Campus,RLFL  111 - 01   Haitian Creole Conversation - Beginners,01-LEC Dynamic,Staff,30,0,30,0,0
2210,Wolfson Campus,RLFL  111 - 02   Haitian Creole Conversation - Beginners,02-LEC Dynamic,Staff,30,0,30,0,0
2806,Kendall Campus,RLHL  111 - 01   Reiki 1,01-LEC Dynamic,Staff,15,0,15,0,0
2717,Kendall Campus,RLPD  111 - 01   Pintando con Acrílicos,01-LEC Dynamic,Staff,10,0,10,0,0
2718,Kendall Campus,RLPD  111 - 02   Pintando con Acrílicos,02-LEC Dynamic,Staff,10,0,10,0,0
3129,Hialeah Campus,RLPD  111 - 03   Pintando con Acrílicos,03-LEC Dynamic,Staff,30,0,30,0,0
1770,Kendall Campus,RLPF  111 - 01   Curso de Educación y Estabilización Familiar (CODP - Ayuda Legal),01-LAB Dynamic,Staff,0,0,0,0,0
1773,Kendall Campus,RLPF  111 - 02   Curso de Educación y Estabilización Familiar (CODP - Ayuda Legal),02-LAB Dynamic,Staff,0,0,0,0,0
1775,Kendall Campus,RLPF  111 - 03   Curso de Educación y Estabilización Familiar (CODP - Ayuda Legal),03-LAB Dynamic,Staff,5,0,5,0,0
1779,Kendall Campus,RLPF  111 - 04   Curso de Educación y Estabilización Familiar (CODP - Ayuda Legal),04-LAB Dynamic,Staff,5,0,5,0,0
1784,Kendall Campus,RLPF  111 - 05   Curso de Educación y Estabilización Familiar (CODP - Ayuda Legal),05-LAB Dynamic,Staff,5,0,5,0,0
1785,Kendall Campus,RLPF  111 - 06   Curso de Educación y Estabilización Familiar (CODP - Ayuda Legal),06-LAB Dynamic,Staff,5,0,5,0,0
2915,Hialeah Campus,RLSC  111 - 01   55+ Navegando Windows 7 - Nivel 1,01-LEC Dynamic,Staff,16,0,16,0,0
2944,Hialeah Campus,WBAB  111 - 01   Certified Bookkeeper Exam Preparation: Beginning Bookkeeping,01-LEC Dynamic,Staff,30,0,30,0,0
3107,North Campus,WBAC  111 - 01   Lifeguard Training Certification Preparation,01-LEC Dynamic,Staff,16,0,16,0,0
3108,North Campus,WBAC  111 - 02   Lifeguard Training Certification Preparation,02-LEC Dynamic,Staff,16,0,16,0,0
3458,Kendall Campus,WBAC  111 - 03   Lifeguard Training Certification Preparation,03-LEC Dynamic,Staff,16,0,16,0,0
3459,Kendall Campus,WBAC  111 - 05   Lifeguard Training Certification Preparation,05-LEC Dynamic,Staff,16,0,16,0,0
3462,Kendall Campus,WBAC  111 - 06   Lifeguard Training Certification Preparation,06-LEC Dynamic,Staff,16,0,16,0,0
3466,Kendall Campus,WBAC  111 - 07   Lifeguard Training Certification Preparation,07-LEC Dynamic,Staff,16,0,16,0,0
1338,Wolfson Campus,WBFI  111 - 01   Investing in Real Estate,01-LEC Dynamic,Staff,16,0,16,0,0
2302,Kendall Campus,WBIE  111 - 01   Freight Forwarding,01-LEC Dynamic,Staff,25,0,25,0,0
2653,West Campus,WBIE  111 - 02   Freight Forwarding,02-LEC Dynamic,Staff,16,0,16,0,0
3241,North Campus,WBIE  111 - 03   Freight Forwarding,03-LEC Dynamic,Staff,16,0,16,0,0
2080,Kendall Campus,WBPD  111 - 01   Speak Like a Professional,01-LEC Dynamic,Staff,16,0,16,0,0
2920,Kendall Campus,WBRE  111 - 01   Home Inspection Make-up Class,01-LEC Dynamic,Staff,16,0,16,0,0
2931,Kendall Campus,WBRE  111 - 02   Home Inspection Make-up Class,02-LEC Dynamic,Staff,16,0,16,0,0
2942,Kendall Campus,WBRE  111 - 03   Home Inspection Make-up Class,03-LEC Dynamic,Staff,16,0,16,0,0
1638,InterAmerican Campus,WBTP  111 - 01   Turbo Tax,01-LEC Dynamic,Staff,16,0,16,0,0
3067,Hialeah Campus,WBTP  111 - 02   Turbo Tax,02-LEC Dynamic,Staff,16,0,16,0,0
1047,Homestead Campus,WBWA  111 - 01   Workplace Writing,01-LEC Dynamic,Staff,25,0,25,0,0
1068,Homestead Campus,WCTR  111 - 01   5 Horas de Prácticas Apropiadas para Niños de Edad Preescolar,01-LEC Dynamic,Staff,25,0,25,0,0
1546,Kendall Campus,WCTR  111 - 04   5 Horas de Prácticas Apropiadas para Niños de Edad Preescolar,04-LEC Dynamic,Staff,25,0,25,0,0
1547,Kendall Campus,WCTR  111 - 05   5 Horas de Prácticas Apropiadas para Niños de Edad Preescolar,05-LEC Dynamic,Staff,25,0,25,0,0
1548,Kendall Campus,WCTR  111 - 06   5 Horas de Prácticas Apropiadas para Niños de Edad Preescolar,06-LEC Dynamic,Staff,25,0,25,0,0
1549,Kendall Campus,WCTR  111 - 07   5 Horas de Prácticas Apropiadas para Niños de Edad Preescolar,07-LEC Dynamic,Staff,25,0,25,0,0
1550,Kendall Campus,WCTR  111 - 08   5 Horas de Prácticas Apropiadas para Niños de Edad Preescolar,08-LEC Dynamic,Staff,25,0,25,0,0
1598,InterAmerican Campus,WCTR  111 - 09   5 Horas de Prácticas Apropiadas para Niños de Edad Preescolar,09-LEC Dynamic,Staff,25,0,25,0,0
1599,InterAmerican Campus,WCTR  111 - 10   5 Horas de Prácticas Apropiadas para Niños de Edad Preescolar,10-LEC Dynamic,Staff,25,0,25,0,0
2582,Hialeah Campus,WCTR  111 - 11   5 Horas de Prácticas Apropiadas para Niños de Edad Preescolar,11-LEC Dynamic,Staff,30,0,30,0,0
2583,Hialeah Campus,WCTR  111 - 12   5 Horas de Prácticas Apropiadas para Niños de Edad Preescolar,12-LEC Dynamic,Staff,30,0,30,0,0
2584,Hialeah Campus,WCTR  111 - 13   5 Horas de Prácticas Apropiadas para Niños de Edad Preescolar,13-LEC Dynamic,Staff,30,0,30,0,0
2620,West Campus,WCTR  111 - 14   5 Horas de Prácticas Apropiadas para Niños de Edad Preescolar,14-LEC Dynamic,Staff,20,0,20,0,0
2615,West Campus,WCTR  111 - 15   5 Horas de Prácticas Apropiadas para Niños de Edad Preescolar,15-LEC Dynamic,Staff,20,0,20,0,0
2616,West Campus,WCTR  111 - 16   5 Horas de Prácticas Apropiadas para Niños de Edad Preescolar,16-LEC Dynamic,Staff,25,0,25,0,0
2617,West Campus,WCTR  111 - 17   5 Horas de Prácticas Apropiadas para Niños de Edad Preescolar,17-LEC Dynamic,Staff,25,0,25,0,0
2618,West Campus,WCTR  111 - 18   5 Horas de Prácticas Apropiadas para Niños de Edad Preescolar,18-LEC Dynamic,Staff,25,0,25,0,0
2619,West Campus,WCTR  111 - 19   5 Horas de Prácticas Apropiadas para Niños de Edad Preescolar,19-LEC Dynamic,Staff,25,0,25,0,0
3367,Medical Campus,WHEP  111 - 01   HESI A2 Exam Review: Mathematics,01-LEC Dynamic,Staff,25,0,25,0,0
1455,Wolfson Campus,WLEP  111 - 01   English Conversation 2B,01-LEC Dynamic,Staff,16,0,16,0,0
1990,Wolfson Campus,WLEP  111 - 02   English Conversation 2B,02-LEC Dynamic,Staff,30,0,30,0,0
1033,Homestead Campus,WTCA  111 - 01   AutoCAD 2014 - Level 1,01-LEC Dynamic,Staff,25,0,25,0,0
1590,Wolfson Campus,WTCA  111 - 02   AutoCAD 2014 - Level 1,02-LEC Dynamic,Staff,20,0,20,0,0
1789,Wolfson Campus,WTCA  111 - 03   AutoCAD 2014 - Level 1,03-LEC Dynamic,Staff,20,0,20,0,0
1897,Kendall Campus,WTCA  111 - 04   AutoCAD 2014 - Level 1,04-LEC Dynamic,Staff,15,0,15,0,0
2938,Hialeah Campus,WTCA  111 - 05   AutoCAD 2014 - Level 1,05-LEC Dynamic,Staff,16,0,16,0,0
2545,West Campus,WTCA  111 - 06   AutoCAD 2014 - Level 1,06-LEC Dynamic,Staff,15,0,15,0,0
2547,West Campus,WTCA  111 - 07   AutoCAD 2014 - Level 1,07-LEC Dynamic,Staff,15,0,15,0,0
3681,North Campus,WTCA  111 - 08   AutoCAD 2014 - Level 1,08-LEC Dynamic,Staff,15,0,15,0,0
3682,North Campus,WTCA  111 - 09   AutoCAD 2014 - Level 1,09-LEC Dynamic,Staff,15,0,15,0,0
1555,Kendall Campus,WTDM  111 - 01   Adobe Illustrator CC Level 2,01-LEC Dynamic,Staff,15,0,15,0,0
1701,Wolfson Campus,WTDM  111 - 02   Adobe Illustrator CC Level 2,02-LEC Dynamic,Staff,20,0,20,0,0
1791,Wolfson Campus,WTWD  111 - 01   Bootstrap - Level 1,01-LEC Dynamic,Staff,25,0,25,0,0
2328,Kendall Campus,RLAC  110 - 01   Parent and Child Aquatics 1 (Ages 2 - 3),01-LEC Dynamic,Staff,4,0,4,0,0
2329,Kendall Campus,RLAC  110 - 02   Parent and Child Aquatics 1 (Ages 2 - 3),02-LEC Dynamic,Staff,4,0,4,0,0
2330,Kendall Campus,RLAC  110 - 03   Parent and Child Aquatics 1 (Ages 2 - 3),03-LEC Dynamic,Staff,4,0,4,0,0
2331,Kendall Campus,RLAC  110 - 04   Parent and Child Aquatics 1 (Ages 2 - 3),04-LEC Dynamic,Staff,4,0,4,0,0
2332,Kendall Campus,RLAC  110 - 05   Parent and Child Aquatics 1 (Ages 2 - 3),05-LEC Dynamic,Staff,4,0,4,0,0
2333,Kendall Campus,RLAC  110 - 06   Parent and Child Aquatics 1 (Ages 2 - 3),06-LEC Dynamic,Staff,4,0,4,0,0
2733,Kendall Campus,RLCP  110 - 01   GED en español – Nivel Superior,01-LEC Dynamic,Staff,20,0,20,0,0
2949,Kendall Campus,RLDA  110 - 01   Belly Dance-Professional Level,01-LEC Dynamic,Staff,40,0,40,0,0
2950,Kendall Campus,RLDA  110 - 02   Belly Dance-Professional Level,02-LEC Dynamic,Staff,40,0,40,0,0
2694,Kendall Campus,RLFA  110 - 01   FSA - 7th Grade Math Review (12 Hours),01-LEC Dynamic,Staff,20,0,20,0,0
3164,Hialeah Campus,RLFD  110 - 01   Diseño Floral con Brazaletes y Collares,01-LEC Dynamic,Staff,30,0,30,0,0
3843,North Campus,RLFI  110 - 01   Pattern Making 2,01-LEC Dynamic,Staff,16,0,16,0,0
3844,North Campus,RLFI  110 - 02   Pattern Making 2,02-LEC Dynamic,Staff,16,0,16,0,0
2804,Kendall Campus,RLHL  110 - 01   Meditation Techniques and Breath Work,01-LEC Dynamic,Staff,15,0,15,0,0
2708,Kendall Campus,RLPD  110 - 01   Painting with Oils/Acrylics,01-LEC Dynamic,Staff,14,0,14,0,0
2710,Kendall Campus,RLPD  110 - 02   Painting with Oils/Acrylics,02-LEC Dynamic,Staff,14,0,14,0,0
2711,Kendall Campus,RLPD  110 - 03   Painting with Oils/Acrylics,03-LEC Dynamic,Staff,10,0,10,0,0
2713,Kendall Campus,RLPD  110 - 04   Painting with Oils/Acrylics,04-LEC Dynamic,Staff,10,0,10,0,0
1733,Kendall Campus,RLPF  110 - 01   Parent Education & Family Stabilization Course (CODP - Legal Aid),01-LEC Dynamic,Staff,5,0,5,0,0
1735,Kendall Campus,RLPF  110 - 02   Parent Education & Family Stabilization Course (CODP - Legal Aid),02-LEC Dynamic,Staff,5,0,5,0,0
1737,Kendall Campus,RLPF  110 - 03   Parent Education & Family Stabilization Course (CODP - Legal Aid),03-LEC Dynamic,Staff,5,0,5,0,0
1738,Kendall Campus,RLPF  110 - 04   Parent Education & Family Stabilization Course (CODP - Legal Aid),04-LEC Dynamic,Staff,5,0,5,0,0
1739,Kendall Campus,RLPF  110 - 05   Parent Education & Family Stabilization Course (CODP - Legal Aid),05-LEC Dynamic,Staff,5,0,5,0,0
1740,Kendall Campus,RLPF  110 - 06   Parent Education & Family Stabilization Course (CODP - Legal Aid),06-LEC Dynamic,Staff,5,0,5,0,0
1665,Wolfson Campus,RLWA  110 - 01   Writing Lab/Tutoring,01-LEC Dynamic,Staff,16,0,16,0,0
2182,Wolfson Campus,RLWA  110 - 02   Writing Lab/Tutoring,02-LEC Dynamic,Staff,30,0,30,0,0
1511,InterAmerican Campus,RSPE  110 - 01   FTCE: Subject Area Exam: Elementary Education (K-6),01-LEC Dynamic,Staff,16,0,16,0,0
2913,Kendall Campus,RSPE  110 - 02   FTCE: Subject Area Exam: Elementary Education (K-6),02-LEC Dynamic,Staff,20,0,20,0,0
2952,Hialeah Campus,WBAB  110 - 01   Certified Bookkeeper Test Preparation: Adjustments and Error Correction,01-LEC Dynamic,Staff,30,0,30,0,0
3110,North Campus,WBAC  110 - 01   Certified Pool/Spa Operator,01-LEC Dynamic,Staff,16,0,16,0,0
3112,North Campus,WBAC  110 - 02   Certified Pool/Spa Operator,02-LEC Dynamic,Staff,16,0,16,0,0
3113,North Campus,WBAC  110 - 03   Certified Pool/Spa Operator,03-LEC Dynamic,Staff,16,0,16,0,0
3533,Wolfson Campus,WBCI  110 - 01   Certificate in Construction Management,01-LEC Dynamic,Staff,31,0,31,0,0
3047,Hialeah Campus,WBEB  110 - 01   Simple Steps to Start Your Business - Marketing Plan,01-LEC Dynamic,Staff,30,0,30,0,0
2596,West Campus,WBEP  110 - 01   Armed Services Vocational Aptitude Battery (ASVAB),01-LEC Dynamic,Staff,16,0,16,0,0
2597,West Campus,WBEP  110 - 02   Armed Services Vocational Aptitude Battery (ASVAB),02-LEC Dynamic,Staff,16,0,16,0,0
3548,Wolfson Campus,WBFI  110 - 01   Investing: Stock Market Series (Option Emphasis),01-LEC Dynamic,Staff,25,0,25,0,0
2314,Kendall Campus,WBIE  110 - 01   Exportación: Proceso y Documentación,01-LEC Dynamic,Staff,25,0,25,0,0
3240,North Campus,WBIE  110 - 02   Exportación: Proceso y Documentación,02-LEC Dynamic,Staff,16,0,16,0,0
1248,Wolfson Campus,WBMS  110 - 01   Time and Priority Management,01-LEC Dynamic,Staff,25,0,25,0,0
1161,Wolfson Campus,WBPD  110 - 01   Speak with Confidence,01-LEC Dynamic,Staff,25,0,25,0,0
2082,InterAmerican Campus,WBTP  110 - 01   Curso Intensivo de Preparación de Impuestos - Corporativo,01-LEC Dynamic,Staff,25,0,25,0,0
2472,West Campus,WBTP  110 - 02   Curso Intensivo de Preparación de Impuestos - Corporativo,02-LEC Dynamic,Staff,20,0,20,0,0
1527,InterAmerican Campus,WCIS  110 - 01   Conociendo el ADD· el ADHD y el Autismo,01-LEC Dynamic,Staff,30,0,30,0,0
1066,Homestead Campus,WCTR  110 - 01   5 Horas de Prácticas Apropiadas para Infantes y Párvulos,01-LEC Dynamic,Staff,25,0,25,0,0
1067,Homestead Campus,WCTR  110 - 02   5 Horas de Prácticas Apropiadas para Infantes y Párvulos,02-LEC Dynamic,Staff,25,0,25,0,0
1543,Kendall Campus,WCTR  110 - 05   5 Horas de Prácticas Apropiadas para Infantes y Párvulos,05-LEC Dynamic,Staff,25,0,25,0,0
1544,Kendall Campus,WCTR  110 - 06   5 Horas de Prácticas Apropiadas para Infantes y Párvulos,06-LEC Dynamic,Staff,25,0,25,0,0
1545,Kendall Campus,WCTR  110 - 07   5 Horas de Prácticas Apropiadas para Infantes y Párvulos,07-LEC Dynamic,Staff,25,0,25,0,0
1595,InterAmerican Campus,WCTR  110 - 08   5 Horas de Prácticas Apropiadas para Infantes y Párvulos,08-LEC Dynamic,Staff,25,0,25,0,0
1596,InterAmerican Campus,WCTR  110 - 09   5 Horas de Prácticas Apropiadas para Infantes y Párvulos,09-LEC Dynamic,Staff,25,0,25,0,0
1597,InterAmerican Campus,WCTR  110 - 10   5 Horas de Prácticas Apropiadas para Infantes y Párvulos,10-LEC Dynamic,Staff,25,0,25,0,0
2577,Hialeah Campus,WCTR  110 - 11   5 Horas de Prácticas Apropiadas para Infantes y Párvulos,11-LEC Dynamic,Staff,30,0,30,0,0
2578,Hialeah Campus,WCTR  110 - 12   5 Horas de Prácticas Apropiadas para Infantes y Párvulos,12-LEC Dynamic,Staff,30,0,30,0,0
2613,West Campus,WCTR  110 - 13   5 Horas de Prácticas Apropiadas para Infantes y Párvulos,13-LEC Dynamic,Staff,16,0,16,0,0
2614,West Campus,WCTR  110 - 14   5 Horas de Prácticas Apropiadas para Infantes y Párvulos,14-LEC Dynamic,Staff,16,0,16,0,0
2812,North Campus,WHCE  110 - 01   HIPAA Compliance,01-LEC Dynamic,Staff,16,0,16,0,0
3366,Medical Campus,WHEP  110 - 01   HESI A2 Exam Review: English,01-LEC Dynamic,Staff,25,0,25,0,0
3404,Medical Campus,WHNC  110 - 01   LPN Intravenous Therapy Course,01-LEC Dynamic,Staff,20,0,20,0,0
3405,Medical Campus,WHNC  110 - 02   LPN Intravenous Therapy Course,02-LEC Dynamic,Staff,20,0,20,0,0
1453,Wolfson Campus,WLEP  110 - 01   English Conversation 2A,01-LEC Dynamic,Staff,25,0,25,0,0
1988,Wolfson Campus,WLEP  110 - 02   English Conversation 2A,02-LEC Dynamic,Staff,30,0,30,0,0
2146,InterAmerican Campus,WTCA  110 - 01   AutoCAD Certification Exam,01-LEC Dynamic,Staff,16,0,16,0,0
1551,Kendall Campus,WTDM  110 - 01   Adobe Illustrator CC Level 1,01-LEC Dynamic,Staff,15,0,15,0,0
1552,Kendall Campus,WTDM  110 - 02   Adobe Illustrator CC Level 1,02-LEC Dynamic,Staff,15,0,15,0,0
1689,Wolfson Campus,WTDM  110 - 03   Adobe Illustrator CC Level 1,03-LEC Dynamic,Staff,20,0,20,0,0
2532,West Campus,WTDM  110 - 04   Adobe Illustrator CC Level 1,04-LEC Dynamic,Staff,35,0,35,0,0
3321,Hialeah Campus,WTWD  110 - 01   Adobe InDesign· Illustrator y Photoshop: Curso Básico Integrado,01-LEC Dynamic,Staff,16,0,16,0,0
3488,Kendall Campus,RLAM  109 - 01   Professional Make-up Artist (16 Hours),01-LEC Dynamic,Staff,12,0,12,0,0
1518,InterAmerican Campus,RLCP  109 - 01   GED en español – Nivel Básico,01-LEC Dynamic,Staff,35,0,35,0,0
1519,InterAmerican Campus,RLCP  109 - 02   GED en español – Nivel Básico,02-LEC Dynamic,Staff,35,0,35,0,0
2726,Kendall Campus,RLCP  109 - 03   GED en español – Nivel Básico,03-LEC Dynamic,Staff,20,0,20,0,0
2889,Kendall Campus,RLDA  109 - 01   Specialty Class: Modern Flair Belly Dance Technique,01-LEC Dynamic,Staff,40,0,40,0,0
2891,Kendall Campus,RLDA  109 - 02   Specialty Class: Modern Flair Belly Dance Technique,02-LEC Dynamic,Staff,40,0,40,0,0
2697,Kendall Campus,RLFA  109 - 01   FSA - 10th Grade Reading Review,01-LEC Dynamic,Staff,20,0,20,0,0
2056,Hialeah Campus,RLFD  109 - 01   Arreglos Florales,01-LEC Dynamic,Staff,30,0,30,0,0
2081,InterAmerican Campus,RLFD  109 - 02   Arreglos Florales,02-LEC Dynamic,Staff,30,0,30,0,0
3127,Hialeah Campus,RLFI  109 - 01   Pattern Making 1,01-LEC Dynamic,Staff,30,0,30,0,0
3841,North Campus,RLFI  109 - 02   Pattern Making 1,02-LEC Dynamic,Staff,16,0,16,0,0
3842,North Campus,RLFI  109 - 03   Pattern Making 1,03-LEC Dynamic,Staff,16,0,16,0,0
3271,Kendall Campus,RLFS  109 - 01   Boot Camp Training - Beginners/Intermediate,01-LEC Dynamic,Staff,16,0,16,0,0
3272,Kendall Campus,RLFS  109 - 02   Boot Camp Training - Beginners/Intermediate,02-LEC Dynamic,Staff,16,0,16,0,0
2856,Kendall Campus,RLGE  109 - 03   GRE Verbal Review,03-LEC Dynamic,Staff,20,0,20,0,0
2860,Kendall Campus,RLGE  109 - 04   GRE Verbal Review,04-LEC Dynamic,Staff,20,0,20,0,0
2739,Kendall Campus,RLLS  109 - 01   Unlock Your Potential Maximize Your Talent,01-LEC Dynamic,Staff,25,0,25,0,0
1865,Kendall Campus,RLPF  109 - 01   CODP: KIDS 8-10 LEGAL AID,01-LEC Dynamic,Staff,0,0,0,0,0
1866,Kendall Campus,RLPF  109 - 02   CODP: KIDS 8-10 LEGAL AID,02-LEC Dynamic,Staff,0,0,0,0,0
1867,Kendall Campus,RLPF  109 - 03   CODP: KIDS 8-10 LEGAL AID,03-LEC Dynamic,Staff,0,0,0,0,0
1870,Kendall Campus,RLPF  109 - 04   CODP: KIDS 8-10 LEGAL AID,04-LEC Dynamic,Staff,0,0,0,0,0
1872,Kendall Campus,RLPF  109 - 05   CODP: KIDS 8-10 LEGAL AID,05-LEC Dynamic,Staff,0,0,0,0,0
1873,Kendall Campus,RLPF  109 - 06   CODP: KIDS 8-10 LEGAL AID,06-LEC Dynamic,Staff,0,0,0,0,0
1908,Kendall Campus,RLSC  109 - 01   55+ Navigating Your Computer w/Windows 8,01-LEC Dynamic,Staff,15,0,15,0,0
1911,Kendall Campus,RLSC  109 - 02   55+ Navigating Your Computer w/Windows 8,02-LEC Dynamic,Staff,15,0,15,0,0
2043,Wolfson Campus,RLSC  109 - 03   55+ Navigating Your Computer w/Windows 8,03-LEC Dynamic,Staff,20,0,20,0,0
2048,Wolfson Campus,RLSC  109 - 04   55+ Navigating Your Computer w/Windows 8,04-LEC Dynamic,Staff,20,0,20,0,0
3311,Kendall Campus,RLSC  109 - 05   55+ Navigating Your Computer w/Windows 8,05-LEC Dynamic,Staff,16,0,16,0,0
3455,Kendall Campus,RLSC  109 - 06   55+ Navigating Your Computer w/Windows 8,06-LEC Dynamic,Staff,16,0,16,0,0
1648,InterAmerican Campus,RLSP  109 - 01   Sewing 2,01-LEC Dynamic,Staff,15,0,15,0,0
1649,InterAmerican Campus,RLSP  109 - 02   Sewing 2,02-LEC Dynamic,Staff,15,0,15,0,0
1703,Wolfson Campus,RLWA  109 - 01   Short Film Writing Boot Camp,01-LEC Dynamic,Staff,20,0,20,0,0
1507,InterAmerican Campus,RSPE  109 - 01   FTCE: Professional Education Test Prep - Ped,01-LEC Dynamic,Staff,25,0,25,0,0
2599,West Campus,RSPE  109 - 02   FTCE: Professional Education Test Prep - Ped,02-LEC Dynamic,Staff,23,0,23,0,0
2749,Hialeah Campus,RSPE  109 - 03   FTCE: Professional Education Test Prep - Ped,03-LEC Dynamic,Staff,30,0,30,0,0
2910,Kendall Campus,RSPE  109 - 04   FTCE: Professional Education Test Prep - Ped,04-LEC Dynamic,Staff,20,0,20,0,0
2654,North Campus,WBCC  109 - 01   Tour Guide Certification,01-LEC Dynamic,Staff,16,0,16,0,0
2655,North Campus,WBCC  109 - 02   Tour Guide Certification,02-LEC Dynamic,Staff,16,0,16,0,0
2835,Wolfson Campus,WBCC  109 - 03   Tour Guide Certification,03-LEC Dynamic,Staff,25,0,25,0,0
2836,Wolfson Campus,WBCC  109 - 04   Tour Guide Certification,04-LEC Dynamic,Staff,20,0,20,0,0
3042,Hialeah Campus,WBEB  109 - 01   Simple Steps to Start Your Business - Funding Sources and Next Steps,01-LEC Dynamic,Staff,30,0,30,0,0
2313,Kendall Campus,WBIE  109 - 01   Expedidor de Carga,01-LEC Dynamic,Staff,25,0,25,0,0
3239,North Campus,WBMK  109 - 01   Marketing your Import and Export Business Effectively,01-LEC Dynamic,Staff,16,0,16,0,0
2078,Kendall Campus,WBMS  109 - 01   Time Management,01-LEC Dynamic,Staff,16,0,16,0,0
3061,Hialeah Campus,WBMS  109 - 02   Time Management,02-LEC Dynamic,Staff,30,0,30,0,0
2004,Wolfson Campus,WBPD  109 - 01   Speak Like a Professional,01-LEC Dynamic,Staff,20,0,20,0,0
1003,Homestead Campus,WBTP  109 - 01   Personal Income Tax Preparation,01-LEC Dynamic,Staff,25,0,25,0,0
1978,Kendall Campus,WBTP  109 - 02   Personal Income Tax Preparation,02-LEC Dynamic,Staff,20,0,20,0,0
2475,West Campus,WBTP  109 - 03   Personal Income Tax Preparation,03-LEC Dynamic,Staff,16,0,16,0,0
2477,West Campus,WBTP  109 - 04   Personal Income Tax Preparation,04-LEC Dynamic,Staff,20,0,20,0,0
2058,Kendall Campus,WBWA  109 - 01   Creative Writing,01-LEC Dynamic,Staff,25,0,25,0,0
1274,Homestead Campus,WHCE  109 - 01   Preventing of Medical Errors,01-LEC Dynamic,Staff,25,0,25,0,0
2822,North Campus,WHCE  109 - 02   Preventing of Medical Errors,02-LEC Dynamic,Staff,16,0,16,0,0
2825,North Campus,WHCE  109 - 03   Preventing of Medical Errors,03-LEC Dynamic,Staff,16,0,16,0,0
2826,North Campus,WHCE  109 - 04   Preventing of Medical Errors,04-LEC Dynamic,Staff,16,0,16,0,0
3086,Kendall Campus,WHCE  109 - 05   Preventing of Medical Errors,05-LEC Dynamic,Staff,16,0,16,0,0
3312,Medical Campus,WHCE  109 - 06   Preventing of Medical Errors,06-LEC Dynamic,Staff,25,0,25,0,0
3816,Kendall Campus,WHCO  109 - 01   Workplace Professionalism in Health Related Careers,01-LEC Dynamic,Staff,30,0,30,0,0
3403,Medical Campus,WHNC  109 - 01   Health Unit Coordinator,01-LEC Dynamic,Staff,16,0,16,0,0
1452,Wolfson Campus,WLEP  109 - 01   English Conversation 1B,01-LEC Dynamic,Staff,16,0,16,0,0
1987,Wolfson Campus,WLEP  109 - 02   English Conversation 1B,02-LEC Dynamic,Staff,30,0,30,0,0
1521,Wolfson Campus,WTCP  109 - 01   Create ANDROID Applications - Level 1,01-LEC Dynamic,Staff,20,0,20,0,0
2972,Hialeah Campus,WTMO  109 - 01   Microsoft Word Básico,01-LEC Dynamic,Staff,16,0,16,0,0
2973,Hialeah Campus,WTMO  109 - 02   Microsoft Word Básico,02-LEC Dynamic,Staff,16,0,16,0,0
1871,Kendall Campus,WTWD  109 - 01   Adobe Flash CC Level 2,01-LEC Dynamic,Staff,15,0,15,0,0
2334,Kendall Campus,RLAC  108 - 01   Introduction to Synchronized Swimming (ages 5-10) (15 Hours),01-LAB Dynamic,Staff,20,0,20,0,0
2335,Kendall Campus,RLAC  108 - 02   Introduction to Synchronized Swimming (ages 5-10) (15 Hours),02-LAB Dynamic,Staff,20,0,20,0,0
2336,Kendall Campus,RLAC  108 - 03   Introduction to Synchronized Swimming (ages 5-10) (15 Hours),03-LAB Dynamic,Staff,20,0,20,0,0
1625,InterAmerican Campus,RLAM  108 - 01   Accesorios de Moda,01-LEC Dynamic,Staff,20,0,20,0,0
2729,Kendall Campus,RLCP  108 - 01   GED en español – Nivel Avanzado,01-LEC Dynamic,Staff,20,0,20,0,0
2868,Kendall Campus,RLDA  108 - 01   Belly Dance Level 3 - Advanced Combinations· Props and Choreography,01-LEC Dynamic,Staff,40,0,40,0,0
2882,Kendall Campus,RLDA  108 - 02   Belly Dance Level 3 - Advanced Combinations· Props and Choreography,02-LEC Dynamic,Staff,40,0,40,0,0
2686,Kendall Campus,RLFA  108 - 01   FSA - 10th Grade Math Review (12 Hours),01-LEC Dynamic,Staff,20,0,20,0,0
3117,Hialeah Campus,RLFD  108 - 01   Arreglos Florales para Bodas,01-LEC Dynamic,Staff,30,0,30,0,0
1355,Wolfson Campus,RLGE  108 - 01   GRE Math Review,01-LEC Dynamic,Staff,25,0,25,0,0
1356,Wolfson Campus,RLGE  108 - 02   GRE Math Review,02-LEC Dynamic,Staff,25,0,25,0,0
2451,Hialeah Campus,RLGE  108 - 03   GRE Math Review,03-LEC Dynamic,Staff,30,0,30,0,0
2700,Kendall Campus,RLHL  108 - 01   Meditation for Children (Ages 7-10),01-LEC Dynamic,Staff,20,0,20,0,0
2824,Kendall Campus,RLID  108 - 01   Interior Decorating Level 2,01-LEC Dynamic,Staff,15,0,15,0,0
2735,Kendall Campus,RLLS  108 - 01   Emotions and Their Impact on Health,01-LEC Dynamic,Staff,25,0,25,0,0
1848,Kendall Campus,RLPF  108 - 01   CODP: KIDS 6-7 LEGAL AID,01-LEC Dynamic,Staff,0,0,0,0,0
1850,Kendall Campus,RLPF  108 - 02   CODP: KIDS 6-7 LEGAL AID,02-LEC Dynamic,Staff,0,0,0,0,0
1851,Kendall Campus,RLPF  108 - 03   CODP: KIDS 6-7 LEGAL AID,03-LEC Dynamic,Staff,0,0,0,0,0
1852,Kendall Campus,RLPF  108 - 04   CODP: KIDS 6-7 LEGAL AID,04-LEC Dynamic,Staff,0,0,0,0,0
1853,Kendall Campus,RLPF  108 - 06   CODP: KIDS 6-7 LEGAL AID,06-LEC Dynamic,Staff,0,0,0,0,0
1855,Kendall Campus,RLPF  108 - 07   CODP: KIDS 6-7 LEGAL AID,07-LEC Dynamic,Staff,0,0,0,0,0
1260,Homestead Campus,RLPH  108 - 01   Intermediate Digital Photography,01-LEC Dynamic,Staff,25,0,25,0,0
1377,Wolfson Campus,RLPH  108 - 02   Intermediate Digital Photography,02-LEC Dynamic,Staff,20,0,20,0,0
1378,Wolfson Campus,RLPH  108 - 03   Intermediate Digital Photography,03-LEC Dynamic,Staff,20,0,20,0,0
1629,InterAmerican Campus,RLPH  108 - 04   Intermediate Digital Photography,04-LEC Dynamic,Staff,16,0,16,0,0
2629,West Campus,RLPH  108 - 05   Intermediate Digital Photography,05-LEC Dynamic,Staff,16,0,16,0,0
3545,Kendall Campus,RLPH  108 - 06   Intermediate Digital Photography,06-LEC Dynamic,Staff,16,0,16,0,0
1503,InterAmerican Campus,RSPE  108 - 01   FTCE: General Knowledge Math Skills,01-LEC Dynamic,Staff,25,0,25,0,0
2908,Kendall Campus,RSPE  108 - 02   FTCE: General Knowledge Math Skills,02-LEC Dynamic,Staff,20,0,20,0,0
3442,Kendall Campus,RSPE  108 - 03   FTCE: General Knowledge Math Skills,03-LEC Dynamic,Staff,16,0,16,0,0
1376,InterAmerican Campus,WBAB  108 - 01   Teneduría de Libros 2 (Bookkeeping 2),01-LEC Dynamic,Staff,25,0,25,0,0
1390,InterAmerican Campus,WBAB  108 - 02   Teneduría de Libros 2 (Bookkeeping 2),02-LEC Dynamic,Staff,25,0,25,0,0
2052,Kendall Campus,WBAB  108 - 03   Teneduría de Libros 2 (Bookkeeping 2),03-LEC Dynamic,Staff,16,0,16,0,0
2504,West Campus,WBAB  108 - 04   Teneduría de Libros 2 (Bookkeeping 2),04-LEC Dynamic,Staff,20,0,20,0,0
3171,Hialeah Campus,WBCC  108 - 01   Certificación en Organización de Bodas y Eventos,01-LEC Dynamic,Staff,30,0,30,0,0
3052,Hialeah Campus,WBEB  108 - 01   Simple Steps to Start Your Business - Financial,01-LEC Dynamic,Staff,30,0,30,0,0
2306,Kendall Campus,WBIE  108 - 01   Export: Creating a Management and Compliance Program,01-LEC Dynamic,Staff,25,0,25,0,0
2283,Wolfson Campus,WBMK  108 - 01   Marketing your Business,01-LEC Dynamic,Staff,30,0,30,0,0
1393,InterAmerican Campus,WBPD  108 - 01   Signing Agent (en Español),01-LEC Dynamic,Staff,20,0,20,0,0
1395,InterAmerican Campus,WBPD  108 - 02   Signing Agent (en Español),02-LEC Dynamic,Staff,20,0,20,0,0
1269,Wolfson Campus,WBRE  108 - 01   Buying Foreclosures and Short Sales,01-LEC Dynamic,Staff,20,0,20,0,0
3555,North Campus,WBRE  108 - 02   Buying Foreclosures and Short Sales,02-LEC Dynamic,Staff,16,0,16,0,0
3556,North Campus,WBRE  108 - 03   Buying Foreclosures and Short Sales,03-LEC Dynamic,Staff,16,0,16,0,0
1004,Homestead Campus,WBTP  108 - 01   Preparación de Impuestos,01-LEC Dynamic,Staff,25,0,25,0,0
2053,Kendall Campus,WBTP  108 - 02   Preparación de Impuestos,02-LEC Dynamic,Staff,16,0,16,0,0
2479,West Campus,WBTP  108 - 03   Preparación de Impuestos,03-LEC Dynamic,Staff,20,0,20,0,0
1051,Homestead Campus,WCIS  108 - 01   Computer Technology for Early Childhood Professionals - Beginning,01-LEC Dynamic,Staff,25,0,25,0,0
1279,Kendall Campus,WCTR  108 - 04   5 Hours Preschool Appropriate Practices,04-LEC Dynamic,Staff,25,0,25,0,0
1502,Kendall Campus,WCTR  108 - 05   5 Hours Preschool Appropriate Practices,05-LEC Dynamic,Staff,25,0,25,0,0
2892,North Campus,WCTR  108 - 06   5 Hours Preschool Appropriate Practices,06-LEC Dynamic,Staff,21,0,21,8,0
2902,North Campus,WCTR  108 - 07   5 Hours Preschool Appropriate Practices,07-LEC Dynamic,Staff,21,0,21,8,0
2905,North Campus,WCTR  108 - 08   5 Hours Preschool Appropriate Practices,08-LEC Dynamic,Staff,21,0,21,8,0
2907,North Campus,WCTR  108 - 09   5 Hours Preschool Appropriate Practices,09-LEC Dynamic,Staff,21,0,21,8,0
2895,North Campus,WCTR  108 - 10   5 Hours Preschool Appropriate Practices,10-LEC Dynamic,Staff,21,0,21,8,0
3611,Kendall Campus,WCTR  108 - 11   5 Hours Preschool Appropriate Practices,11-LEC Dynamic,Staff,25,0,25,0,0
3612,Kendall Campus,WCTR  108 - 12   5 Hours Preschool Appropriate Practices,12-LEC Dynamic,Staff,18,0,18,0,0
3613,Kendall Campus,WCTR  108 - 13   5 Hours Preschool Appropriate Practices,13-LEC Dynamic,Staff,16,0,16,0,0
3625,Kendall Campus,WCTR  108 - 14   5 Hours Preschool Appropriate Practices,14-LEC Dynamic,Staff,25,0,25,0,0
1273,Homestead Campus,WHCE  108 - 01   Occupational Exposure to Blood Pathogens (OSHA),01-LEC Dynamic,Staff,25,0,25,0,0
2820,North Campus,WHCE  108 - 02   Occupational Exposure to Blood Pathogens (OSHA),02-LEC Dynamic,Staff,16,0,16,0,0
2821,North Campus,WHCE  108 - 03   Occupational Exposure to Blood Pathogens (OSHA),03-LEC Dynamic,Staff,16,0,16,0,0
3084,Kendall Campus,WHCE  108 - 04   Occupational Exposure to Blood Pathogens (OSHA),04-LEC Dynamic,Staff,16,0,16,0,0
3306,Medical Campus,WHCE  108 - 05   Occupational Exposure to Blood Pathogens (OSHA),05-LEC Dynamic,Staff,25,0,25,0,0
3309,Medical Campus,WHCE  108 - 06   Occupational Exposure to Blood Pathogens (OSHA),06-LEC Dynamic,Staff,25,0,25,0,0
3264,Wolfson Campus,WHCO  108 - 01   Health Communities Of Interest Orientation,01-LEC Dynamic,Staff,30,0,30,0,0
3265,Wolfson Campus,WHCO  108 - 02   Health Communities Of Interest Orientation,02-LEC Dynamic,Staff,30,0,30,0,0
3266,Wolfson Campus,WHCO  108 - 03   Health Communities Of Interest Orientation,03-LEC Dynamic,Staff,30,0,30,0,0
3817,Kendall Campus,WHCO  108 - 04   Health Communities Of Interest Orientation,04-LEC Dynamic,Staff,30,0,30,0,0
3818,Kendall Campus,WHCO  108 - 05   Health Communities Of Interest Orientation,05-LEC Dynamic,Staff,30,0,30,0,0
3819,Kendall Campus,WHCO  108 - 06   Health Communities Of Interest Orientation,06-LEC Dynamic,Staff,30,0,30,0,0
3821,Medical Campus,WHCO  108 - 07   Health Communities Of Interest Orientation,07-LEC Dynamic,Staff,30,0,30,0,0
3822,Medical Campus,WHCO  108 - 08   Health Communities Of Interest Orientation,08-LEC Dynamic,Staff,30,0,30,0,0
3823,Medical Campus,WHCO  108 - 09   Health Communities Of Interest Orientation,09-LEC Dynamic,Staff,30,0,30,0,0
3825,Medical Campus,WHCO  108 - 10   Health Communities Of Interest Orientation,10-LEC Dynamic,Staff,30,0,30,0,0
3827,Medical Campus,WHCO  108 - 11   Health Communities Of Interest Orientation,11-LEC Dynamic,Staff,30,0,30,0,0
3828,Medical Campus,WHCO  108 - 12   Health Communities Of Interest Orientation,12-LEC Dynamic,Staff,30,0,30,0,0
3032,Kendall Campus,WINS  108 - 01   2-15 Life· Health and Variable Annuity Cram Review,01-LEC Dynamic,Staff,16,0,16,0,0
1450,Wolfson Campus,WLEP  108 - 01   English Conversation 1A,01-LEC Dynamic,Staff,16,0,16,0,0
1986,Wolfson Campus,WLEP  108 - 02   English Conversation 1A,02-LEC Dynamic,Staff,30,0,30,0,0
2989,Hialeah Campus,WLFL  108 - 01   Chinese Language for Business (15 Hours),01-LEC Dynamic,Staff,30,0,30,0,0
2320,North Campus,WTCT  108 - 01   CompTIA A+ Practical Application (220-802),01-LEC Dynamic,Staff,30,0,30,0,0
2542,West Campus,WTCT  108 - 02   CompTIA A+ Practical Application (220-802),02-LEC Dynamic,Staff,35,0,35,0,0
3489,Kendall Campus,WTCT  108 - 03   CompTIA A+ Practical Application (220-802),03-LEC Dynamic,Staff,16,0,16,0,0
3664,North Campus,WTCT  108 - 04   CompTIA A+ Practical Application (220-802),04-LEC Dynamic,Staff,16,0,16,0,0
1682,Wolfson Campus,WTMO  108 - 01   Microsoft Word 2013  Básico,01-LEC Dynamic,Staff,25,0,25,0,0
3676,North Campus,WTMO  108 - 02   Microsoft Word 2013  Básico,02-LEC Dynamic,Staff,16,0,16,0,0
1584,Kendall Campus,WTWD  108 - 01   Adobe Flash CC Level 1,01-LEC Dynamic,Staff,15,0,15,0,0
2339,Kendall Campus,RLAC  107 - 01   Introduction to Synchronized Swimming (ages 11-17),01-LEC Dynamic,Staff,8,0,8,0,0
2340,Kendall Campus,RLAC  107 - 02   Introduction to Synchronized Swimming (ages 11-17),02-LEC Dynamic,Staff,8,0,8,0,0
2341,Kendall Campus,RLAC  107 - 03   Introduction to Synchronized Swimming (ages 11-17),03-LEC Dynamic,Staff,8,0,8,0,0
1626,InterAmerican Campus,RLAM  107 - 01   Tecnicas de Maquillaje,01-LEC Dynamic,Staff,20,0,20,0,0
1729,Wolfson Campus,RLCP  107 - 01   Serie de GED en Español - Niveles 1 y 2,01-LEC Dynamic,Staff,35,0,35,0,0
1731,Wolfson Campus,RLCP  107 - 02   Serie de GED en Español - Niveles 1 y 2,02-LEC Dynamic,Staff,35,0,35,0,0
2861,Kendall Campus,RLDA  107 - 01   Belly Dance Level 2 - Travel with Movements,01-LEC Dynamic,Staff,40,0,40,0,0
2863,Kendall Campus,RLDA  107 - 02   Belly Dance Level 2 - Travel with Movements,02-LEC Dynamic,Staff,40,0,40,0,0
2424,North Campus,RLEC  107 - 01   Home Landscape Design,01-LEC Dynamic,Staff,15,0,15,5,0
2693,Kendall Campus,RLFA  107 - 01   FSA – 5th Grade Reading Review,01-LEC Dynamic,Staff,20,0,20,0,0
3789,Kendall Campus,RLFL  107 - 01   Mandarin Chinese (For Children),01-LEC Dynamic,Staff,15,0,15,0,0
2403,North Campus,RLGE  107 - 01   GRE Intensive Test Review,01-LEC Dynamic,Staff,16,0,16,5,0
2404,North Campus,RLGE  107 - 02   GRE Intensive Test Review,02-LEC Dynamic,Staff,16,0,16,5,0
1369,Wolfson Campus,RLID  107 - 01   Interior Decorating Level 1,01-LEC Dynamic,Staff,25,0,25,0,0
2823,Kendall Campus,RLID  107 - 02   Interior Decorating Level 1,02-LEC Dynamic,Staff,15,0,15,0,0
2730,Kendall Campus,RLLS  107 - 01   Discover India: Ancient and Modern,01-LEC Dynamic,Staff,25,0,25,0,0
3448,Wolfson Campus,RLMP  107 - 01   Piano II Adult Group,01-LEC Dynamic,Staff,30,0,30,0,0
2037,Kendall Campus,RLPF  107 - 01   CODP: KIDS 14-17 LEGAL AID,01-LEC Dynamic,Staff,0,0,0,0,0
2038,Kendall Campus,RLPF  107 - 02   CODP: KIDS 14-17 LEGAL AID,02-LEC Dynamic,Staff,0,0,0,0,0
2040,Kendall Campus,RLPF  107 - 03   CODP: KIDS 14-17 LEGAL AID,03-LEC Dynamic,Staff,0,0,0,0,0
2042,Kendall Campus,RLPF  107 - 04   CODP: KIDS 14-17 LEGAL AID,04-LEC Dynamic,Staff,0,0,0,0,0
2044,Kendall Campus,RLPF  107 - 05   CODP: KIDS 14-17 LEGAL AID,05-LEC Dynamic,Staff,0,0,0,0,0
2046,Kendall Campus,RLPF  107 - 06   CODP: KIDS 14-17 LEGAL AID,06-LEC Dynamic,Staff,0,0,0,0,0
1259,Homestead Campus,RLPH  107 - 01   Beginning Digital Photography,01-LEC Dynamic,Staff,25,0,25,0,0
1372,Wolfson Campus,RLPH  107 - 02   Beginning Digital Photography,02-LEC Dynamic,Staff,20,0,20,0,0
1373,Wolfson Campus,RLPH  107 - 03   Beginning Digital Photography,03-LEC Dynamic,Staff,20,0,20,0,0
1628,InterAmerican Campus,RLPH  107 - 04   Beginning Digital Photography,04-LEC Dynamic,Staff,16,0,16,0,0
2630,West Campus,RLPH  107 - 05   Beginning Digital Photography,05-LEC Dynamic,Staff,16,0,16,0,0
3315,North Campus,RLPH  107 - 07   Beginning Digital Photography,07-LEC Dynamic,Staff,16,0,16,8,0
3534,Kendall Campus,RLPH  107 - 08   Beginning Digital Photography,08-LEC Dynamic,Staff,20,0,20,0,0
3535,Kendall Campus,RLPH  107 - 09   Beginning Digital Photography,09-LEC Dynamic,Staff,16,0,16,0,0
3317,North Campus,RLPH  107 - 11   Beginning Digital Photography,11-LEC Dynamic,Staff,16,0,16,8,0
2721,Kendall Campus,RLSP  107 - 01   Learn to Sew,01-LEC Dynamic,Staff,15,0,15,0,0
2723,Kendall Campus,RLSP  107 - 02   Learn to Sew,02-LEC Dynamic,Staff,15,0,15,0,0
3214,Kendall Campus,RLSP  107 - 03   Learn to Sew,03-LEC Dynamic,Staff,15,0,15,0,0
2900,Kendall Campus,RSPE  107 - 01   FTCE: General Knowledge - Grammar Skills,01-LEC Dynamic,Staff,20,0,20,0,0
1139,Wolfson Campus,WBAB  107 - 01   Bookkeeping - Level 2,01-LEC Dynamic,Staff,20,0,20,0,0
2039,Kendall Campus,WBAB  107 - 02   Bookkeeping - Level 2,02-LEC Dynamic,Staff,16,0,16,0,0
2486,West Campus,WBAB  107 - 03   Bookkeeping - Level 2,03-LEC Dynamic,Staff,16,0,16,0,0
2489,North Campus,WBAB  107 - 04   Bookkeeping - Level 2,04-LEC Dynamic,Staff,16,0,16,0,0
2491,North Campus,WBAB  107 - 05   Bookkeeping - Level 2,05-LEC Dynamic,Staff,16,0,16,0,0
3436,Wolfson Campus,WBCC  107 - 01   Certificate in Business and Marketing,01-LEC Dynamic,Staff,30,0,30,0,0
2013,Wolfson Campus,WBCI  107 - 01   Best Practices in Construction Management,01-LEC Dynamic,Staff,30,0,30,0,0
3041,Hialeah Campus,WBEB  107 - 01   Simple Steps to Start Your Business - Business Concept,01-LEC Dynamic,Staff,30,0,30,0,0
1009,Homestead Campus,WBFI  107 - 01   Introducción al Mercado de Valores,01-LEC Dynamic,Staff,25,0,25,0,0
2672,Kendall Campus,WBFI  107 - 02   Introducción al Mercado de Valores,02-LEC Dynamic,Staff,20,0,20,0,0
1961,InterAmerican Campus,WBIE  107 - 01   Exportación: Normas de Manejo,01-LEC Dynamic,Staff,20,0,20,0,0
2316,Kendall Campus,WBIE  107 - 02   Exportación: Normas de Manejo,02-LEC Dynamic,Staff,25,0,25,0,0
1002,Homestead Campus,WBMK  107 - 01   Marketing your Products and Services,01-LEC Dynamic,Staff,25,0,25,0,0
1111,Wolfson Campus,WBMK  107 - 02   Marketing your Products and Services,02-LEC Dynamic,Staff,20,0,20,0,0
3237,North Campus,WBMK  107 - 03   Marketing your Products and Services,03-LEC Dynamic,Staff,16,0,16,0,0
3238,North Campus,WBMK  107 - 04   Marketing your Products and Services,04-LEC Dynamic,Staff,16,0,16,0,0
2002,Wolfson Campus,WBPD  107 - 01   Resume Writing/Interview Skills,01-LEC Dynamic,Staff,20,0,20,0,0
1403,InterAmerican Campus,WBTP  107 - 01   Curso Intensivo en Preparación de Impuestos – Individual y de Negocios,01-LEC Dynamic,Staff,16,0,16,0,0
1270,Homestead Campus,WHCE  107 - 01   HIV/AIDS in the Health Care Environment,01-LEC Dynamic,Staff,25,0,25,0,0
2814,North Campus,WHCE  107 - 02   HIV/AIDS in the Health Care Environment,02-LEC Dynamic,Staff,16,0,16,0,0
3079,Kendall Campus,WHCE  107 - 03   HIV/AIDS in the Health Care Environment,03-LEC Dynamic,Staff,16,0,16,0,0
3080,Kendall Campus,WHCE  107 - 04   HIV/AIDS in the Health Care Environment,04-LEC Dynamic,Staff,16,0,16,0,0
3296,Medical Campus,WHCE  107 - 05   HIV/AIDS in the Health Care Environment,05-LEC Dynamic,Staff,15,0,15,0,0
3298,Medical Campus,WHCE  107 - 06   HIV/AIDS in the Health Care Environment,06-LEC Dynamic,Staff,15,0,15,0,0
3815,Kendall Campus,WHCO  107 - 01   Legal Aspects of a Health Care Professional,01-LEC Dynamic,Staff,30,0,30,0,0
2315,Kendall Campus,WINS  107 - 01   2-15 Health and Life (including Annuities & Var) Pre-Licensing ID# 94376 - Book,01-LEC Dynamic,Staff,25,0,25,0,0
1474,Wolfson Campus,WLEP  107 - 01   Coffee and Conversation - Advanced (28 hours),01-LEC Dynamic,Staff,16,0,16,0,0
1476,Wolfson Campus,WLEP  107 - 02   Coffee and Conversation - Advanced (28 hours),02-LEC Dynamic,Staff,16,0,16,0,0
2003,Wolfson Campus,WLEP  107 - 03   Coffee and Conversation - Advanced (28 hours),03-LEC Dynamic,Staff,30,0,30,0,0
2005,Wolfson Campus,WLEP  107 - 04   Coffee and Conversation - Advanced (28 hours),04-LEC Dynamic,Staff,30,0,30,0,0
1712,Wolfson Campus,WLFL  107 - 01   Chinese Calligraphy,01-LEC Dynamic,Staff,30,0,30,0,0
2054,Kendall Campus,WLFL  107 - 02   Chinese Calligraphy,02-LEC Dynamic,Staff,25,0,25,0,0
2206,Wolfson Campus,WLFL  107 - 03   Chinese Calligraphy,03-LEC Dynamic,Staff,30,0,30,0,0
2319,North Campus,WTCT  107 - 01   CompTIA A+ Essentials (220-801),01-LEC Dynamic,Staff,30,0,30,0,0
2543,West Campus,WTCT  107 - 02   CompTIA A+ Essentials (220-801),02-LEC Dynamic,Staff,35,0,35,0,0
3480,Kendall Campus,WTCT  107 - 04   CompTIA A+ Essentials (220-801),04-LEC Dynamic,Staff,16,0,16,0,0
3663,North Campus,WTCT  107 - 05   CompTIA A+ Essentials (220-801),05-LEC Dynamic,Staff,16,0,16,0,0
2540,West Campus,WTCT  107 - 06   CompTIA A+ Essentials (220-801),06-LEC Dynamic,Staff,35,0,35,0,0
1413,InterAmerican Campus,WTDM  107 - 01   Adobe After Effects CC Level 1,01-LEC Dynamic,Staff,20,0,20,0,0
1692,Wolfson Campus,WTDM  107 - 02   Adobe After Effects CC Level 1,02-LEC Dynamic,Staff,25,0,25,0,0
1675,Wolfson Campus,WTMO  107 - 01   Microsoft Word 2013 - Basic,01-LEC Dynamic,Staff,25,0,25,0,0
3654,North Campus,WTMO  107 - 02   Microsoft Word 2013 - Basic,02-LEC Dynamic,Staff,16,0,16,0,0
3655,North Campus,WTMO  107 - 03   Microsoft Word 2013 - Basic,03-LEC Dynamic,Staff,16,0,16,0,0
1579,Kendall Campus,WTWD  107 - 01   Adobe DreamWeaver CC Level 2,01-LEC Dynamic,Staff,15,0,15,0,0
1581,Kendall Campus,WTWD  107 - 02   Adobe DreamWeaver CC Level 2,02-LEC Dynamic,Staff,15,0,15,0,0
2337,Kendall Campus,RLAC  106 - 01   Introduction to Diving (Ages 11 - 17) (9 Hours),01-LEC Dynamic,Staff,20,0,20,0,0
2338,Kendall Campus,RLAC  106 - 02   Introduction to Diving (Ages 11 - 17) (9 Hours),02-LEC Dynamic,Staff,20,0,20,0,0
3749,Kendall Campus,RLAC  106 - 03   Introduction to Diving (Ages 11 - 17) (9 Hours),03-LEC Dynamic,Staff,10,0,10,0,0
2737,Kendall Campus,RLCP  106 - 01   Serie de GED en Español - Niveles 1 y 2,01-LEC Dynamic,Staff,30,0,30,0,0
2827,Kendall Campus,RLDA  106 - 01   Ballroom Dancing Beginners,01-LEC Dynamic,Staff,40,0,40,0,0
2829,Kendall Campus,RLDA  106 - 02   Ballroom Dancing Beginners,02-LEC Dynamic,Staff,40,0,40,0,0
2692,Kendall Campus,RLFA  106 - 01   FSA – 5th Grade Math Review,01-LEC Dynamic,Staff,20,0,20,0,0
3839,North Campus,RLFI  106 - 01   Fashion Design - Level 2,01-LEC Dynamic,Staff,16,0,16,0,0
3840,North Campus,RLFI  106 - 02   Fashion Design - Level 2,02-LEC Dynamic,Staff,16,0,16,0,0
1357,Wolfson Campus,RLGE  106 - 01   GRE Review Series,01-LEC Dynamic,Staff,30,0,30,0,0
1358,Wolfson Campus,RLGE  106 - 02   GRE Review Series,02-LEC Dynamic,Staff,30,0,30,0,0
2936,Kendall Campus,RLMP  106 - 01   Piano Adult Group,01-LEC Dynamic,Staff,20,0,20,0,0
1997,Kendall Campus,RLPF  106 - 01   CODP: KIDS 11-13 LEGAL AID,01-LEC Dynamic,Staff,0,0,0,0,0
1999,Kendall Campus,RLPF  106 - 02   CODP: KIDS 11-13 LEGAL AID,02-LEC Dynamic,Staff,0,0,0,0,0
2015,Kendall Campus,RLPF  106 - 03   CODP: KIDS 11-13 LEGAL AID,03-LEC Dynamic,Staff,0,0,0,0,0
2018,Kendall Campus,RLPF  106 - 04   CODP: KIDS 11-13 LEGAL AID,04-LEC Dynamic,Staff,0,0,0,0,0
2022,Kendall Campus,RLPF  106 - 05   CODP: KIDS 11-13 LEGAL AID,05-LEC Dynamic,Staff,0,0,0,0,0
2024,Kendall Campus,RLPF  106 - 06   CODP: KIDS 11-13 LEGAL AID,06-LEC Dynamic,Staff,5,0,5,0,0
1646,InterAmerican Campus,RLSP  106 - 01   Sewing 1,01-LEC Dynamic,Staff,15,0,15,0,0
1647,InterAmerican Campus,RLSP  106 - 02   Sewing 1,02-LEC Dynamic,Staff,15,0,15,0,0
3270,Wolfson Campus,RLTH  106 - 01   Actuando para las Cámaras,01-LEC Dynamic,Staff,30,0,30,0,0
1700,Wolfson Campus,RLWA  106 - 01   Screenwriting,01-LEC Dynamic,Staff,20,0,20,0,0
1499,InterAmerican Campus,RSPE  106 - 01   FTCE: General Knowledge - Essay/Reading,01-LEC Dynamic,Staff,25,0,25,0,0
2897,Kendall Campus,RSPE  106 - 02   FTCE: General Knowledge - Essay/Reading,02-LEC Dynamic,Staff,20,0,20,0,0
1375,InterAmerican Campus,WBAB  106 - 01   Teneduría de Libros 1 (Bookkeeping 1),01-LEC Dynamic,Staff,25,0,25,0,0
1389,InterAmerican Campus,WBAB  106 - 02   Teneduría de Libros 1 (Bookkeeping 1),02-LEC Dynamic,Staff,25,0,25,0,0
2050,Kendall Campus,WBAB  106 - 03   Teneduría de Libros 1 (Bookkeeping 1),03-LEC Dynamic,Staff,16,0,16,0,0
2502,West Campus,WBAB  106 - 04   Teneduría de Libros 1 (Bookkeeping 1),04-LEC Dynamic,Staff,25,0,25,0,0
2503,West Campus,WBAB  106 - 05   Teneduría de Libros 1 (Bookkeeping 1),05-LEC Dynamic,Staff,25,0,25,0,0
2951,Hialeah Campus,WBCC  106 - 01   Certified Bookkeeper Test Preparation: Series Pricing,01-LEC Dynamic,Staff,30,0,30,0,0
3437,Wolfson Campus,WBEB  106 - 01   Effective Negotiation Techniques,01-LEC Dynamic,Staff,30,0,30,0,0
2671,Kendall Campus,WBFI  106 - 01   Introducción al Mercado de Opciones (Stocks),01-LEC Dynamic,Staff,20,0,20,0,0
2305,Kendall Campus,WBIE  106 - 01   Export: Procedures and Documentation,01-LEC Dynamic,Staff,25,0,25,0,0
2651,West Campus,WBIE  106 - 02   Export: Procedures and Documentation,02-LEC Dynamic,Staff,16,0,16,0,0
3245,North Campus,WBIE  106 - 03   Export: Procedures and Documentation,03-LEC Dynamic,Staff,16,0,16,0,0
2295,Kendall Campus,WBIN  106 - 01   Title Agent (4-10) - State ID# 3431,01-LEC Dynamic,Staff,25,0,25,0,0
2512,West Campus,WBIN  106 - 02   Title Agent (4-10) - State ID# 3431,02-LEC Dynamic,Staff,35,0,35,0,0
3560,North Campus,WBIN  106 - 03   Title Agent (4-10) - State ID# 3431,03-LEC Dynamic,Staff,16,0,16,0,0
3561,North Campus,WBIN  106 - 04   Title Agent (4-10) - State ID# 3431,04-LEC Dynamic,Staff,16,0,16,0,0
1007,Homestead Campus,WBPD  106 - 01   Resume Writing and Interview Skills,01-LEC Dynamic,Staff,25,0,25,0,0
2049,Kendall Campus,WBRE  106 - 01   Preparación para la Licencia de Bienes Raíces (Libro y Repaso Intensivo Incluido),01-LEC Dynamic,Staff,15,0,15,0,0
3549,North Campus,WBRE  106 - 02   Preparación para la Licencia de Bienes Raíces (Libro y Repaso Intensivo Incluido),02-LEC Dynamic,Staff,16,0,16,0,0
3550,North Campus,WBRE  106 - 03   Preparación para la Licencia de Bienes Raíces (Libro y Repaso Intensivo Incluido),03-LEC Dynamic,Staff,16,0,16,0,0
2963,Hialeah Campus,WBTP  106 - 01   Intensive Income Tax Preparation Program - Individual,01-LEC Dynamic,Staff,30,0,30,0,0
3434,Wolfson Campus,WBTP  106 - 02   Intensive Income Tax Preparation Program - Individual,02-LEC Dynamic,Staff,30,0,30,0,0
2170,Wolfson Campus,WBWA  106 - 01   Business Writing 2 - 21 hrs,01-LEC Dynamic,Staff,30,0,30,0,0
3796,Homestead Campus,WCIS  106 - 01   CDA National Preparation,01-LEC Dynamic,Staff,25,0,25,0,0
3596,Kendall Campus,WCTR  106 - 02   30 Horas de Cuidado Infantil en el Hogar,02-LEC Dynamic,Staff,20,0,20,0,0
1271,Homestead Campus,WHCE  106 - 01   HIV/AIDS Update,01-LEC Dynamic,Staff,25,0,25,0,0
2816,North Campus,WHCE  106 - 02   HIV/AIDS Update,02-LEC Dynamic,Staff,16,0,16,0,0
2817,North Campus,WHCE  106 - 03   HIV/AIDS Update,03-LEC Dynamic,Staff,16,0,16,0,0
2819,North Campus,WHCE  106 - 04   HIV/AIDS Update,04-LEC Dynamic,Staff,16,0,16,0,0
3081,Kendall Campus,WHCE  106 - 05   HIV/AIDS Update,05-LEC Dynamic,Staff,16,0,16,0,0
3083,Kendall Campus,WHCE  106 - 06   HIV/AIDS Update,06-LEC Dynamic,Staff,16,0,16,0,0
3301,Medical Campus,WHCE  106 - 07   HIV/AIDS Update,07-LEC Dynamic,Staff,10,0,10,0,0
3303,Medical Campus,WHCE  106 - 08   HIV/AIDS Update,08-LEC Dynamic,Staff,10,0,10,0,0
3402,Medical Campus,WHNC  106 - 01   ECG and Pharmacology,01-LEC Dynamic,Staff,15,0,15,0,0
1569,InterAmerican Campus,WHPR  106 - 01   Primeros Auxilios con RCP,01-LEC Dynamic,Staff,10,0,10,0,0
1570,InterAmerican Campus,WHPR  106 - 02   Primeros Auxilios con RCP,02-LEC Dynamic,Staff,10,0,10,0,0
2523,Hialeah Campus,WHPR  106 - 03   Primeros Auxilios con RCP,03-LEC Dynamic,Staff,16,0,16,0,0
2524,Hialeah Campus,WHPR  106 - 04   Primeros Auxilios con RCP,04-LEC Dynamic,Staff,16,0,16,0,0
2525,Hialeah Campus,WHPR  106 - 05   Primeros Auxilios con RCP,05-LEC Dynamic,Staff,16,0,16,0,0
3039,Kendall Campus,WHPR  106 - 06   Primeros Auxilios con RCP,06-LEC Dynamic,Staff,18,0,18,0,0
2311,Kendall Campus,WINS  106 - 01   2-15 Health and Life (including Annuities & Var) Pre-Licensing ID# 94376 - Book and Cram Included,01-LEC Dynamic,Staff,25,0,25,0,0
1472,Wolfson Campus,WLEP  106 - 01   Coffee and Conversation - Advanced 42 hours,01-LEC Dynamic,Staff,16,0,16,0,0
2001,Wolfson Campus,WLEP  106 - 02   Coffee and Conversation - Advanced 42 hours,02-LEC Dynamic,Staff,30,0,30,0,0
1755,Wolfson Campus,WTCA  106 - 01   3DMax - VIZ Level 1,01-LEC Dynamic,Staff,20,0,20,0,0
1493,Wolfson Campus,WTWD  106 - 01   Adobe DreamWeaver CC Level 1,01-LEC Dynamic,Staff,20,0,20,0,0
1577,Kendall Campus,WTWD  106 - 02   Adobe DreamWeaver CC Level 1,02-LEC Dynamic,Staff,15,0,15,0,0
1578,Kendall Campus,WTWD  106 - 03   Adobe DreamWeaver CC Level 1,03-LEC Dynamic,Staff,15,0,15,0,0
2342,Kendall Campus,RLAC  105 - 01   Introduction to Diving  (Ages 5 - 10 ) (6 Hours),01-LEC Dynamic,Staff,8,0,8,0,0
2343,Kendall Campus,RLAC  105 - 02   Introduction to Diving  (Ages 5 - 10 ) (6 Hours),02-LEC Dynamic,Staff,8,0,8,0,0
1122,Homestead Campus,RLCP  105 - 01   Serie de GED en Español - Niveles 1 y 2,01-LEC Dynamic,Staff,25,0,25,0,0
1525,InterAmerican Campus,RLCP  105 - 02   Serie de GED en Español - Niveles 1 y 2,02-LEC Dynamic,Staff,35,0,35,0,0
1526,InterAmerican Campus,RLCP  105 - 03   Serie de GED en Español - Niveles 1 y 2,03-LEC Dynamic,Staff,35,0,35,0,0
2464,Hialeah Campus,RLCP  105 - 04   Serie de GED en Español - Niveles 1 y 2,04-LEC Dynamic,Staff,30,0,30,0,0
2465,Hialeah Campus,RLCP  105 - 05   Serie de GED en Español - Niveles 1 y 2,05-LEC Dynamic,Staff,30,0,30,0,0
2466,Hialeah Campus,RLCP  105 - 06   Serie de GED en Español - Niveles 1 y 2,06-LEC Dynamic,Staff,30,0,30,0,0
2690,Kendall Campus,RLFA  105 - 01   FSA – 4th Grade Reading Review,01-LEC Dynamic,Staff,20,0,20,0,0
3835,North Campus,RLFI  105 - 01   Fashion Design - Level 1,01-LEC Dynamic,Staff,16,0,16,0,0
3837,North Campus,RLFI  105 - 02   Fashion Design - Level 1,02-LEC Dynamic,Staff,16,0,16,0,0
1857,Kendall Campus,RLPF  105 - 01   KIDS (SandCastles Program) 8-10 yrs,01-LAB Dynamic,Staff,0,0,0,0,0
1858,Kendall Campus,RLPF  105 - 02   KIDS (SandCastles Program) 8-10 yrs,02-LAB Dynamic,Staff,0,0,0,0,0
1859,Kendall Campus,RLPF  105 - 03   KIDS (SandCastles Program) 8-10 yrs,03-LAB Dynamic,Staff,0,0,0,0,0
1860,Kendall Campus,RLPF  105 - 04   KIDS (SandCastles Program) 8-10 yrs,04-LAB Dynamic,Staff,0,0,0,0,0
1861,Kendall Campus,RLPF  105 - 05   KIDS (SandCastles Program) 8-10 yrs,05-LAB Dynamic,Staff,0,0,0,0,0
1863,Kendall Campus,RLPF  105 - 06   KIDS (SandCastles Program) 8-10 yrs,06-LAB Dynamic,Staff,0,0,0,0,0
2267,Wolfson Campus,RLPF  105 - 07   KIDS (SandCastles Program) 8-10 yrs,07-LAB Dynamic,Staff,20,0,20,0,0
2271,Wolfson Campus,RLPF  105 - 08   KIDS (SandCastles Program) 8-10 yrs,08-LAB Dynamic,Staff,20,0,20,0,0
2276,Wolfson Campus,RLPF  105 - 09   KIDS (SandCastles Program) 8-10 yrs,09-LAB Dynamic,Staff,20,0,20,0,0
2279,Wolfson Campus,RLPF  105 - 10   KIDS (SandCastles Program) 8-10 yrs,10-LAB Dynamic,Staff,20,0,20,0,0
3543,Kendall Campus,RLPH  105 - 01   Capture· Discover· and Explore Digital Photography,01-LEC Dynamic,Staff,15,0,15,0,0
1623,InterAmerican Campus,RLSP  105 - 01   Costura 2,01-LEC Dynamic,Staff,15,0,15,0,0
1624,InterAmerican Campus,RLSP  105 - 02   Costura 2,02-LEC Dynamic,Staff,15,0,15,0,0
3565,Kendall Campus,RLTH  105 - 01   Acting for Beginners,01-LEC Dynamic,Staff,15,0,15,0,0
3566,Kendall Campus,RLTH  105 - 02   Acting for Beginners,02-LEC Dynamic,Staff,15,0,15,0,0
3866,Kendall Campus,RLWA  105 - 01   Screenwriting,01-LEC Dynamic,Staff,16,0,16,0,0
2598,West Campus,RSPE  105 - 01   FTCE General Knowledge All Inclusive Preparation,01-LEC Dynamic,Staff,16,0,16,0,0
2413,North Campus,RSPE  105 - 02   FTCE General Knowledge All Inclusive Preparation,02-LEC Dynamic,Staff,16,0,16,8,0
2746,Hialeah Campus,RSPE  105 - 03   FTCE General Knowledge All Inclusive Preparation,03-LEC Dynamic,Staff,30,0,30,0,0
1138,Wolfson Campus,WBAB  105 - 01   Bookkeeping - Level 1,01-LEC Dynamic,Staff,25,0,25,0,0
2033,Kendall Campus,WBAB  105 - 02   Bookkeeping - Level 1,02-LEC Dynamic,Staff,16,0,16,0,0
2482,West Campus,WBAB  105 - 03   Bookkeeping - Level 1,03-LEC Dynamic,Staff,35,0,35,0,0
2494,West Campus,WBAB  105 - 04   Bookkeeping - Level 1,04-LEC Dynamic,Staff,20,0,20,0,0
2487,North Campus,WBAB  105 - 05   Bookkeeping - Level 1,05-LEC Dynamic,Staff,16,0,16,0,0
2488,North Campus,WBAB  105 - 06   Bookkeeping - Level 1,06-LEC Dynamic,Staff,16,0,16,0,0
2483,West Campus,WBAB  105 - 07   Bookkeeping - Level 1,07-LEC Dynamic,Staff,35,0,35,0,0
2495,West Campus,WBAB  105 - 08   Bookkeeping - Level 1,08-LEC Dynamic,Staff,20,0,20,0,0
1014,Homestead Campus,WBCC  105 - 01   Wedding and Event Planning Certification,01-LEC Dynamic,Staff,20,0,20,0,0
2176,Wolfson Campus,WBCC  105 - 02   Wedding and Event Planning Certification,02-LEC Dynamic,Staff,30,0,30,0,0
2656,North Campus,WBCC  105 - 03   Wedding and Event Planning Certification,03-LEC Dynamic,Staff,16,0,16,0,0
2670,Kendall Campus,WBCC  105 - 04   Wedding and Event Planning Certification,04-LEC Dynamic,Staff,20,0,20,0,0
2057,Kendall Campus,WBEB  105 - 01   Customer Service for Small Businesses,01-LEC Dynamic,Staff,16,0,16,0,0
2155,Kendall Campus,WBRE  105 - 01   Preparación para la Licencia de Bienes Raíces,01-LEC Dynamic,Staff,15,0,15,0,0
2962,Hialeah Campus,WBTP  105 - 01   Intensive Income Tax Preparation Program - Business,01-LEC Dynamic,Staff,30,0,30,0,0
3435,Wolfson Campus,WBTP  105 - 02   Intensive Income Tax Preparation Program - Business,02-LEC Dynamic,Staff,30,0,30,0,0
1046,Homestead Campus,WBWA  105 - 01   Business Writing 2 - 15 hrs,01-LEC Dynamic,Staff,25,0,25,0,0
3044,Hialeah Campus,WCCI  105 - 01   Creative Curriculum 0-3: Experiences and Objectives,01-LEC Dynamic,Staff,30,0,30,0,0
1558,InterAmerican Campus,WCCP  105 - 01   Currículo Creativo Preescolar:  Resumen General (4.5 CEUs),01-LEC Dynamic,Staff,25,0,25,0,0
3051,Hialeah Campus,WCCP  105 - 02   Currículo Creativo Preescolar:  Resumen General (4.5 CEUs),02-LEC Dynamic,Staff,30,0,30,0,0
1050,Homestead Campus,WCIS  105 - 01   Curso de Preparación para el CDA Nacional,01-LEC Dynamic,Staff,25,0,25,0,0
1561,InterAmerican Campus,WCIS  105 - 02   Curso de Preparación para el CDA Nacional,02-LEC Dynamic,Staff,25,0,25,0,0
2544,Hialeah Campus,WCIS  105 - 03   Curso de Preparación para el CDA Nacional,03-LEC Dynamic,Staff,30,0,30,0,0
2628,West Campus,WCIS  105 - 04   Curso de Preparación para el CDA Nacional,04-LEC Dynamic,Staff,16,0,16,0,0
2854,North Campus,WCTR  105 - 02   30 Hours Family Child Care,02-LEC Dynamic,Staff,21,0,21,8,0
2859,North Campus,WCTR  105 - 03   30 Hours Family Child Care,03-LEC Dynamic,Staff,21,0,21,8,0
2873,North Campus,WCTR  105 - 04   30 Hours Family Child Care,04-LEC Dynamic,Staff,21,0,21,8,0
1267,Homestead Campus,WHCE  105 - 01   HIPAA - Health Insurance Portability and Accountability Act,01-LEC Dynamic,Staff,25,0,25,0,0
3078,Kendall Campus,WHCE  105 - 02   HIPAA - Health Insurance Portability and Accountability Act,02-LEC Dynamic,Staff,16,0,16,0,0
3292,Medical Campus,WHCE  105 - 03   HIPAA - Health Insurance Portability and Accountability Act,03-LEC Dynamic,Staff,16,0,16,0,0
3328,Medical Campus,WHCH  105 - 01   The Community Health Worker as Advocate,01-LEC Dynamic,Staff,25,0,25,0,0
3401,Medical Campus,WHNC  105 - 01   Critical Care Training,01-LEC Dynamic,Staff,10,0,10,0,0
3043,Kendall Campus,WHPR  105 - 01   Heartsaver CPR AED for the Layperson,01-LEC Dynamic,Staff,5,0,5,0,0
3045,Kendall Campus,WHPR  105 - 02   Heartsaver CPR AED for the Layperson,02-LEC Dynamic,Staff,5,0,5,0,0
3418,Medical Campus,WHPR  105 - 03   Heartsaver CPR AED for the Layperson,03-LEC Dynamic,Staff,25,0,25,0,0
3499,Kendall Campus,WINS  105 - 01   Registered Customer Service Representative State Designation – (4-40 RCSR) #94894,01-LEC Dynamic,Staff,16,0,16,0,0
3562,North Campus,WINS  105 - 02   Registered Customer Service Representative State Designation – (4-40 RCSR) #94894,02-LEC Dynamic,Staff,16,0,16,0,0
3563,North Campus,WINS  105 - 03   Registered Customer Service Representative State Designation – (4-40 RCSR) #94894,03-LEC Dynamic,Staff,16,0,16,0,0
1226,Kendall Campus,WLEP  105 - 01   Accent Reduction - Vowels,01-LEC Dynamic,Staff,25,0,25,0,0
1229,Kendall Campus,WLEP  105 - 02   Accent Reduction - Vowels,02-LEC Dynamic,Staff,25,0,25,0,0
1085,Kendall Campus,WLFL  105 - 01   Arabic 2 - 21 hrs.,01-LEC Dynamic,Staff,25,0,25,0,0
3673,North Campus,WTMO  105 - 01   Microsoft Excel for Small Businesses,01-LEC Dynamic,Staff,16,0,16,0,0
3674,North Campus,WTMO  105 - 02   Microsoft Excel for Small Businesses,02-LEC Dynamic,Staff,16,0,16,0,0
2689,Kendall Campus,RLFA  104 - 01   FSA – 4th Grade Math Review,01-LEC Dynamic,Staff,20,0,20,0,0
1840,Kendall Campus,RLPF  104 - 01   KIDS (SandCastles Program) 6-7 yrs,01-LEC Dynamic,Staff,0,0,0,0,0
1842,Kendall Campus,RLPF  104 - 02   KIDS (SandCastles Program) 6-7 yrs,02-LEC Dynamic,Staff,0,0,0,0,0
1843,Kendall Campus,RLPF  104 - 03   KIDS (SandCastles Program) 6-7 yrs,03-LEC Dynamic,Staff,0,0,0,0,0
1844,Kendall Campus,RLPF  104 - 04   KIDS (SandCastles Program) 6-7 yrs,04-LEC Dynamic,Staff,0,0,0,0,0
1845,Kendall Campus,RLPF  104 - 05   KIDS (SandCastles Program) 6-7 yrs,05-LEC Dynamic,Staff,0,0,0,0,0
1846,Kendall Campus,RLPF  104 - 06   KIDS (SandCastles Program) 6-7 yrs,06-LEC Dynamic,Staff,0,0,0,0,0
2259,Wolfson Campus,RLPF  104 - 07   KIDS (SandCastles Program) 6-7 yrs,07-LEC Dynamic,Staff,16,0,16,0,0
2270,Wolfson Campus,RLPF  104 - 08   KIDS (SandCastles Program) 6-7 yrs,08-LEC Dynamic,Staff,20,0,20,0,0
2274,Wolfson Campus,RLPF  104 - 09   KIDS (SandCastles Program) 6-7 yrs,09-LEC Dynamic,Staff,20,0,20,0,0
2278,Wolfson Campus,RLPF  104 - 10   KIDS (SandCastles Program) 6-7 yrs,10-LEC Dynamic,Staff,20,0,20,0,0
2086,Kendall Campus,RLSC  104 - 01   55+ Communicate using WhatsApp and Skype,01-LEC Dynamic,Staff,15,0,15,0,0
1621,InterAmerican Campus,RLSP  104 - 01   Costura 1,01-LEC Dynamic,Staff,15,0,15,0,0
1622,InterAmerican Campus,RLSP  104 - 02   Costura 1,02-LEC Dynamic,Staff,15,0,15,0,0
1137,Wolfson Campus,WBAB  104 - 01   Audit Your Business,01-LEC Dynamic,Staff,25,0,25,0,0
3135,Kendall Campus,WBCC  104 - 01   Auctioneer Pre-Licensing,01-LEC Dynamic,Staff,16,0,16,0,0
2964,Hialeah Campus,WBEB  104 - 01   Introduction to Simple Steps to Create Your Own Business,01-LEC Dynamic,Staff,30,0,30,0,0
1116,Wolfson Campus,WBHE  104 - 01   SHRM Essentials of Human Resource Management Certificate Program,01-LEC Dynamic,Staff,25,0,25,0,0
1117,Wolfson Campus,WBHE  104 - 02   SHRM Essentials of Human Resource Management Certificate Program,02-LEC Dynamic,Staff,20,0,20,0,0
2310,Kendall Campus,WBIE  104 - 01   Customs Regulations· Duties· Taxes I,01-LEC Dynamic,Staff,25,0,25,0,0
1318,Wolfson Campus,WBIN  104 - 01   Public Adjuster State Exam Preparation (3-20) with Accredited Claims Adjuster State Designation,01-LEC Dynamic,Staff,25,0,25,0,0
1319,Wolfson Campus,WBIN  104 - 02   Public Adjuster State Exam Preparation (3-20) with Accredited Claims Adjuster State Designation,02-LEC Dynamic,Staff,25,0,25,0,0
2300,Kendall Campus,WBIN  104 - 03   Public Adjuster State Exam Preparation (3-20) with Accredited Claims Adjuster State Designation,03-LEC Dynamic,Staff,25,0,25,0,0
3559,North Campus,WBIN  104 - 04   Public Adjuster State Exam Preparation (3-20) with Accredited Claims Adjuster State Designation,04-LEC Dynamic,Staff,16,0,16,0,0
2872,Kendall Campus,WBMK  104 - 01   Effective Sales Techniques,01-LEC Dynamic,Staff,20,0,20,0,0
1013,Homestead Campus,WBPD  104 - 01   Signing Agent Workshop,01-LEC Dynamic,Staff,25,0,25,0,0
1135,Wolfson Campus,WBPD  104 - 02   Signing Agent Workshop,02-LEC Dynamic,Staff,20,0,20,0,0
1136,Wolfson Campus,WBPD  104 - 03   Signing Agent Workshop,03-LEC Dynamic,Staff,25,0,25,0,0
2470,North Campus,WBPD  104 - 04   Signing Agent Workshop,04-LEC Dynamic,Staff,16,0,16,0,0
2471,North Campus,WBPD  104 - 05   Signing Agent Workshop,05-LEC Dynamic,Staff,16,0,16,0,0
2473,North Campus,WBPD  104 - 06   Signing Agent Workshop,06-LEC Dynamic,Staff,16,0,16,0,0
2474,North Campus,WBPD  104 - 07   Signing Agent Workshop,07-LEC Dynamic,Staff,16,0,16,0,0
3420,Kendall Campus,WBPD  104 - 08   Signing Agent Workshop,08-LEC Dynamic,Staff,16,0,16,0,0
2284,Wolfson Campus,WBRE  104 - 01   Preparación para la Licencia de Bienes Raíces - Libro Incluido,01-LEC Dynamic,Staff,30,0,30,0,0
2980,Hialeah Campus,WBRE  104 - 02   Preparación para la Licencia de Bienes Raíces - Libro Incluido,02-LEC Dynamic,Staff,30,0,30,0,0
2264,Kendall Campus,WCCI  104 - 01   Currículo Creativo 0 - 3: Resumen General (4.5 CEUs),01-LEC Dynamic,Staff,25,0,25,0,0
3035,Hialeah Campus,WCCI  104 - 02   Currículo Creativo 0 - 3: Resumen General (4.5 CEUs),02-LEC Dynamic,Staff,30,0,30,0,0
2299,Kendall Campus,WCCP  104 - 01   Creative Curriculum Preschool: Literacy,01-LEC Dynamic,Staff,25,0,25,0,0
2301,Kendall Campus,WCIS  104 - 01   Behavior Management,01-LEC Dynamic,Staff,25,0,25,0,0
1063,Homestead Campus,WCTR  104 - 02   30 Horas de Cuidado Infantil en un Centro,02-LEC Dynamic,Staff,25,0,25,0,0
1064,Homestead Campus,WCTR  104 - 03   30 Horas de Cuidado Infantil en un Centro,03-LEC Dynamic,Staff,25,0,25,0,0
1065,Homestead Campus,WCTR  104 - 04   30 Horas de Cuidado Infantil en un Centro,04-LEC Dynamic,Staff,25,0,25,0,0
1533,Kendall Campus,WCTR  104 - 08   30 Horas de Cuidado Infantil en un Centro,08-LEC Dynamic,Staff,25,0,25,0,0
1534,Kendall Campus,WCTR  104 - 09   30 Horas de Cuidado Infantil en un Centro,09-LEC Dynamic,Staff,25,0,25,0,0
1535,Kendall Campus,WCTR  104 - 10   30 Horas de Cuidado Infantil en un Centro,10-LEC Dynamic,Staff,25,0,25,0,0
1536,Kendall Campus,WCTR  104 - 11   30 Horas de Cuidado Infantil en un Centro,11-LEC Dynamic,Staff,25,0,25,0,0
1537,Kendall Campus,WCTR  104 - 12   30 Horas de Cuidado Infantil en un Centro,12-LEC Dynamic,Staff,25,0,25,0,0
1538,Kendall Campus,WCTR  104 - 13   30 Horas de Cuidado Infantil en un Centro,13-LEC Dynamic,Staff,25,0,25,0,0
1539,Kendall Campus,WCTR  104 - 14   30 Horas de Cuidado Infantil en un Centro,14-LEC Dynamic,Staff,25,0,25,0,0
1540,Kendall Campus,WCTR  104 - 15   30 Horas de Cuidado Infantil en un Centro,15-LEC Dynamic,Staff,25,0,25,0,0
1541,Kendall Campus,WCTR  104 - 16   30 Horas de Cuidado Infantil en un Centro,16-LEC Dynamic,Staff,25,0,25,0,0
1583,InterAmerican Campus,WCTR  104 - 17   30 Horas de Cuidado Infantil en un Centro,17-LEC Dynamic,Staff,25,0,25,0,0
1591,InterAmerican Campus,WCTR  104 - 18   30 Horas de Cuidado Infantil en un Centro,18-LEC Dynamic,Staff,25,0,25,0,0
1592,InterAmerican Campus,WCTR  104 - 19   30 Horas de Cuidado Infantil en un Centro,19-LEC Dynamic,Staff,25,0,25,0,0
1593,InterAmerican Campus,WCTR  104 - 20   30 Horas de Cuidado Infantil en un Centro,20-LEC Dynamic,Staff,25,0,25,0,0
1594,InterAmerican Campus,WCTR  104 - 21   30 Horas de Cuidado Infantil en un Centro,21-LEC Dynamic,Staff,25,0,25,0,0
2556,Hialeah Campus,WCTR  104 - 23   30 Horas de Cuidado Infantil en un Centro,23-LEC Dynamic,Staff,30,0,30,0,0
2558,Hialeah Campus,WCTR  104 - 24   30 Horas de Cuidado Infantil en un Centro,24-LEC Dynamic,Staff,30,0,30,0,0
2559,Hialeah Campus,WCTR  104 - 25   30 Horas de Cuidado Infantil en un Centro,25-LEC Dynamic,Staff,30,0,30,0,0
2560,Hialeah Campus,WCTR  104 - 26   30 Horas de Cuidado Infantil en un Centro,26-LEC Dynamic,Staff,30,0,30,0,0
2561,Hialeah Campus,WCTR  104 - 27   30 Horas de Cuidado Infantil en un Centro,27-LEC Dynamic,Staff,30,0,30,0,0
2563,Hialeah Campus,WCTR  104 - 28   30 Horas de Cuidado Infantil en un Centro,28-LEC Dynamic,Staff,30,0,30,0,0
2610,West Campus,WCTR  104 - 29   30 Horas de Cuidado Infantil en un Centro,29-LEC Dynamic,Staff,25,0,25,0,0
2611,West Campus,WCTR  104 - 30   30 Horas de Cuidado Infantil en un Centro,30-LEC Dynamic,Staff,25,0,25,0,0
2612,West Campus,WCTR  104 - 31   30 Horas de Cuidado Infantil en un Centro,31-LEC Dynamic,Staff,25,0,25,0,0
2609,West Campus,WCTR  104 - 32   30 Horas de Cuidado Infantil en un Centro,32-LEC Dynamic,Staff,25,0,25,0,0
1266,Homestead Campus,WHCE  104 - 01   Domestic Violence,01-LEC Dynamic,Staff,25,0,25,0,0
2798,Medical Campus,WHCE  104 - 02   Domestic Violence,02-LEC Dynamic,Staff,25,0,25,0,0
2799,Medical Campus,WHCE  104 - 03   Domestic Violence,03-LEC Dynamic,Staff,25,0,25,0,0
2810,North Campus,WHCE  104 - 04   Domestic Violence,04-LEC Dynamic,Staff,16,0,16,0,0
3077,Kendall Campus,WHCE  104 - 06   Domestic Violence,06-LEC Dynamic,Staff,16,0,16,0,0
3326,Medical Campus,WHCH  104 - 01   Professional Responsibilities of the CHW,01-LEC Dynamic,Staff,25,0,25,0,0
1286,Homestead Campus,WHPR  104 - 01   Heartsaver-CPR/First Aid,01-LEC Dynamic,Staff,25,0,25,0,0
1287,Homestead Campus,WHPR  104 - 02   Heartsaver-CPR/First Aid,02-LEC Dynamic,Staff,25,0,25,0,0
1288,Homestead Campus,WHPR  104 - 03   Heartsaver-CPR/First Aid,03-LEC Dynamic,Staff,25,0,25,0,0
1289,Homestead Campus,WHPR  104 - 04   Heartsaver-CPR/First Aid,04-LEC Dynamic,Staff,25,0,25,0,0
3048,Kendall Campus,WHPR  104 - 05   Heartsaver-CPR/First Aid,05-LEC Dynamic,Staff,13,0,13,0,0
3050,Kendall Campus,WHPR  104 - 06   Heartsaver-CPR/First Aid,06-LEC Dynamic,Staff,13,0,13,0,0
3419,Medical Campus,WHPR  104 - 07   Heartsaver-CPR/First Aid,07-LEC Dynamic,Staff,25,0,25,0,0
3724,Kendall Campus,WHPR  104 - 08   Heartsaver-CPR/First Aid,08-LEC Dynamic,Staff,18,0,18,0,0
3727,Kendall Campus,WHPR  104 - 09   Heartsaver-CPR/First Aid,09-LEC Dynamic,Staff,18,0,18,0,0
3730,Kendall Campus,WHPR  104 - 10   Heartsaver-CPR/First Aid,10-LEC Dynamic,Staff,18,0,18,0,0
3732,Kendall Campus,WHPR  104 - 11   Heartsaver-CPR/First Aid,11-LEC Dynamic,Staff,18,0,18,0,0
3417,Medical Campus,WHRN  104 - 01   NCLEX LPN Remedial Clinical Practicum,01-CLN Dynamic,Staff,6,0,6,0,0
1484,Wolfson Campus,WLEP  104 - 01   Accent Reduction - Intermediate,01-LEC Dynamic,Staff,30,0,30,0,0
1486,Wolfson Campus,WLEP  104 - 02   Accent Reduction - Intermediate,02-LEC Dynamic,Staff,16,0,16,0,0
2159,Wolfson Campus,WLEP  104 - 03   Accent Reduction - Intermediate,03-LEC Dynamic,Staff,30,0,30,0,0
2160,Wolfson Campus,WLEP  104 - 04   Accent Reduction - Intermediate,04-LEC Dynamic,Staff,30,0,30,0,0
1704,Wolfson Campus,WLFL  104 - 01   Arabic 2 - 28 hrs.,01-LEC Dynamic,Staff,30,0,30,0,0
2199,Wolfson Campus,WLFL  104 - 02   Arabic 2 - 28 hrs.,02-LEC Dynamic,Staff,30,0,30,0,0
2127,Kendall Campus,WTMO  104 - 01   Microsoft Excel 2013 Nivel 2,01-LEC Dynamic,Staff,15,0,15,0,0
2347,Kendall Campus,RLAC  103 - 01   Aquatic Exercise II: High Impact,01-LEC Dynamic,Staff,9,0,9,0,0
3484,Kendall Campus,RLAM  103 - 01   Fashion Make-Up and More,01-LEC Dynamic,Staff,12,0,12,0,0
3485,Kendall Campus,RLAM  103 - 02   Fashion Make-Up and More,02-LEC Dynamic,Staff,12,0,12,0,0
1223,Wolfson Campus,RLCP  103 - 01   ACT Test Preparation,01-LEC Dynamic,Staff,25,0,25,0,0
1227,Wolfson Campus,RLCP  103 - 02   ACT Test Preparation,02-LEC Dynamic,Staff,25,0,25,0,0
2866,Kendall Campus,RLCP  103 - 03   ACT Test Preparation,03-LEC Dynamic,Staff,20,0,20,0,0
2870,Kendall Campus,RLCP  103 - 04   ACT Test Preparation,04-LEC Dynamic,Staff,20,0,20,0,0
3025,Kendall Campus,RLDA  103 - 01   Ballet (Ages 6 - 12),01-LEC Dynamic,Staff,15,0,15,0,0
3026,Kendall Campus,RLDA  103 - 02   Ballet (Ages 6 - 12),02-LEC Dynamic,Staff,15,0,15,0,0
2135,InterAmerican Campus,RLDP  103 - 01   Serie de Fotografía Digital,01-LEC Dynamic,Staff,20,0,20,0,0
2691,Kendall Campus,RLFA  103 - 01   FSA – 4th/5th Grade Writing Review,01-LEC Dynamic,Staff,20,0,20,0,0
2803,Kendall Campus,RLHL  103 - 01   Ayurveda/Unlock the Secret to Health,01-LEC Dynamic,Staff,20,0,20,0,0
2722,Kendall Campus,RLID  103 - 01   Decoración de Interiores - Nivel 3,01-LEC Dynamic,Staff,20,0,20,0,0
2724,Kendall Campus,RLID  103 - 02   Decoración de Interiores - Nivel 3,02-LEC Dynamic,Staff,20,0,20,0,0
2683,Kendall Campus,RLLS  103 - 01   Etiquette and Leadership Skills for Teens (Ages 12 - 17),01-LEC Dynamic,Staff,20,0,20,0,0
2684,Kendall Campus,RLLS  103 - 02   Etiquette and Leadership Skills for Teens (Ages 12 - 17),02-LEC Dynamic,Staff,20,0,20,0,0
3211,Kendall Campus,RLMP  103 - 01   Private Music - 14 - 1 Hour Sibling,01-LEC Dynamic,Staff,16,0,16,0,0
2027,Kendall Campus,RLPF  103 - 01   KIDS (SandCastles Program) 14-17 yrs,01-LEC Dynamic,Staff,0,0,0,0,0
2029,Kendall Campus,RLPF  103 - 02   KIDS (SandCastles Program) 14-17 yrs,02-LEC Dynamic,Staff,0,0,0,0,0
2031,Kendall Campus,RLPF  103 - 03   KIDS (SandCastles Program) 14-17 yrs,03-LEC Dynamic,Staff,0,0,0,0,0
2034,Kendall Campus,RLPF  103 - 04   KIDS (SandCastles Program) 14-17 yrs,04-LEC Dynamic,Staff,0,0,0,0,0
2035,Kendall Campus,RLPF  103 - 05   KIDS (SandCastles Program) 14-17 yrs,05-LEC Dynamic,Staff,0,0,0,0,0
2036,Kendall Campus,RLPF  103 - 06   KIDS (SandCastles Program) 14-17 yrs,06-LEC Dynamic,Staff,0,0,0,0,0
2269,Wolfson Campus,RLPF  103 - 07   KIDS (SandCastles Program) 14-17 yrs,07-LEC Dynamic,Staff,20,0,20,0,0
2273,Wolfson Campus,RLPF  103 - 08   KIDS (SandCastles Program) 14-17 yrs,08-LEC Dynamic,Staff,20,0,20,0,0
2281,Wolfson Campus,RLPF  103 - 09   KIDS (SandCastles Program) 14-17 yrs,09-LEC Dynamic,Staff,20,0,20,0,0
2282,Wolfson Campus,RLPF  103 - 10   KIDS (SandCastles Program) 14-17 yrs,10-LEC Dynamic,Staff,20,0,20,0,0
2903,Hialeah Campus,RLSC  103 - 01   55+ Correo Electrónico,01-LEC Dynamic,Staff,16,0,16,0,0
1368,Wolfson Campus,RLSP  103 - 01   Fashion Accessorizing,01-LAB Dynamic,Staff,20,0,20,0,0
2662,Kendall Campus,RLTH  103 - 01   Acting and Theater for Teens,01-LEC Dynamic,Staff,30,0,30,0,0
2699,Kendall Campus,RLTH  103 - 02   Acting and Theater for Teens,02-LEC Dynamic,Staff,30,0,30,0,0
1447,Kendall Campus,RLTO  103 - 01   Preparation Course for the TOEFL iBT,01-LEC Dynamic,Staff,30,0,30,0,0
1448,Kendall Campus,RLTO  103 - 02   Preparation Course for the TOEFL iBT,02-LEC Dynamic,Staff,30,0,30,0,0
1517,InterAmerican Campus,RLTO  103 - 03   Preparation Course for the TOEFL iBT,03-LEC Dynamic,Staff,30,0,30,0,0
2600,West Campus,RLTO  103 - 04   Preparation Course for the TOEFL iBT,04-LEC Dynamic,Staff,30,0,30,0,0
2601,West Campus,RLTO  103 - 05   Preparation Course for the TOEFL iBT,05-LEC Dynamic,Staff,30,0,30,0,0
1216,Wolfson Campus,WBAB  103 - 02   Accounting and Finance Series,02-LEC Dynamic,Staff,20,0,20,0,0
1335,Wolfson Campus,WBCC  103 - 01   Property Management Essentials,01-LEC Dynamic,Staff,16,0,16,0,0
1956,InterAmerican Campus,WBEB  103 - 01   Como Crear una Empresa de Importación y Exportación,01-LEC Dynamic,Staff,16,0,16,0,0
1958,InterAmerican Campus,WBEB  103 - 02   Como Crear una Empresa de Importación y Exportación,02-LEC Dynamic,Staff,16,0,16,0,0
2956,Hialeah Campus,WBEB  103 - 03   Como Crear una Empresa de Importación y Exportación,03-LEC Dynamic,Staff,30,0,30,0,0
3225,North Campus,WBEB  103 - 04   Como Crear una Empresa de Importación y Exportación,04-LEC Dynamic,Staff,16,0,16,0,0
2663,Kendall Campus,WBHR  103 - 01   Human Resources Professional Development,01-LEC Dynamic,Staff,20,0,20,0,0
3594,Kendall Campus,WBIE  103 - 01   Customs Regulations· Duties· Taxes II,01-LEC Dynamic,Staff,16,0,16,0,0
2304,Kendall Campus,WBIN  103 - 01   Public Adjuster Exam Review/Cram,01-LEC Dynamic,Staff,25,0,25,0,0
1232,Wolfson Campus,WBMS  103 - 01   Conflict Resolution: How to Deal with Difficult People,01-LEC Dynamic,Staff,20,0,20,0,0
2076,Kendall Campus,WBMS  103 - 02   Conflict Resolution: How to Deal with Difficult People,02-LEC Dynamic,Staff,16,0,16,0,0
2021,Kendall Campus,WBRE  103 - 01   7-Hour USPAP Update,01-LEC Dynamic,Staff,15,0,15,0,0
1501,Wolfson Campus,WBWA  103 - 01   Business Writing 1 21 hrs,01-LEC Dynamic,Staff,30,0,30,0,0
2169,Wolfson Campus,WBWA  103 - 02   Business Writing 1 21 hrs,02-LEC Dynamic,Staff,30,0,30,0,0
2528,Hialeah Campus,WBWA  103 - 03   Business Writing 1 21 hrs,03-LEC Dynamic,Staff,30,0,30,0,0
1048,Homestead Campus,WCCP  103 - 01   Creative Curriculum Preschool: Overview,01-LEC Dynamic,Staff,25,0,25,0,0
1053,Homestead Campus,WCIS  103 - 01   Ambiente para Infantes y Párvulos (4.5 CEU's),01-LEC Dynamic,Staff,25,0,25,0,0
2541,Hialeah Campus,WCIS  103 - 02   Ambiente para Infantes y Párvulos (4.5 CEU's),02-LEC Dynamic,Staff,30,0,30,0,0
1057,Homestead Campus,WCTR  103 - 01   30 Hours Child Care Facility Personnel Training,01-LEC Dynamic,Staff,25,0,25,0,0
1237,Kendall Campus,WCTR  103 - 04   30 Hours Child Care Facility Personnel Training,04-LEC Dynamic,Staff,25,0,25,0,0
1238,Kendall Campus,WCTR  103 - 05   30 Hours Child Care Facility Personnel Training,05-LEC Dynamic,Staff,25,0,25,0,0
1239,Kendall Campus,WCTR  103 - 06   30 Hours Child Care Facility Personnel Training,06-LEC Dynamic,Staff,25,0,25,0,0
1243,Kendall Campus,WCTR  103 - 07   30 Hours Child Care Facility Personnel Training,07-LEC Dynamic,Staff,25,0,25,0,0
2767,North Campus,WCTR  103 - 09   30 Hours Child Care Facility Personnel Training,09-LEC Dynamic,Staff,21,0,21,8,0
2792,North Campus,WCTR  103 - 11   30 Hours Child Care Facility Personnel Training,11-LEC Dynamic,Staff,21,0,21,8,0
2830,North Campus,WCTR  103 - 12   30 Hours Child Care Facility Personnel Training,12-LEC Dynamic,Staff,21,0,21,8,0
2832,North Campus,WCTR  103 - 13   30 Hours Child Care Facility Personnel Training,13-LEC Dynamic,Staff,21,0,21,8,0
2833,North Campus,WCTR  103 - 14   30 Hours Child Care Facility Personnel Training,14-LEC Dynamic,Staff,21,0,21,8,0
2837,North Campus,WCTR  103 - 15   30 Hours Child Care Facility Personnel Training,15-LEC Dynamic,Staff,21,0,21,8,0
2841,North Campus,WCTR  103 - 16   30 Hours Child Care Facility Personnel Training,16-LEC Dynamic,Staff,21,0,21,8,0
3595,Kendall Campus,WCTR  103 - 17   30 Hours Child Care Facility Personnel Training,17-LEC Dynamic,Staff,16,0,16,0,0
2759,North Campus,WCTR  103 - 18   30 Hours Child Care Facility Personnel Training,18-LEC Dynamic,Staff,21,0,21,8,0
3757,Homestead Campus,WCTR  103 - 19   30 Hours Child Care Facility Personnel Training,19-LEC Dynamic,Staff,25,0,25,0,0
2768,Medical Campus,WHAC  103 - 01   ACLS Provider Course,01-LEC Dynamic,Staff,15,0,15,0,0
2783,Medical Campus,WHCE  103 - 01   Laws and Rules for Florida Nurses,01-LEC Dynamic,Staff,25,0,25,0,0
2790,Medical Campus,WHCE  103 - 02   Laws and Rules for Florida Nurses,02-LEC Dynamic,Staff,25,0,25,0,0
3325,Medical Campus,WHCH  103 - 01   Identifying Client Needs and Resources in a Community Health Setting,01-LEC Dynamic,Staff,25,0,25,0,0
1275,Homestead Campus,WHCP  103 - 01   Certified Nursing Assistant (CNA) Test Prep,01-LEC Dynamic,Staff,25,0,25,0,0
1276,Homestead Campus,WHCP  103 - 02   Certified Nursing Assistant (CNA) Test Prep,02-LEC Dynamic,Staff,25,0,25,0,0
3349,Medical Campus,WHCP  103 - 03   Certified Nursing Assistant (CNA) Test Prep,03-LEC Dynamic,Staff,10,0,10,0,0
3352,Medical Campus,WHCP  103 - 04   Certified Nursing Assistant (CNA) Test Prep,04-LEC Dynamic,Staff,10,0,10,0,0
3353,Medical Campus,WHCP  103 - 05   Certified Nursing Assistant (CNA) Test Prep,05-LEC Dynamic,Staff,10,0,10,0,0
3354,Medical Campus,WHCP  103 - 06   Certified Nursing Assistant (CNA) Test Prep,06-LEC Dynamic,Staff,10,0,10,0,0
3365,Medical Campus,WHEM  103 - 01   Paramedic Refresher Course,01-LEC Dynamic,Staff,25,0,25,0,0
3378,Medical Campus,WHHA  103 - 01   PALS Instructor Course,01-LEC Dynamic,Staff,25,0,25,0,0
3395,Medical Campus,WHMR  103 - 01   MRI Clinical Practice,01-CLN Dynamic,Staff,25,0,25,0,0
3397,Medical Campus,WHMS  103 - 01   Med-Surg RN Skills: Refresher,01-LEC Dynamic,Staff,20,0,20,0,0
1280,Homestead Campus,WHPR  103 - 01   CPR-BLS for Health Care Providers,01-LEC Dynamic,Staff,25,0,25,0,0
1281,Homestead Campus,WHPR  103 - 02   CPR-BLS for Health Care Providers,02-LEC Dynamic,Staff,25,0,25,0,0
1282,Homestead Campus,WHPR  103 - 03   CPR-BLS for Health Care Providers,03-LEC Dynamic,Staff,25,0,25,0,0
1283,Homestead Campus,WHPR  103 - 04   CPR-BLS for Health Care Providers,04-LEC Dynamic,Staff,25,0,25,0,0
1284,Homestead Campus,WHPR  103 - 05   CPR-BLS for Health Care Providers,05-LEC Dynamic,Staff,25,0,25,0,0
1285,Homestead Campus,WHPR  103 - 06   CPR-BLS for Health Care Providers,06-LEC Dynamic,Staff,25,0,25,0,0
2114,Medical Campus,WHPR  103 - 07   CPR-BLS for Health Care Providers,07-LEC Dynamic,Staff,25,0,25,0,0
2117,Medical Campus,WHPR  103 - 08   CPR-BLS for Health Care Providers,08-LEC Dynamic,Staff,25,0,25,0,0
2118,Medical Campus,WHPR  103 - 09   CPR-BLS for Health Care Providers,09-LEC Dynamic,Staff,25,0,25,0,0
2121,Medical Campus,WHPR  103 - 10   CPR-BLS for Health Care Providers,10-LEC Dynamic,Staff,25,0,25,0,0
2122,Medical Campus,WHPR  103 - 11   CPR-BLS for Health Care Providers,11-LEC Dynamic,Staff,25,0,25,0,0
2124,Medical Campus,WHPR  103 - 12   CPR-BLS for Health Care Providers,12-LEC Dynamic,Staff,25,0,25,0,0
2126,Medical Campus,WHPR  103 - 13   CPR-BLS for Health Care Providers,13-LEC Dynamic,Staff,25,0,25,0,0
2128,Medical Campus,WHPR  103 - 14   CPR-BLS for Health Care Providers,14-LEC Dynamic,Staff,25,0,25,0,0
2129,Medical Campus,WHPR  103 - 15   CPR-BLS for Health Care Providers,15-LEC Dynamic,Staff,25,0,25,0,0
2130,Medical Campus,WHPR  103 - 16   CPR-BLS for Health Care Providers,16-LEC Dynamic,Staff,25,0,25,0,0
2521,Hialeah Campus,WHPR  103 - 17   CPR-BLS for Health Care Providers,17-LEC Dynamic,Staff,16,0,16,0,0
2522,Hialeah Campus,WHPR  103 - 18   CPR-BLS for Health Care Providers,18-LEC Dynamic,Staff,16,0,16,0,0
2762,North Campus,WHPR  103 - 19   CPR-BLS for Health Care Providers,19-LEC Dynamic,Staff,16,0,16,0,0
2765,North Campus,WHPR  103 - 20   CPR-BLS for Health Care Providers,20-LEC Dynamic,Staff,16,0,16,0,0
2766,North Campus,WHPR  103 - 21   CPR-BLS for Health Care Providers,21-LEC Dynamic,Staff,16,0,16,0,0
2770,North Campus,WHPR  103 - 22   CPR-BLS for Health Care Providers,22-LEC Dynamic,Staff,16,0,16,0,0
2771,North Campus,WHPR  103 - 23   CPR-BLS for Health Care Providers,23-LEC Dynamic,Staff,16,0,16,0,0
2776,North Campus,WHPR  103 - 24   CPR-BLS for Health Care Providers,24-LEC Dynamic,Staff,16,0,16,0,0
3054,Kendall Campus,WHPR  103 - 25   CPR-BLS for Health Care Providers,25-LEC Dynamic,Staff,16,0,16,0,0
3056,Kendall Campus,WHPR  103 - 26   CPR-BLS for Health Care Providers,26-LEC Dynamic,Staff,16,0,16,0,0
3058,Kendall Campus,WHPR  103 - 27   CPR-BLS for Health Care Providers,27-LEC Dynamic,Staff,16,0,16,0,0
3062,Kendall Campus,WHPR  103 - 28   CPR-BLS for Health Care Providers,28-LEC Dynamic,Staff,16,0,16,0,0
3064,Kendall Campus,WHPR  103 - 29   CPR-BLS for Health Care Providers,29-LEC Dynamic,Staff,16,0,16,0,0
3414,Medical Campus,WHRN  103 - 01   NCLEX RN Remediation Clinical Practicum,01-LEC Dynamic,Staff,6,0,6,0,0
3415,Medical Campus,WHRN  103 - 02   NCLEX RN Remediation Clinical Practicum,02-LEC Dynamic,Staff,6,0,6,0,0
3416,Medical Campus,WHRN  103 - 03   NCLEX RN Remediation Clinical Practicum,03-LEC Dynamic,Staff,6,0,6,0,0
1479,Wolfson Campus,WLEP  103 - 01   Accent Reduction - Beginners,01-LEC Dynamic,Staff,16,0,16,0,0
1480,Wolfson Campus,WLEP  103 - 02   Accent Reduction - Beginners,02-LEC Dynamic,Staff,16,0,16,0,0
2011,Wolfson Campus,WLEP  103 - 03   Accent Reduction - Beginners,03-LEC Dynamic,Staff,30,0,30,0,0
2012,Wolfson Campus,WLEP  103 - 04   Accent Reduction - Beginners,04-LEC Dynamic,Staff,30,0,30,0,0
2648,West Campus,WLEP  103 - 05   Accent Reduction - Beginners,05-LEC Dynamic,Staff,16,0,16,0,0
1702,Wolfson Campus,WLFL  103 - 01   Arabic 1 - 28 hrs.,01-LEC Dynamic,Staff,30,0,30,0,0
2198,Wolfson Campus,WLFL  103 - 02   Arabic 1 - 28 hrs.,02-LEC Dynamic,Staff,30,0,30,0,0
1685,Wolfson Campus,WTMO  103 - 01   Microsoft Excel 2013 Básico,01-LEC Dynamic,Staff,25,0,25,0,0
2966,Hialeah Campus,WTMO  103 - 02   Microsoft Excel 2013 Básico,02-LEC Dynamic,Staff,16,0,16,0,0
2967,Hialeah Campus,WTMO  103 - 03   Microsoft Excel 2013 Básico,03-LEC Dynamic,Staff,16,0,16,0,0
3621,North Campus,WTMO  103 - 04   Microsoft Excel 2013 Básico,04-LEC Dynamic,Staff,16,0,16,0,0
3622,North Campus,WTMO  103 - 05   Microsoft Excel 2013 Básico,05-LEC Dynamic,Staff,16,0,16,0,0
3623,North Campus,WTMO  103 - 06   Microsoft Excel 2013 Básico,06-LEC Dynamic,Staff,16,0,16,0,0
3675,North Campus,WTMO  103 - 07   Microsoft Excel 2013 Básico,07-LEC Dynamic,Staff,16,0,16,0,0
2344,Kendall Campus,RLAC  102 - 01   Aquatic Exercise I: Low Impact,01-LEC Dynamic,Staff,9,0,9,0,0
2345,Kendall Campus,RLAC  102 - 02   Aquatic Exercise I: Low Impact,02-LEC Dynamic,Staff,9,0,9,0,0
2346,Kendall Campus,RLAC  102 - 03   Aquatic Exercise I: Low Impact,03-LEC Dynamic,Staff,9,0,9,0,0
3119,Hialeah Campus,RLAM  102 - 01   Basic Make-up Techniques,01-LEC Dynamic,Staff,30,0,30,0,0
3478,Kendall Campus,RLAM  102 - 02   Basic Make-up Techniques,02-LEC Dynamic,Staff,12,0,12,0,0
3479,Kendall Campus,RLAM  102 - 03   Basic Make-up Techniques,03-LEC Dynamic,Staff,12,0,12,0,0
3481,Kendall Campus,RLAM  102 - 04   Basic Make-up Techniques,04-LEC Dynamic,Staff,12,0,12,0,0
1255,Homestead Campus,RLCP  102 - 01   ACT Intensive Read/Write,01-LEC Dynamic,Staff,25,0,25,0,0
2575,West Campus,RLCP  102 - 02   ACT Intensive Read/Write,02-LEC Dynamic,Staff,20,0,20,0,0
2576,West Campus,RLCP  102 - 03   ACT Intensive Read/Write,03-LEC Dynamic,Staff,20,0,20,0,0
2406,North Campus,RLCP  102 - 04   ACT Intensive Read/Write,04-LEC Dynamic,Staff,20,0,20,10,0
3585,Wolfson Campus,RLCP  102 - 05   ACT Intensive Read/Write,05-LEC Dynamic,Staff,25,0,25,0,0
3587,Wolfson Campus,RLCP  102 - 06   ACT Intensive Read/Write,06-LEC Dynamic,Staff,20,0,20,0,0
1361,Wolfson Campus,RLCT  102 - 01   Terminología para el Examen de Ciudadanía,01-LEC Dynamic,Staff,30,0,30,0,0
1362,Wolfson Campus,RLCT  102 - 02   Terminología para el Examen de Ciudadanía,02-LEC Dynamic,Staff,30,0,30,0,0
2595,West Campus,RLCT  102 - 03   Terminología para el Examen de Ciudadanía,03-LEC Dynamic,Staff,30,0,30,0,0
1686,Wolfson Campus,RLDA  102 - 01   Argentine Tango,01-LEC Dynamic,Staff,30,0,30,0,0
3125,Hialeah Campus,RLDP  102 - 01   Fotografía Digital Básica,01-LEC Dynamic,Staff,30,0,30,0,0
1406,InterAmerican Campus,RLEP  102 - 01   Introduccion a Planificacion de Eventos Empresarios y Sociales,01-LEC Dynamic,Staff,16,0,16,0,0
2688,Kendall Campus,RLFA  102 - 01   FSA - 3rd Grade Reading Review,01-LEC Dynamic,Staff,20,0,20,0,0
2181,Wolfson Campus,RLGE  102 - 01   GRE Test Preparation-Verbal,01-LEC Dynamic,Staff,25,0,25,0,0
2185,Wolfson Campus,RLGE  102 - 02   GRE Test Preparation-Verbal,02-LEC Dynamic,Staff,25,0,25,0,0
2452,Hialeah Campus,RLGE  102 - 03   GRE Test Preparation-Verbal,03-LEC Dynamic,Staff,16,0,16,0,0
2715,Kendall Campus,RLID  102 - 01   Decoración de Interiores - Nivel 2,01-LEC Dynamic,Staff,20,0,20,0,0
2720,Kendall Campus,RLID  102 - 02   Decoración de Interiores - Nivel 2,02-LEC Dynamic,Staff,20,0,20,0,0
2681,Kendall Campus,RLLS  102 - 01   Etiquette and Leadership Skills for Children (Ages 7 - 11),01-LEC Dynamic,Staff,20,0,20,0,0
2682,Kendall Campus,RLLS  102 - 02   Etiquette and Leadership Skills for Children (Ages 7 - 11),02-LEC Dynamic,Staff,20,0,20,0,0
1878,Kendall Campus,RLPF  102 - 01   KIDS (SandCastles Program) 11-13 yrs,01-LEC Dynamic,Staff,16,0,16,0,0
1886,Kendall Campus,RLPF  102 - 02   KIDS (SandCastles Program) 11-13 yrs,02-LEC Dynamic,Staff,0,0,0,0,0
1887,Kendall Campus,RLPF  102 - 03   KIDS (SandCastles Program) 11-13 yrs,03-LEC Dynamic,Staff,0,0,0,0,0
1891,Kendall Campus,RLPF  102 - 04   KIDS (SandCastles Program) 11-13 yrs,04-LEC Dynamic,Staff,0,0,0,0,0
1976,Kendall Campus,RLPF  102 - 05   KIDS (SandCastles Program) 11-13 yrs,05-LEC Dynamic,Staff,0,0,0,0,0
1982,Kendall Campus,RLPF  102 - 06   KIDS (SandCastles Program) 11-13 yrs,06-LEC Dynamic,Staff,0,0,0,0,0
1984,Kendall Campus,RLPF  102 - 07   KIDS (SandCastles Program) 11-13 yrs,07-LEC Dynamic,Staff,16,0,16,0,0
2268,Wolfson Campus,RLPF  102 - 08   KIDS (SandCastles Program) 11-13 yrs,08-LEC Dynamic,Staff,20,0,20,0,0
2272,Wolfson Campus,RLPF  102 - 09   KIDS (SandCastles Program) 11-13 yrs,09-LEC Dynamic,Staff,20,0,20,0,0
2277,Wolfson Campus,RLPF  102 - 10   KIDS (SandCastles Program) 11-13 yrs,10-LEC Dynamic,Staff,20,0,20,0,0
2280,Wolfson Campus,RLPF  102 - 11   KIDS (SandCastles Program) 11-13 yrs,11-LEC Dynamic,Staff,20,0,20,0,0
2045,Wolfson Campus,RLSC  102 - 01   55+ Computer Basics,01-LAB Dynamic,Staff,20,0,20,0,0
2067,Hialeah Campus,RLSP  102 - 01   Basic Sewing,01-LEC Dynamic,Staff,30,0,30,0,0
1662,Wolfson Campus,RLTO  102 - 01   Preparation Course for the TOEFL iBT,01-LEC Dynamic,Staff,30,0,30,0,0
1663,Wolfson Campus,RLTO  102 - 02   Preparation Course for the TOEFL iBT,02-LEC Dynamic,Staff,30,0,30,0,0
1664,Wolfson Campus,RLTO  102 - 03   Preparation Course for the TOEFL iBT,03-LEC Dynamic,Staff,30,0,30,0,0
2178,Wolfson Campus,RLTO  102 - 04   Preparation Course for the TOEFL iBT,04-LEC Dynamic,Staff,30,0,30,0,0
2179,Wolfson Campus,RLTO  102 - 05   Preparation Course for the TOEFL iBT,05-LEC Dynamic,Staff,30,0,30,0,0
2180,Wolfson Campus,RLTO  102 - 06   Preparation Course for the TOEFL iBT,06-LEC Dynamic,Staff,30,0,30,0,0
2462,Hialeah Campus,RLTO  102 - 07   Preparation Course for the TOEFL iBT,07-LEC Dynamic,Staff,30,0,30,0,0
2463,Hialeah Campus,RLTO  102 - 08   Preparation Course for the TOEFL iBT,08-LEC Dynamic,Staff,30,0,30,0,0
1211,Wolfson Campus,WBAB  102 - 01   Accounting - Level II,01-LEC Dynamic,Staff,20,0,20,0,0
2030,Kendall Campus,WBAB  102 - 02   Accounting - Level II,02-LEC Dynamic,Staff,16,0,16,0,0
2485,North Campus,WBAB  102 - 03   Accounting - Level II,03-LEC Dynamic,Staff,16,0,16,0,0
1045,Homestead Campus,WBCC  102 - 01   Community Association Manager License Exam Preparation (CAM - PRE 33),01-LEC Dynamic,Staff,25,0,25,0,0
1257,Wolfson Campus,WBCC  102 - 02   Community Association Manager License Exam Preparation (CAM - PRE 33),02-LEC Dynamic,Staff,30,0,30,0,0
1258,Wolfson Campus,WBCC  102 - 03   Community Association Manager License Exam Preparation (CAM - PRE 33),03-LEC Dynamic,Staff,30,0,30,0,0
2071,Kendall Campus,WBCC  102 - 04   Community Association Manager License Exam Preparation (CAM - PRE 33),04-LEC Dynamic,Staff,15,0,15,0,0
2864,North Campus,WBCC  102 - 05   Community Association Manager License Exam Preparation (CAM - PRE 33),05-LEC Dynamic,Staff,16,0,16,0,0
2865,North Campus,WBCC  102 - 06   Community Association Manager License Exam Preparation (CAM - PRE 33),06-LEC Dynamic,Staff,16,0,16,0,0
2867,North Campus,WBCC  102 - 07   Community Association Manager License Exam Preparation (CAM - PRE 33),07-LEC Dynamic,Staff,16,0,16,0,0
3536,Wolfson Campus,WBCI  102 - 01   Practical Construction Management,01-LEC Dynamic,Staff,25,0,25,0,0
2055,Kendall Campus,WBEB  102 - 01   Como Comenzar una Pequeña Empresa 1,01-LEC Dynamic,Staff,16,0,16,0,0
2480,West Campus,WBEB  102 - 02   Como Comenzar una Pequeña Empresa 1,02-LEC Dynamic,Staff,16,0,16,0,0
2481,West Campus,WBEB  102 - 03   Como Comenzar una Pequeña Empresa 1,03-LEC Dynamic,Staff,16,0,16,0,0
3523,Wolfson Campus,WBEB  102 - 04   Como Comenzar una Pequeña Empresa 1,04-LEC Dynamic,Staff,25,0,25,0,0
3588,Homestead Campus,WBHR  102 - 01   Human Resources for Business,01-LEC Dynamic,Staff,25,0,25,0,0
1341,Wolfson Campus,WBIE  102 - 01   Logistics and Distribution Management for Professionals,01-LEC Dynamic,Staff,25,0,25,0,0
3230,North Campus,WBMK  102 - 01   Tourism and Customer Service Champion - Miami Begins with Me,01-LEC Dynamic,Staff,16,0,16,0,0
3231,North Campus,WBMK  102 - 02   Tourism and Customer Service Champion - Miami Begins with Me,02-LEC Dynamic,Staff,16,0,16,0,0
3232,North Campus,WBMK  102 - 03   Tourism and Customer Service Champion - Miami Begins with Me,03-LEC Dynamic,Staff,16,0,16,0,0
3233,North Campus,WBMK  102 - 04   Tourism and Customer Service Champion - Miami Begins with Me,04-LEC Dynamic,Staff,16,0,16,0,0
3234,North Campus,WBMK  102 - 05   Tourism and Customer Service Champion - Miami Begins with Me,05-LEC Dynamic,Staff,16,0,16,0,0
3235,North Campus,WBMK  102 - 06   Tourism and Customer Service Champion - Miami Begins with Me,06-LEC Dynamic,Staff,16,0,16,0,0
3236,North Campus,WBMK  102 - 07   Tourism and Customer Service Champion - Miami Begins with Me,07-LEC Dynamic,Staff,16,0,16,0,0
2242,Wolfson Campus,WBMS  102 - 01   Management and Human Resources Professional Certificate,01-LEC Dynamic,Staff,20,0,20,0,0
2072,Kendall Campus,WBNI  102 - 01   Introduction to Grant Writing,01-LEC Dynamic,Staff,16,0,16,0,0
2505,West Campus,WBNI  102 - 02   Introduction to Grant Writing,02-LEC Dynamic,Staff,20,0,20,0,0
1010,Homestead Campus,WBPD  102 - 01   Notary Public Workshop,01-LEC Dynamic,Staff,25,0,25,0,0
1011,Homestead Campus,WBPD  102 - 02   Notary Public Workshop,02-LEC Dynamic,Staff,25,0,25,0,0
1012,Homestead Campus,WBPD  102 - 03   Notary Public Workshop,03-LEC Dynamic,Staff,25,0,25,0,0
2102,Kendall Campus,WBPD  102 - 04   Notary Public Workshop,04-LEC Dynamic,Staff,15,0,15,0,0
1130,Wolfson Campus,WBPD  102 - 06   Notary Public Workshop,06-LEC Dynamic,Staff,20,0,20,0,0
1132,Wolfson Campus,WBPD  102 - 07   Notary Public Workshop,07-LEC Dynamic,Staff,20,0,20,0,0
1134,Wolfson Campus,WBPD  102 - 08   Notary Public Workshop,08-LEC Dynamic,Staff,20,0,20,0,0
1454,InterAmerican Campus,WBPD  102 - 09   Notary Public Workshop,09-LEC Dynamic,Staff,16,0,16,0,0
1391,InterAmerican Campus,WBPD  102 - 10   Notary Public Workshop,10-LEC Dynamic,Staff,25,0,25,0,0
2115,Kendall Campus,WBPD  102 - 11   Notary Public Workshop,11-LEC Dynamic,Staff,15,0,15,0,0
2120,Kendall Campus,WBPD  102 - 12   Notary Public Workshop,12-LEC Dynamic,Staff,15,0,15,0,0
2392,North Campus,WBPD  102 - 13   Notary Public Workshop,13-LEC Dynamic,Staff,16,0,16,0,0
2393,North Campus,WBPD  102 - 14   Notary Public Workshop,14-LEC Dynamic,Staff,16,0,16,0,0
2394,North Campus,WBPD  102 - 15   Notary Public Workshop,15-LEC Dynamic,Staff,16,0,16,0,0
2395,North Campus,WBPD  102 - 16   Notary Public Workshop,16-LEC Dynamic,Staff,16,0,16,0,0
2396,North Campus,WBPD  102 - 17   Notary Public Workshop,17-LEC Dynamic,Staff,16,0,16,0,0
2453,North Campus,WBPD  102 - 18   Notary Public Workshop,18-LEC Dynamic,Staff,16,0,16,0,0
2468,North Campus,WBPD  102 - 19   Notary Public Workshop,19-LEC Dynamic,Staff,16,0,16,0,0
2469,North Campus,WBPD  102 - 20   Notary Public Workshop,20-LEC Dynamic,Staff,16,0,16,0,0
2974,Hialeah Campus,WBPD  102 - 21   Notary Public Workshop,21-LEC Dynamic,Staff,30,0,30,0,0
2975,Hialeah Campus,WBPD  102 - 22   Notary Public Workshop,22-LEC Dynamic,Staff,30,0,30,0,0
2509,West Campus,WBPD  102 - 23   Notary Public Workshop,23-LEC Dynamic,Staff,16,0,16,0,0
2510,West Campus,WBPD  102 - 24   Notary Public Workshop,24-LEC Dynamic,Staff,16,0,16,0,0
3491,Kendall Campus,WBPM  102 - 01   Professional Project Management Certification Preparation Course,01-LEC Dynamic,Staff,16,0,16,0,0
3076,Kendall Campus,WBRE  102 - 01   3-Hour Florida Law for Appraisers,01-LEC Dynamic,Staff,16,0,16,0,0
1170,Wolfson Campus,WBTP  102 - 01   Income Tax Preparation Series,01-LEC Dynamic,Staff,25,0,25,0,0
2961,Hialeah Campus,WBTP  102 - 02   Income Tax Preparation Series,02-LEC Dynamic,Staff,30,0,30,0,0
1445,Kendall Campus,WBWA  102 - 01   Better Writing 2,01-LEC Dynamic,Staff,30,0,30,0,0
1446,Kendall Campus,WBWA  102 - 02   Better Writing 2,02-LEC Dynamic,Staff,30,0,30,0,0
2172,Wolfson Campus,WBWA  102 - 03   Better Writing 2,03-LEC Dynamic,Staff,30,0,30,0,0
1049,Homestead Campus,WCFC  102 - 01   Family Engagement and Inclusion,01-LEC Dynamic,Staff,25,0,25,0,0
1245,Kendall Campus,WCTR  102 - 03   10 Hours Special Needs Appropriate Practices,03-LEC Dynamic,Staff,25,0,25,0,0
3249,North Campus,WCTR  102 - 04   10 Hours Special Needs Appropriate Practices,04-LEC Dynamic,Staff,16,0,16,8,0
3250,North Campus,WCTR  102 - 05   10 Hours Special Needs Appropriate Practices,05-LEC Dynamic,Staff,16,0,16,8,0
2685,Medical Campus,WHAC  102 - 01   ACLS Provider Retraining Course,01-LEC Dynamic,Staff,16,0,16,0,0
2800,North Campus,WHAL  102 - 01   Assisted Living Facility (ALF) Core Training,01-LEC Dynamic,Staff,16,0,16,0,0
3324,Medical Campus,WHCH  102 - 01   Foundations of Health for the Community Health Worker,01-LEC Dynamic,Staff,25,0,25,0,0
3357,Medical Campus,WHCT  102 - 01   Managing Alzheimer's and Dementia for the Caregiver,01-LEC Dynamic,Staff,25,0,25,0,0
3358,Medical Campus,WHCT  102 - 02   Managing Alzheimer's and Dementia for the Caregiver,02-LEC Dynamic,Staff,25,0,25,0,0
3363,Medical Campus,WHEG  102 - 01   12 Lead EKG Interpretation - Basic,01-LEC Dynamic,Staff,20,0,20,0,0
3374,Medical Campus,WHHA  102 - 01   BLS Instructor Course,01-LEC Dynamic,Staff,25,0,25,0,0
3394,Medical Campus,WHMR  102 - 01   MRI Procedures and Cross Sectional Anatomy and Pathology,01-LEC Dynamic,Staff,25,0,25,0,0
3400,Medical Campus,WHNC  102 - 01   Airway Management,01-LEC Dynamic,Staff,15,0,15,0,0
3410,Medical Campus,WHPA  102 - 01   PALS Provider Recertification Course,01-LEC Dynamic,Staff,10,0,10,0,0
3413,Medical Campus,WHRN  102 - 01   NCLEX LPN (PN) Remediation Lecture,01-LEC Dynamic,Staff,20,0,20,0,0
1487,Wolfson Campus,WLEP  102 - 01   Accent Reduction - Advanced,01-LEC Dynamic,Staff,25,0,25,0,0
1488,Wolfson Campus,WLEP  102 - 02   Accent Reduction - Advanced,02-LEC Dynamic,Staff,16,0,16,0,0
2162,Wolfson Campus,WLEP  102 - 03   Accent Reduction - Advanced,03-LEC Dynamic,Staff,30,0,30,0,0
2163,Wolfson Campus,WLEP  102 - 04   Accent Reduction - Advanced,04-LEC Dynamic,Staff,30,0,30,0,0
1084,Kendall Campus,WLFL  102 - 01   Arabic 1 - 21 hrs.,01-LEC Dynamic,Staff,16,0,16,0,0
2921,Hialeah Campus,WTBT  102 - 01   Abra Su Tienda en Internet - Nivel 2,01-LEC Dynamic,Staff,16,0,16,0,0
1326,Kendall Campus,WTMO  102 - 01   Microsoft Access for Small Businesses,01-LEC Dynamic,Staff,15,0,15,0,0
2348,Kendall Campus,RLAC  101 - 01   Aqua Fitness,01-LEC Dynamic,Staff,9,0,9,0,0
3101,Hialeah Campus,RLAM  101 - 01   All About the Eyes,01-LEC Dynamic,Staff,30,0,30,0,0
3468,Kendall Campus,RLAM  101 - 02   All About the Eyes,02-LEC Dynamic,Staff,16,0,16,0,0
3473,Kendall Campus,RLAM  101 - 03   All About the Eyes,03-LEC Dynamic,Staff,16,0,16,0,0
1241,Wolfson Campus,RLCP  101 - 01   ACT Intensive Math/Science,01-LEC Dynamic,Staff,30,0,30,0,0
1244,Wolfson Campus,RLCP  101 - 02   ACT Intensive Math/Science,02-LEC Dynamic,Staff,30,0,30,0,0
2573,West Campus,RLCP  101 - 03   ACT Intensive Math/Science,03-LEC Dynamic,Staff,30,0,30,0,0
2405,North Campus,RLCP  101 - 04   ACT Intensive Math/Science,04-LEC Dynamic,Staff,30,0,30,10,0
2574,West Campus,RLCP  101 - 05   ACT Intensive Math/Science,05-LEC Dynamic,Staff,30,0,30,0,0
2454,Hialeah Campus,RLCP  101 - 06   ACT Intensive Math/Science,06-LEC Dynamic,Staff,30,0,30,0,0
1069,Homestead Campus,RLCT  101 - 01   Citizenship (15 hours),01-LEC Dynamic,Staff,25,0,25,0,0
1070,Homestead Campus,RLCT  101 - 02   Citizenship (15 hours),02-LEC Dynamic,Staff,25,0,25,0,0
1440,Kendall Campus,RLCT  101 - 03   Citizenship (15 hours),03-LEC Dynamic,Staff,30,0,30,0,0
1441,Kendall Campus,RLCT  101 - 04   Citizenship (15 hours),04-LEC Dynamic,Staff,30,0,30,0,0
1489,InterAmerican Campus,RLCT  101 - 05   Citizenship (15 hours),05-LEC Dynamic,Staff,30,0,30,0,0
2460,Hialeah Campus,RLCT  101 - 06   Citizenship (15 hours),06-LEC Dynamic,Staff,30,0,30,0,0
2461,Hialeah Campus,RLCT  101 - 07   Citizenship (15 hours),07-LEC Dynamic,Staff,30,0,30,0,0
2593,West Campus,RLCT  101 - 08   Citizenship (15 hours),08-LEC Dynamic,Staff,30,0,30,0,0
2594,West Campus,RLCT  101 - 09   Citizenship (15 hours),09-LEC Dynamic,Staff,30,0,30,0,0
1399,InterAmerican Campus,RLEP  101 - 01   Introduction to Event Planning,01-LEC Dynamic,Staff,16,0,16,0,0
1400,InterAmerican Campus,RLEP  101 - 02   Introduction to Event Planning,02-LEC Dynamic,Staff,16,0,16,0,0
2687,Kendall Campus,RLFA  101 - 01   FSA - 3rd Grade Math Review,01-LEC Dynamic,Staff,20,0,20,0,0
2828,Kendall Campus,RLGE  101 - 01   GRE Math Review,01-LEC Dynamic,Staff,20,0,20,0,0
2831,Kendall Campus,RLGE  101 - 02   GRE Math Review,02-LEC Dynamic,Staff,20,0,20,0,0
2712,Kendall Campus,RLID  101 - 01   Decoración de Interiores - Nivel 1,01-LEC Dynamic,Staff,15,0,15,0,0
2719,Kendall Campus,RLID  101 - 02   Decoración de Interiores - Nivel 1,02-LEC Dynamic,Staff,15,0,15,0,0
3121,Hialeah Campus,RLID  101 - 03   Decoración de Interiores - Nivel 1,03-LEC Dynamic,Staff,30,0,30,0,0
3065,Kendall Campus,RLMC  101 - 01   Motorcycle Riding Certification,01-LEC Dynamic,Staff,24,0,24,0,0
3070,Kendall Campus,RLMC  101 - 02   Motorcycle Riding Certification,02-LEC Dynamic,Staff,24,0,24,0,0
3072,Kendall Campus,RLMC  101 - 03   Motorcycle Riding Certification,03-LEC Dynamic,Staff,24,0,24,0,0
3088,Kendall Campus,RLMC  101 - 04   Motorcycle Riding Certification,04-LEC Dynamic,Staff,24,0,24,0,0
3092,Kendall Campus,RLMC  101 - 05   Motorcycle Riding Certification,05-LEC Dynamic,Staff,24,0,24,0,0
3093,Kendall Campus,RLMC  101 - 06   Motorcycle Riding Certification,06-LEC Dynamic,Staff,24,0,24,0,0
3095,Kendall Campus,RLMC  101 - 07   Motorcycle Riding Certification,07-LEC Dynamic,Staff,24,0,24,0,0
3098,Kendall Campus,RLMC  101 - 08   Motorcycle Riding Certification,08-LEC Dynamic,Staff,24,0,24,0,0
3100,Kendall Campus,RLMC  101 - 09   Motorcycle Riding Certification,09-LEC Dynamic,Staff,24,0,24,0,0
3103,Kendall Campus,RLMC  101 - 10   Motorcycle Riding Certification,10-LEC Dynamic,Staff,24,0,24,0,0
3106,Kendall Campus,RLMC  101 - 11   Motorcycle Riding Certification,11-LEC Dynamic,Staff,24,0,24,0,0
3114,Kendall Campus,RLMC  101 - 12   Motorcycle Riding Certification,12-LEC Dynamic,Staff,24,0,24,0,0
3138,Kendall Campus,RLMC  101 - 13   Motorcycle Riding Certification,13-LEC Dynamic,Staff,24,0,24,0,0
3140,Kendall Campus,RLMC  101 - 14   Motorcycle Riding Certification,14-LEC Dynamic,Staff,24,0,24,0,0
3142,Kendall Campus,RLMC  101 - 15   Motorcycle Riding Certification,15-LEC Dynamic,Staff,24,0,24,0,0
3143,Kendall Campus,RLMC  101 - 16   Motorcycle Riding Certification,16-LEC Dynamic,Staff,24,0,24,0,0
3144,Kendall Campus,RLMC  101 - 17   Motorcycle Riding Certification,17-LEC Dynamic,Staff,24,0,24,0,0
1650,InterAmerican Campus,RLPF  101 - 01   Curso de Educación y Estabilización Familiar (CODP),01-LEC Dynamic,Staff,20,0,20,0,0
1651,InterAmerican Campus,RLPF  101 - 02   Curso de Educación y Estabilización Familiar (CODP),02-LEC Dynamic,Staff,20,0,20,0,0
1652,InterAmerican Campus,RLPF  101 - 03   Curso de Educación y Estabilización Familiar (CODP),03-LEC Dynamic,Staff,20,0,20,0,0
1826,Kendall Campus,RLPF  101 - 04   Curso de Educación y Estabilización Familiar (CODP),04-LEC Dynamic,Staff,0,0,0,0,0
1827,Kendall Campus,RLPF  101 - 05   Curso de Educación y Estabilización Familiar (CODP),05-LEC Dynamic,Staff,0,0,0,0,0
1829,Kendall Campus,RLPF  101 - 06   Curso de Educación y Estabilización Familiar (CODP),06-LEC Dynamic,Staff,30,0,30,0,0
1831,Kendall Campus,RLPF  101 - 07   Curso de Educación y Estabilización Familiar (CODP),07-LEC Dynamic,Staff,30,0,30,0,0
1832,Kendall Campus,RLPF  101 - 08   Curso de Educación y Estabilización Familiar (CODP),08-LEC Dynamic,Staff,30,0,30,0,0
1835,Kendall Campus,RLPF  101 - 09   Curso de Educación y Estabilización Familiar (CODP),09-LEC Dynamic,Staff,30,0,30,0,0
2249,Wolfson Campus,RLPF  101 - 10   Curso de Educación y Estabilización Familiar (CODP),10-LEC Dynamic,Staff,30,0,30,0,0
2250,Wolfson Campus,RLPF  101 - 11   Curso de Educación y Estabilización Familiar (CODP),11-LEC Dynamic,Staff,30,0,30,0,0
2251,Wolfson Campus,RLPF  101 - 12   Curso de Educación y Estabilización Familiar (CODP),12-LEC Dynamic,Staff,30,0,30,0,0
2252,Wolfson Campus,RLPF  101 - 13   Curso de Educación y Estabilización Familiar (CODP),13-LEC Dynamic,Staff,30,0,30,0,0
2414,North Campus,RLTO  101 - 01   TOEFL Prep: Listening· Speaking and Reading,01-LEC Dynamic,Staff,30,0,30,10,0
1422,InterAmerican Campus,RLWA  101 - 01   Creación y Composición Literaria,01-LAB Dynamic,Staff,16,0,16,0,0
1423,InterAmerican Campus,RLWA  101 - 02   Creación y Composición Literaria,02-LAB Dynamic,Staff,16,0,16,0,0
1204,Wolfson Campus,WBAB  101 - 01   Accounting - Level I,01-LEC Dynamic,Staff,25,0,25,0,0
2026,Kendall Campus,WBAB  101 - 02   Accounting - Level I,02-LEC Dynamic,Staff,20,0,20,0,0
2484,North Campus,WBAB  101 - 03   Accounting - Level I,03-LEC Dynamic,Staff,16,0,16,0,0
3781,Wolfson Campus,WBCI  101 - 01   Materials and Methods of Construction,01-LEC Dynamic,Staff,30,0,30,0,0
2241,Wolfson Campus,WBEB  101 - 01   Certificate in Sales and Negotiation,01-LEC Dynamic,Staff,20,0,20,0,0
1143,Wolfson Campus,WBFI  101 - 01   Advanced Trading Currencies,01-LEC Dynamic,Staff,20,0,20,0,0
1311,Wolfson Campus,WBFM  101 - 01   Finance for Non-Financial Managers,01-LEC Dynamic,Staff,18,0,18,0,0
1113,Wolfson Campus,WBHE  101 - 01   SHRM Certification Exam Preparation for SHRM-CP and SHRM-SCP,01-LEC Dynamic,Staff,25,0,25,0,0
1114,Wolfson Campus,WBHE  101 - 02   SHRM Certification Exam Preparation for SHRM-CP and SHRM-SCP,02-LEC Dynamic,Staff,25,0,25,0,0
3570,Wolfson Campus,WBHR  101 - 01   Human Resources Excellence in Management,01-LEC Dynamic,Staff,25,0,25,0,0
2074,Kendall Campus,WBIE  101 - 01,01-LEC Dynamic,Staff,15,0,15,0,0
2357,Kendall Campus,WBIN  101 - 01   Accredited Claims Adjuster State Designation (6-20/3-20 - ACA),01-LEC Dynamic,Staff,25,0,25,0,0
3268,Wolfson Campus,WBIN  101 - 02   Accredited Claims Adjuster State Designation (6-20/3-20 - ACA),02-LEC Dynamic,Staff,30,0,30,30,0
3269,Wolfson Campus,WBIN  101 - 03   Accredited Claims Adjuster State Designation (6-20/3-20 - ACA),03-LEC Dynamic,Staff,30,0,30,0,0
1354,Homestead Campus,WBNI  101 - 01   Grant Writing Basics,01-LEC Dynamic,Staff,25,0,25,0,0
3120,North Campus,WBNI  101 - 02   Grant Writing Basics,02-LEC Dynamic,Staff,16,0,16,0,0
1385,InterAmerican Campus,WBPD  101 - 01   Notary Public (en Español),01-LEC Dynamic,Staff,25,0,25,0,0
1386,InterAmerican Campus,WBPD  101 - 02   Notary Public (en Español),02-LEC Dynamic,Staff,16,0,16,0,0
1387,InterAmerican Campus,WBPD  101 - 03   Notary Public (en Español),03-LEC Dynamic,Staff,25,0,25,0,0
1388,InterAmerican Campus,WBPD  101 - 04   Notary Public (en Español),04-LEC Dynamic,Staff,25,0,25,0,0
2077,Kendall Campus,WBPD  101 - 05   Notary Public (en Español),05-LEC Dynamic,Staff,15,0,15,0,0
2097,Kendall Campus,WBPD  101 - 06   Notary Public (en Español),06-LEC Dynamic,Staff,15,0,15,0,0
2098,Kendall Campus,WBPD  101 - 07   Notary Public (en Español),07-LEC Dynamic,Staff,15,0,15,0,0
2976,Hialeah Campus,WBPD  101 - 08   Notary Public (en Español),08-LEC Dynamic,Staff,30,0,30,0,0
2977,Hialeah Campus,WBPD  101 - 09   Notary Public (en Español),09-LEC Dynamic,Staff,30,0,30,0,0
2978,Hialeah Campus,WBPD  101 - 10   Notary Public (en Español),10-LEC Dynamic,Staff,30,0,30,0,0
2979,Hialeah Campus,WBPD  101 - 11   Notary Public (en Español),11-LEC Dynamic,Staff,30,0,30,0,0
2507,West Campus,WBPD  101 - 12   Notary Public (en Español),12-LEC Dynamic,Staff,25,0,25,0,0
2508,West Campus,WBPD  101 - 13   Notary Public (en Español),13-LEC Dynamic,Staff,25,0,25,0,0
2156,Kendall Campus,WBPM  101 - 01   Project Management,01-LEC Dynamic,Staff,15,0,15,0,0
2025,Kendall Campus,WBRE  101 - 01   Appraisal Continuing Education,01-LEC Dynamic,Staff,15,0,15,0,0
1008,Homestead Campus,WBSE  101 - 01   Quality Customer Service,01-LEC Dynamic,Staff,25,0,25,0,0
2981,Hialeah Campus,WBSE  101 - 02   Quality Customer Service,02-LEC Dynamic,Staff,30,0,30,0,0
1985,Kendall Campus,WBTP  101 - 01   Corporate Income Tax Preparation,01-LEC Dynamic,Staff,20,0,20,0,0
2467,West Campus,WBTP  101 - 02   Corporate Income Tax Preparation,02-LEC Dynamic,Staff,20,0,20,0,0
2476,North Campus,WBTP  101 - 03   Corporate Income Tax Preparation,03-LEC Dynamic,Staff,16,0,16,0,0
2478,North Campus,WBTP  101 - 04   Corporate Income Tax Preparation,04-LEC Dynamic,Staff,16,0,16,0,0
1442,Kendall Campus,WBWA  101 - 01   Better Writing 1,01-LEC Dynamic,Staff,25,0,25,0,0
1443,Kendall Campus,WBWA  101 - 02   Better Writing 1,02-LEC Dynamic,Staff,30,0,30,0,0
1657,Wolfson Campus,WBWA  101 - 03   Better Writing 1,03-LEC Dynamic,Staff,16,0,16,0,0
2171,Wolfson Campus,WBWA  101 - 04   Better Writing 1,04-LEC Dynamic,Staff,30,0,30,0,0
2527,Hialeah Campus,WBWA  101 - 05   Better Writing 1,05-LEC Dynamic,Staff,30,0,30,0,0
3826,Homestead Campus,WCCP  101 - 01   Creative Curriculum for Preschoolers,01-LEC Dynamic,Staff,25,0,25,0,0
2070,Kendall Campus,WCIS  101 - 01   10 Componentes de Calidad de un Centro Infantil 4.5 CEU's,01-LEC Dynamic,Staff,25,0,25,0,0
1542,Kendall Campus,WCTR  101 - 03   10 Horas de Prácticas Apropiadas para Niños con Necesidades Especiales,03-LEC Dynamic,Staff,25,0,25,0,0
2554,Hialeah Campus,WCTR  101 - 05   10 Horas de Prácticas Apropiadas para Niños con Necesidades Especiales,05-LEC Dynamic,Staff,16,0,16,0,0
2607,West Campus,WCTR  101 - 06   10 Horas de Prácticas Apropiadas para Niños con Necesidades Especiales,06-LEC Dynamic,Staff,25,0,25,0,0
2608,West Campus,WCTR  101 - 07   10 Horas de Prácticas Apropiadas para Niños con Necesidades Especiales,07-LEC Dynamic,Staff,25,0,25,0,0
3814,Homestead Campus,WCTR  101 - 08   10 Horas de Prácticas Apropiadas para Niños con Necesidades Especiales,08-LEC Dynamic,Staff,25,0,25,0,0
1264,Homestead Campus,WHCE  101 - 01   Alzheimer's Disease for Health Care,01-LEC Dynamic,Staff,25,0,25,0,0
3318,Medical Campus,WHCE  101 - 02   Alzheimer's Disease for Health Care,02-LEC Dynamic,Staff,25,0,25,0,0
3322,Medical Campus,WHCH  101 - 01   Enhancing CHW Service Delivery Through Communication and Education,01-LEC Dynamic,Staff,25,0,25,0,0
2796,North Campus,WHCT  101 - 01   Home Health Aide Training,01-LEC Dynamic,Staff,16,0,16,0,0
3356,Medical Campus,WHCT  101 - 02   Home Health Aide Training,02-LEC Dynamic,Staff,16,0,16,0,0
3360,Medical Campus,WHDH  101 - 01   Local Anesthesia for Dental Hygienists,01-LEC Dynamic,Staff,25,0,25,0,0
3361,Medical Campus,WHDH  101 - 02   Local Anesthesia for Dental Hygienists,02-LEC Dynamic,Staff,25,0,25,0,0
1277,Homestead Campus,WHEG  101 - 01   EKG Technician Certification,01-LEC Dynamic,Staff,25,0,25,0,0
1278,Homestead Campus,WHEG  101 - 02   EKG Technician Certification,02-LEC Dynamic,Staff,25,0,25,0,0
3362,Medical Campus,WHEG  101 - 03   EKG Technician Certification,03-LEC Dynamic,Staff,10,0,10,0,0
3364,Medical Campus,WHEM  101 - 01   EMT Refresher,01-LEC Dynamic,Staff,25,0,25,0,0
3372,Medical Campus,WHHA  101 - 01   ACLS Instructor Course,01-LEC Dynamic,Staff,25,0,25,0,0
3398,Medical Campus,WHMB  101 - 01   Introduction to ICD-10,01-LEC Dynamic,Staff,15,0,15,0,0
3393,Medical Campus,WHMR  101 - 01   MRI Principles,01-LEC Dynamic,Staff,25,0,25,0,0
3396,Medical Campus,WHMS  101 - 01   Med-Surg RN Refresher - Lecture,01-LEC Dynamic,Staff,20,0,20,0,0
3399,Medical Campus,WHMT  101 - 01   Advanced Clinical Applications for Massage Therapy,01-LEC Dynamic,Staff,10,0,10,0,0
3258,Wolfson Campus,WHNC  101 - 01   A Day in the Life of a Patient,01-LEC Dynamic,Staff,20,0,20,0,0
3409,Medical Campus,WHPA  101 - 01   Pediatric Advanced Life Support (PALS),01-LEC Dynamic,Staff,20,0,20,0,0
2148,Medical Campus,WHPR  101 - 01   CPR-BLS for Health Care Providers (Recertification),01-LEC Dynamic,Staff,25,0,25,0,0
2150,Medical Campus,WHPR  101 - 02   CPR-BLS for Health Care Providers (Recertification),02-LEC Dynamic,Staff,25,0,25,0,0
2151,Medical Campus,WHPR  101 - 03   CPR-BLS for Health Care Providers (Recertification),03-LEC Dynamic,Staff,25,0,25,0,0
2153,Medical Campus,WHPR  101 - 04   CPR-BLS for Health Care Providers (Recertification),04-LEC Dynamic,Staff,25,0,25,0,0
2154,Medical Campus,WHPR  101 - 05   CPR-BLS for Health Care Providers (Recertification),05-LEC Dynamic,Staff,25,0,25,0,0
2780,North Campus,WHPR  101 - 06   CPR-BLS for Health Care Providers (Recertification),06-LEC Dynamic,Staff,16,0,16,0,0
2786,North Campus,WHPR  101 - 07   CPR-BLS for Health Care Providers (Recertification),07-LEC Dynamic,Staff,16,0,16,0,0
2789,North Campus,WHPR  101 - 08   CPR-BLS for Health Care Providers (Recertification),08-LEC Dynamic,Staff,16,0,16,0,0
2791,North Campus,WHPR  101 - 09   CPR-BLS for Health Care Providers (Recertification),09-LEC Dynamic,Staff,16,0,16,0,0
2793,North Campus,WHPR  101 - 10   CPR-BLS for Health Care Providers (Recertification),10-LEC Dynamic,Staff,16,0,16,0,0
2795,North Campus,WHPR  101 - 11   CPR-BLS for Health Care Providers (Recertification),11-LEC Dynamic,Staff,16,0,16,0,0
3068,Kendall Campus,WHPR  101 - 12   CPR-BLS for Health Care Providers (Recertification),12-LEC Dynamic,Staff,16,0,16,0,0
3069,Kendall Campus,WHPR  101 - 13   CPR-BLS for Health Care Providers (Recertification),13-LEC Dynamic,Staff,16,0,16,0,0
3721,Kendall Campus,WHPR  101 - 14   CPR-BLS for Health Care Providers (Recertification),14-LEC Dynamic,Staff,18,0,18,0,0
3412,Medical Campus,WHRN  101 - 01   NCLEX RN Remediation Lecture,01-LEC Dynamic,Staff,20,0,20,0,0
1222,Kendall Campus,WLEP  101 - 01   Accent Reduction - Consonants,01-LEC Dynamic,Staff,25,0,25,0,0
1224,Kendall Campus,WLEP  101 - 02   Accent Reduction - Consonants,02-LEC Dynamic,Staff,25,0,25,0,0
1332,Kendall Campus,WTBT  101 - 01   Abra su Tienda en Internet,01-LEC Dynamic,Staff,15,0,15,0,0
1334,Kendall Campus,WTBT  101 - 02   Abra su Tienda en Internet,02-LEC Dynamic,Staff,15,0,15,0,0
2919,Hialeah Campus,WTBT  101 - 03   Abra su Tienda en Internet,03-LEC Dynamic,Staff,16,0,16,0,0
1757,Wolfson Campus,WTCA  101 - 01   3DMax - VIZ Level 2,01-LEC Dynamic,Staff,30,0,30,0,0
